geo_id,state_id,county_id,county_name,race_total_population,race_hispanic_or_latino,race_not_hispanic_or_latino,race_american_indian_and_alaska_native,race_asian,race_black_or_african_american,race_native_hawaiian_and_other_pacific_islander,race_some_other_race,race_two_or_more,race_two_or_more_excluding_some_ther_and_three_or_more,race_two_or_more_including_some_other,race_white_alone
0500000US06033,06,033,Lake County,64148,12830,51318,2090,642,1426,30,142,1365,1348,17,45623
0500000US06043,06,043,Mariposa County,17540,1909,15631,390,243,166,54,20,633,627,6,14125
0500000US06115,06,115,Yuba County,75493,20990,54503,643,4977,2340,292,126,4040,3982,58,42085
0500000US06013,06,013,Contra Costa County,1133247,288101,845146,2376,182135,93683,5251,3829,54921,53181,1740,502951
0500000US06035,06,035,Lassen County,31185,5834,25351,847,436,2695,205,22,618,559,59,20528
0500000US06083,06,083,Santa Barbara County,443738,200060,243678,1407,22996,7881,482,604,10952,10760,192,199356
0500000US06097,06,097,Sonoma County,501317,132985,368332,2068,19720,7192,1406,2501,17208,16693,515,318237
0500000US06025,06,025,Imperial County,180216,151019,29197,1076,2376,3906,307,120,1639,1598,41,19773
0500000US06051,06,051,Mono County,14174,3866,10308,342,336,40,0,80,276,276,0,9234
0500000US06001,06,001,Alameda County,1643700,369061,1274639,5288,483067,172329,13192,4977,72395,68394,4001,523391
0500000US06067,06,067,Sacramento County,1510023,347025,1162998,5469,231740,144003,16335,6086,76865,73779,3086,682500
0500000US06055,06,055,Napa County,140530,47687,92843,326,11210,2764,264,516,3604,3384,220,74159
0500000US06053,06,053,Monterey County,433212,252588,180624,1046,23647,10606,1963,530,11594,11458,136,131238
0500000US06091,06,091,Sierra County,2930,324,2606,25,0,6,0,0,8,8,0,2567
0500000US06073,06,073,San Diego County,3302833,1106925,2195908,12282,382336,155536,12811,6366,111197,108705,2492,1515380
0500000US06113,06,113,Yolo County,214977,67809,147168,533,29360,5215,919,258,9609,9276,333,101274
0500000US06023,06,023,Humboldt County,135768,15360,120408,5919,4049,1342,369,258,7166,7057,109,101305
0500000US06003,06,003,Alpine County,1146,105,1041,294,8,9,0,0,52,52,0,678
0500000US06045,06,045,Mendocino County,87422,21679,65743,2839,1667,511,170,180,3062,3037,25,57314
0500000US06087,06,087,Santa Cruz County,273765,91676,182089,360,12116,2359,168,554,8992,8851,141,157540
0500000US06037,06,037,Los Angeles County,10098052,4893603,5204449,20307,1451560,795505,24821,29924,223280,209713,13567,2659052
0500000US06065,06,065,Riverside County,2383286,1154517,1228769,10064,147706,144503,5846,5345,58837,56161,2676,856468
0500000US06085,06,085,Santa Clara County,1922200,495455,1426745,3003,685265,45379,6231,4743,66212,62474,3738,615912
0500000US06041,06,041,Marin County,260295,41335,218960,435,14815,5597,292,2453,9559,9282,277,185809
0500000US06093,06,093,Siskiyou County,43540,5336,38204,1283,671,619,120,33,2088,2062,26,33390
0500000US06089,06,089,Shasta County,179085,17605,161480,4014,5326,2140,182,151,6092,5863,229,143575
0500000US06015,06,015,Del Norte County,27424,5340,22084,1841,937,758,17,128,1231,1205,26,17172
0500000US06021,06,021,Glenn County,27897,11504,16393,414,820,223,17,0,412,410,2,14507
0500000US06007,06,007,Butte County,227075,36358,190717,1738,9900,3303,341,406,10639,10350,289,164390
0500000US06063,06,063,Plumas County,18699,1629,17070,387,200,194,41,126,551,551,0,15571
0500000US06079,06,079,San Luis Obispo County,281455,63002,218453,1363,9924,4912,258,244,7178,6955,223,194574
0500000US06029,06,029,Kern County,883053,465842,417211,4202,40273,45053,1153,1039,18461,17011,1450,307030
0500000US06059,06,059,Orange County,3164182,1080195,2083987,6348,629637,50412,8541,5881,87132,82896,4236,1296036
0500000US06009,06,009,Calaveras County,45235,5297,39938,374,568,299,126,52,1614,1595,19,36905
0500000US06101,06,101,Sutter County,95872,29354,66518,676,14532,1793,367,211,4170,3960,210,44769
0500000US06081,06,081,San Mateo County,765935,189002,576933,1151,212474,16838,10272,2476,30675,29042,1633,303047
0500000US06109,06,109,Tuolumne County,53932,6527,47405,747,732,880,125,40,1517,1489,28,43364
0500000US06077,06,077,San Joaquin County,732212,301256,430956,1536,110164,49926,3959,1069,26415,25080,1335,237887
0500000US06005,06,005,Amador County,37829,5132,32697,270,466,749,69,10,1370,1370,0,29763
0500000US06047,06,047,Merced County,269075,158494,110581,840,19487,8038,556,501,5151,4987,164,76008
0500000US06049,06,049,Modoc County,8938,1292,7646,291,130,149,6,4,104,96,8,6962
0500000US06027,06,027,Inyo County,18085,3927,14158,1944,289,160,35,28,313,312,1,11389
0500000US06099,06,099,Stanislaus County,539301,245973,293328,2600,28599,14338,3711,908,13376,12769,607,229796
0500000US06103,06,103,Tehama County,63373,15623,47750,1013,964,420,17,24,1773,1734,39,43539
0500000US06069,06,069,San Benito County,59416,35248,24168,193,1705,434,79,84,893,840,53,20780
0500000US06017,06,017,El Dorado County,186661,23631,163030,939,8237,1432,396,184,5852,5721,131,145990
0500000US06075,06,075,San Francisco County,870044,132651,737393,1363,294846,43619,2694,4163,37038,35528,1510,353670
0500000US06107,06,107,Tulare County,460477,295149,165328,2769,14800,5870,584,877,6811,6549,262,133617
0500000US06057,06,057,Nevada County,99092,9281,89811,570,989,601,154,130,2897,2812,85,84470
0500000US06039,06,039,Madera County,155013,88806,66207,1504,3047,4835,136,443,2711,2500,211,53531
0500000US06105,06,105,Trinity County,12862,930,11932,574,179,87,158,27,300,299,1,10607
0500000US06071,06,071,San Bernardino County,2135413,1127813,1007600,7409,145652,168864,6037,4085,52291,49414,2877,623262
0500000US06061,06,061,Placer County,380077,52498,327579,1244,27196,5868,576,403,13912,13528,384,278380
0500000US06095,06,095,Solano County,438530,114406,324124,1258,65994,59500,3928,1288,23286,22630,656,168870
0500000US06011,06,011,Colusa County,21464,12655,8809,159,324,277,53,30,294,294,0,7672
0500000US06031,06,031,Kings County,150075,81154,68921,1227,5737,8784,285,204,3626,3449,177,49058
0500000US06019,06,019,Fresno County,978130,515907,462223,4458,97991,44474,1104,1864,20877,19919,958,291455
0500000US06111,06,111,Ventura County,848112,360017,488095,2299,60242,13677,1406,1016,21154,20614,540,388301
