geo_id,state_id,county_id,county_name,citizenship_total_population,citizenship_native_born,citizenship_foreign_born
0500000US28151,28,151,Washington County,47086,46444,642
0500000US28111,28,111,Perry County,12028,11990,38
0500000US28019,28,019,Choctaw County,8321,8292,29
0500000US28057,28,057,Itawamba County,23480,23272,208
0500000US28015,28,015,Carroll County,10129,10102,27
0500000US28043,28,043,Grenada County,21278,21208,70
0500000US28063,28,063,Jefferson County,7346,7299,47
0500000US28041,28,041,Greene County,13714,13525,189
0500000US28093,28,093,Marshall County,35787,35257,530
0500000US28119,28,119,Quitman County,7372,7335,37
0500000US28011,28,011,Bolivar County,32592,32100,492
0500000US28073,28,073,Lamar County,61223,59562,1661
0500000US28081,28,081,Lee County,84915,83261,1654
0500000US28113,28,113,Pike County,39737,39515,222
0500000US28135,28,135,Tallahatchie County,14361,13640,721
0500000US28129,28,129,Smith County,16063,15952,111
0500000US28131,28,131,Stone County,18375,18239,136
0500000US28149,28,149,Warren County,47075,46112,963
0500000US28023,28,023,Clarke County,15928,15888,40
0500000US28069,28,069,Kemper County,10107,10107,0
0500000US28097,28,097,Montgomery County,10198,10119,79
0500000US28105,28,105,Oktibbeha County,49481,47703,1778
0500000US28109,28,109,Pearl River County,55149,54299,850
0500000US28079,28,079,Leake County,22870,22421,449
0500000US28103,28,103,Noxubee County,10828,10717,111
0500000US28099,28,099,Neshoba County,29376,28988,388
0500000US28121,28,121,Rankin County,151240,147090,4150
0500000US28137,28,137,Tate County,28493,27944,549
0500000US28077,28,077,Lawrence County,12630,12588,42
0500000US28107,28,107,Panola County,34243,33841,402
0500000US28161,28,161,Yalobusha County,12421,12375,46
0500000US28017,28,017,Chickasaw County,17279,16937,342
0500000US28029,28,029,Copiah County,28721,28145,576
0500000US28039,28,039,George County,23710,23367,343
0500000US28049,28,049,Hinds County,241774,237444,4330
0500000US28101,28,101,Newton County,21524,21228,296
0500000US28145,28,145,Union County,28356,27682,674
0500000US28125,28,125,Sharkey County,4511,4435,76
0500000US28139,28,139,Tippah County,21990,21512,478
0500000US28035,28,035,Forrest County,75517,73429,2088
0500000US28045,28,045,Hancock County,46653,45759,894
0500000US28071,28,071,Lafayette County,53459,51582,1877
0500000US28055,28,055,Issaquena County,1328,1323,5
0500000US28087,28,087,Lowndes County,59437,58035,1402
0500000US28083,28,083,Leflore County,29804,29270,534
0500000US28157,28,157,Wilkinson County,8990,8990,0
0500000US28047,28,047,Harrison County,202626,192846,9780
0500000US28065,28,065,Jefferson Davis County,11495,11453,42
0500000US28085,28,085,Lincoln County,34432,34283,149
0500000US28123,28,123,Scott County,28415,26374,2041
0500000US28159,28,159,Winston County,18358,18275,83
0500000US28163,28,163,Yazoo County,27974,26831,1143
0500000US28009,28,009,Benton County,8253,8129,124
0500000US28037,28,037,Franklin County,7757,7726,31
0500000US28061,28,061,Jasper County,16529,16490,39
0500000US28067,28,067,Jones County,68454,66595,1859
0500000US28095,28,095,Monroe County,35840,35599,241
0500000US28133,28,133,Sunflower County,26532,26418,114
0500000US28155,28,155,Webster County,9828,9758,70
0500000US28001,28,001,Adams County,31547,29200,2347
0500000US28025,28,025,Clay County,19808,19746,62
0500000US28031,28,031,Covington County,19091,19008,83
0500000US28053,28,053,Humphreys County,8539,8388,151
0500000US29123,29,123,Madison County,12205,12117,88
0500000US29229,29,229,Wright County,18293,18108,185
0500000US29217,29,217,Vernon County,20691,20426,265
0500000US29195,29,195,Saline County,23102,21666,1436
0500000US29147,29,147,Nodaway County,22547,22027,520
0500000US29041,29,041,Chariton County,7546,7516,30
0500000US29079,29,079,Grundy County,10039,9806,233
0500000US29141,29,141,Morgan County,20137,19998,139
0500000US29223,29,223,Wayne County,13308,13218,90
0500000US29017,29,017,Bollinger County,12281,12224,57
0500000US29031,29,031,Cape Girardeau County,78324,76048,2276
0500000US29205,29,205,Shelby County,6061,6042,19
0500000US29225,29,225,Webster County,38082,37723,359
0500000US29005,29,005,Atchison County,5270,5230,40
0500000US29013,29,013,Bates County,16374,16243,131
0500000US29015,29,015,Benton County,18989,18847,142
0500000US29035,29,035,Carter County,6197,6184,13
0500000US29057,29,057,Dade County,7590,7523,67
0500000US29115,29,115,Linn County,12186,12107,79
0500000US29091,29,091,Howell County,40102,39610,492
0500000US29101,29,101,Johnson County,53689,52167,1522
0500000US29105,29,105,Laclede County,35507,35151,356
0500000US29125,29,125,Maries County,8884,8831,53
0500000US29161,29,161,Phelps County,44789,42311,2478
0500000US29165,29,165,Platte County,98824,93571,5253
0500000US29187,29,187,St. Francois County,66342,65668,674
0500000US29003,29,003,Andrew County,17403,17236,167
0500000US29033,29,033,Carroll County,8843,8727,116
0500000US29061,29,061,Daviess County,8302,8237,65
0500000US29103,29,103,Knox County,3951,3921,30
0500000US29127,29,127,Marion County,28672,28423,249
0500000US29151,29,151,Osage County,13619,13601,18
0500000US29181,29,181,Ripley County,13693,13617,76
0500000US29219,29,219,Warren County,33908,33316,592
0500000US29007,29,007,Audrain County,25735,25298,437
0500000US29043,29,043,Christian County,84275,82678,1597
0500000US29077,29,077,Greene County,288429,279750,8679
0500000US29081,29,081,Harrison County,8554,8429,125
0500000US29185,29,185,St. Clair County,9383,9270,113
0500000US29001,29,001,Adair County,25325,24283,1042
0500000US29199,29,199,Scotland County,4898,4888,10
0500000US29211,29,211,Sullivan County,6317,5741,576
0500000US29045,29,045,Clark County,6800,6762,38
0500000US29099,29,099,Jefferson County,223302,219203,4099
0500000US29111,29,111,Lewis County,10027,9938,89
0500000US29143,29,143,New Madrid County,17811,17725,86
0500000US29157,29,157,Perry County,19146,18938,208
0500000US29173,29,173,Ralls County,10217,10106,111
0500000US29177,29,177,Ray County,22825,22638,187
0500000US29189,29,189,St. Louis County,998684,926072,72612
0500000US29209,29,209,Stone County,31527,30936,591
0500000US29009,29,009,Barry County,35493,33685,1808
0500000US29019,29,019,Boone County,176515,164840,11675
0500000US29039,29,039,Cedar County,13938,13807,131
0500000US29055,29,055,Crawford County,24280,24061,219
0500000US29093,29,093,Iron County,10221,10105,116
0500000US29117,29,117,Livingston County,15076,14972,104
0500000US29135,29,135,Moniteau County,15958,15759,199
0500000US29149,29,149,Oregon County,10699,10546,153
0500000US29159,29,159,Pettis County,42371,39668,2703
0500000US29186,29,186,Ste. Genevieve County,17871,17699,172
0500000US29175,29,175,Randolph County,24945,24636,309
0500000US29069,29,069,Dunklin County,30428,29463,965
0500000US29071,29,071,Franklin County,102781,101195,1586
0500000US29089,29,089,Howard County,10113,10034,79
0500000US29095,29,095,Jackson County,692003,651534,40469
0500000US29131,29,131,Miller County,25049,24825,224
0500000US29169,29,169,Pulaski County,52591,49922,2669
0500000US29171,29,171,Putnam County,4815,4777,38
0500000US29213,29,213,Taney County,54720,52807,1913
0500000US29215,29,215,Texas County,25671,25438,233
0500000US29021,29,021,Buchanan County,89076,85566,3510
0500000US29025,29,025,Caldwell County,9049,8933,116
0500000US29027,29,027,Callaway County,44840,44010,830
0500000US29037,29,037,Cass County,102678,100410,2268
0500000US29049,29,049,Clinton County,20475,20247,228
0500000US29053,29,053,Cooper County,17622,17461,161
0500000US29059,29,059,Dallas County,16499,16286,213
0500000US29075,29,075,Gentry County,6665,6593,72
0500000US29085,29,085,Hickory County,9368,9299,69
0500000US29113,29,113,Lincoln County,55563,54784,779
0500000US29133,29,133,Mississippi County,13748,13681,67
0500000US29137,29,137,Monroe County,8654,8608,46
0500000US29145,29,145,Newton County,58202,56322,1880
0500000US29153,29,153,Ozark County,9236,9179,57
0500000US29163,29,163,Pike County,18489,18270,219
0500000US29183,29,183,St. Charles County,389985,374289,15696
0500000US30017,30,017,Custer County,11845,11655,190
0500000US30041,30,041,Hill County,16439,16205,234
0500000US30075,30,075,Powder River County,1619,1598,21
0500000US30067,30,067,Park County,16246,15828,418
0500000US30085,30,085,Roosevelt County,11228,11110,118
0500000US30005,30,005,Blaine County,6727,6664,63
0500000US30051,30,051,Liberty County,2280,2268,12
0500000US30083,30,083,Richland County,11360,11118,242
0500000US30099,30,099,Teton County,6080,5985,95
0500000US30101,30,101,Toole County,4976,4799,177
0500000US30025,30,025,Fallon County,2838,2799,39
0500000US30019,30,019,Daniels County,1753,1681,72
0500000US30045,30,045,Judith Basin County,1951,1931,20
0500000US30093,30,093,Silver Bow County,34814,33956,858
0500000US30023,30,023,Deer Lodge County,9100,8871,229
0500000US30043,30,043,Jefferson County,11778,11707,71
0500000US30055,30,055,McCone County,1630,1618,12
0500000US30107,30,107,Wheatland County,2149,2089,60
0500000US30087,30,087,Rosebud County,9250,9131,119
0500000US30011,30,011,Carter County,1318,1318,0
0500000US30021,30,021,Dawson County,9191,9101,90
0500000US30007,30,007,Broadwater County,5834,5778,56
0500000US30047,30,047,Lake County,29774,29186,588
0500000US30073,30,073,Pondera County,6044,5955,89
0500000US30111,30,111,Yellowstone County,157816,154472,3344
0500000US30081,30,081,Ravalli County,41902,41170,732
0500000US30105,30,105,Valley County,7532,7394,138
0500000US30027,30,027,Fergus County,11273,11114,159
0500000US30061,30,061,Mineral County,4211,4092,119
0500000US30069,30,069,Petroleum County,432,426,6
0500000US30089,30,089,Sanders County,11521,11279,242
0500000US30109,30,109,Wibaux County,1175,1138,37
0500000US30059,30,059,Meagher County,1968,1937,31
0500000US30009,30,009,Carbon County,10546,10440,106
0500000US30029,30,029,Flathead County,98082,95924,2158
0500000US30071,30,071,Phillips County,4124,4052,72
0500000US31001,31,001,Adams County,31583,29792,1791
0500000US31109,31,109,Lancaster County,310094,286075,24019
0500000US31011,31,011,Boone County,5313,5278,35
0500000US31149,31,149,Rock County,1350,1342,8
0500000US31007,31,007,Banner County,696,687,9
0500000US31163,31,163,Sherman County,3042,2992,50
0500000US31147,31,147,Richardson County,8009,7961,48
0500000US31093,31,093,Howard County,6405,6303,102
0500000US31089,31,089,Holt County,10245,9942,303
0500000US31065,31,065,Furnas County,4786,4694,92
0500000US31073,31,073,Gosper County,2015,1993,22
0500000US31151,31,151,Saline County,14288,12155,2133
0500000US31153,31,153,Sarpy County,178351,169277,9074
0500000US31173,31,173,Thurston County,7140,7028,112
0500000US31177,31,177,Washington County,20219,19975,244
0500000US31015,31,015,Boyd County,2042,2011,31
0500000US31031,31,031,Cherry County,5790,5633,157
0500000US31053,31,053,Dodge County,36683,34226,2457
0500000US31059,31,059,Fillmore County,5574,5489,85
0500000US31069,31,069,Garden County,1860,1819,41
0500000US31091,31,091,Hooker County,691,690,1
0500000US31123,31,123,Morrill County,4841,4626,215
0500000US31127,31,127,Nemaha County,7004,6906,98
0500000US31159,31,159,Seward County,17127,16861,266
0500000US31171,31,171,Thomas County,645,641,4
0500000US31043,31,043,Dakota County,20317,15413,4904
0500000US31181,31,181,Webster County,3571,3537,34
0500000US31003,31,003,Antelope County,6372,6261,111
0500000US31023,31,023,Butler County,8067,7891,176
0500000US31035,31,035,Clay County,6232,6002,230
0500000US31041,31,041,Custer County,10830,10618,212
0500000US31067,31,067,Gage County,21595,21247,348
0500000US31081,31,081,Hamilton County,9178,9077,101
0500000US31099,31,099,Kearney County,6552,6338,214
0500000US31101,31,101,Keith County,8099,7894,205
0500000US31119,31,119,Madison County,35164,32605,2559
0500000US31135,31,135,Perkins County,2907,2838,69
0500000US31155,31,155,Saunders County,21024,20749,275
0500000US31179,31,179,Wayne County,9367,9105,262
0500000US31103,31,103,Keya Paha County,792,788,4
0500000US31107,31,107,Knox County,8460,8342,118
0500000US31111,31,111,Lincoln County,35433,34787,646
0500000US31139,31,139,Pierce County,7157,7052,105
0500000US31165,31,165,Sioux County,1266,1264,2
0500000US31025,31,025,Cass County,25702,25425,277
0500000US31051,31,051,Dixon County,5746,5326,420
0500000US31057,31,057,Dundy County,2023,1864,159
0500000US31077,31,077,Greeley County,2410,2379,31
0500000US31079,31,079,Hall County,61343,52904,8439
0500000US31131,31,131,Otoe County,15896,15255,641
0500000US31145,31,145,Red Willow County,10806,10659,147
0500000US31045,31,045,Dawes County,8896,8799,97
0500000US31033,31,033,Cheyenne County,9852,9655,197
0500000US31047,31,047,Dawson County,23804,19209,4595
0500000US31117,31,117,McPherson County,454,454,0
0500000US31125,31,125,Nance County,3554,3521,33
0500000US31167,31,167,Stanton County,5992,5751,241
0500000US31175,31,175,Valley County,4224,4182,42
0500000US31083,31,083,Harlan County,3438,3387,51
0500000US31009,31,009,Blaine County,480,480,0
0500000US31019,31,019,Buffalo County,49030,46756,2274
0500000US31049,31,049,Deuel County,1894,1867,27
0500000US31087,31,087,Hitchcock County,2843,2830,13
0500000US31141,31,141,Platte County,33063,30000,3063
0500000US31169,31,169,Thayer County,5098,5065,33
0500000US31013,31,013,Box Butte County,11089,10872,217
0500000US32001,32,001,Churchill County,24010,22124,1886
0500000US32005,32,005,Douglas County,47828,44206,3622
0500000US32027,32,027,Pershing County,6611,5924,687
0500000US32009,32,009,Esmeralda County,981,866,115
0500000US32013,32,013,Humboldt County,16904,14919,1985
0500000US32021,32,021,Mineral County,4448,4211,237
0500000US32033,32,033,White Pine County,9737,9318,419
0500000US32007,32,007,Elko County,52252,47636,4616
0500000US32017,32,017,Lincoln County,5174,5011,163
0500000US32023,32,023,Nye County,43705,40533,3172
0500000US32029,32,029,Storey County,3941,3847,94
0500000US32031,32,031,Washoe County,450486,387268,63218
0500000US32003,32,003,Clark County,2141574,1666257,475317
0500000US32510,32,510,Carson City,54467,47833,6634
0500000US32019,32,019,Lyon County,53155,49526,3629
0500000US33005,33,005,Cheshire County,76263,73760,2503
0500000US33013,33,013,Merrimack County,149452,141490,7962
0500000US33009,33,009,Grafton County,89811,84566,5245
0500000US33015,33,015,Rockingham County,305129,290463,14666
0500000US33001,33,001,Belknap County,60640,59129,1511
0500000US33019,33,019,Sullivan County,43125,41932,1193
0500000US33011,33,011,Hillsborough County,411087,372266,38821
0500000US33017,33,017,Strafford County,128237,121279,6958
0500000US33007,33,007,Coos County,32038,30904,1134
0500000US33003,33,003,Carroll County,47840,46546,1294
0500000US34025,34,025,Monmouth County,623387,540320,83067
0500000US34037,34,037,Sussex County,142298,131062,11236
0500000US34011,34,011,Cumberland County,153400,137373,16027
0500000US34013,34,013,Essex County,793555,583563,209992
0500000US34029,34,029,Ocean County,591939,545126,46813
0500000US34015,34,015,Gloucester County,290852,275376,15476
0500000US34033,34,033,Salem County,63336,60471,2865
0500000US34031,34,031,Passaic County,504041,355207,148834
0500000US34007,34,007,Camden County,507367,451478,55889
0500000US34003,34,003,Bergen County,929999,644881,285118
0500000US34041,34,041,Warren County,106293,96071,10222
0500000US34017,34,017,Hudson County,668631,382633,285998
0500000US34005,34,005,Burlington County,446367,403232,43135
0500000US34027,34,027,Morris County,494383,399919,94464
0500000US35039,35,039,Rio Arriba County,39307,37866,1441
0500000US35047,35,047,San Miguel County,28034,27036,998
0500000US35057,35,057,Torrance County,15595,14721,874
0500000US35035,35,035,Otero County,65745,58264,7481
0500000US35006,35,006,Cibola County,26978,26152,826
0500000US35019,35,019,Guadalupe County,4382,4312,70
0500000US35003,35,003,Catron County,3539,3471,68
0500000US35029,35,029,Luna County,24264,19776,4488
0500000US35031,35,031,McKinley County,72849,71109,1740
0500000US35055,35,055,Taos County,32888,31069,1819
0500000US35017,35,017,Grant County,28061,27015,1046
0500000US35007,35,007,Colfax County,12353,11918,435
0500000US35015,35,015,Eddy County,57437,53762,3675
0500000US35033,35,033,Mora County,4563,4524,39
0500000US35037,35,037,Quay County,8373,8136,237
0500000US35027,35,027,Lincoln County,19482,17784,1698
0500000US35025,35,025,Lea County,70126,58577,11549
0500000US35049,35,049,Santa Fe County,148917,130257,18660
0500000US35051,35,051,Sierra County,11135,10640,495
0500000US35053,35,053,Socorro County,17000,16037,963
0500000US35013,35,013,Do�a Ana County,215338,177439,37899
0500000US36095,36,095,Schoharie County,31364,30485,879
0500000US36067,36,067,Onondaga County,464242,427761,36481
0500000US36019,36,019,Clinton County,80794,77162,3632
0500000US36099,36,099,Seneca County,34612,33845,767
0500000US36079,36,079,Putnam County,99070,86185,12885
0500000US36033,36,033,Franklin County,50692,48433,2259
0500000US36069,36,069,Ontario County,109472,105171,4301
0500000US36081,36,081,Queens County,2298513,1211280,1087233
0500000US36101,36,101,Steuben County,96927,94140,2787
0500000US36041,36,041,Hamilton County,4575,4465,110
0500000US36115,36,115,Washington County,61828,60491,1337
0500000US36013,36,013,Chautauqua County,129656,126680,2976
0500000US36047,36,047,Kings County,2600747,1651721,949026
0500000US36061,36,061,New York County,1632480,1159320,473160
0500000US36107,36,107,Tioga County,49045,48185,860
0500000US36011,36,011,Cayuga County,77868,76077,1791
0500000US36073,36,073,Orleans County,41175,39925,1250
0500000US36091,36,091,Saratoga County,227377,215432,11945
0500000US36087,36,087,Rockland County,323686,256409,67277
0500000US36021,36,021,Columbia County,60919,56695,4224
0500000US36049,36,049,Lewis County,26719,26300,419
0500000US36063,36,063,Niagara County,211704,203430,8274
0500000US36119,36,119,Westchester County,968815,721151,247664
0500000US36025,36,025,Delaware County,45502,43417,2085
0500000US36031,36,031,Essex County,37751,36534,1217
0500000US36057,36,057,Montgomery County,49426,47795,1631
0500000US36059,36,059,Nassau County,1356564,1055185,301379
0500000US36085,36,085,Richmond County,474101,365255,108846
0500000US36097,36,097,Schuyler County,17992,17711,281
0500000US36109,36,109,Tompkins County,102962,89456,13506
0500000US36017,36,017,Chenango County,48348,47599,749
0500000US36023,36,023,Cortland County,48123,47177,946
0500000US36045,36,045,Jefferson County,114448,110109,4339
0500000US36065,36,065,Oneida County,230782,213215,17567
0500000US36103,36,103,Suffolk County,1487901,1256938,230963
0500000US36121,36,121,Wyoming County,40565,39735,830
0500000US36015,36,015,Chemung County,85740,83204,2536
0500000US36075,36,075,Oswego County,119104,116973,2131
0500000US36077,36,077,Otsego County,60244,58030,2214
0500000US36117,36,117,Wayne County,90856,88321,2535
0500000US36001,36,001,Albany County,307426,275301,32125
0500000US36007,36,007,Broome County,194402,181043,13359
0500000US36029,36,029,Erie County,919866,854462,65404
0500000US36053,36,053,Madison County,71359,69534,1825
0500000US36105,36,105,Sullivan County,75211,68142,7069
0500000US36037,36,037,Genesee County,58112,56947,1165
0500000US36071,36,071,Orange County,378227,337960,40267
0500000US37079,37,079,Greene County,21008,19408,1600
0500000US37121,37,121,Mitchell County,15040,14543,497
0500000US37041,37,041,Chowan County,14205,13883,322
0500000US37027,37,027,Caldwell County,81779,78949,2830
0500000US37035,37,035,Catawba County,156729,145776,10953
0500000US37049,37,049,Craven County,103082,98427,4655
0500000US37065,37,065,Edgecombe County,53332,52167,1165
0500000US37085,37,085,Harnett County,130361,122527,7834
0500000US37089,37,089,Henderson County,113625,105367,8258
0500000US37095,37,095,Hyde County,5393,5154,239
0500000US37119,37,119,Mecklenburg County,1054314,895964,158350
0500000US37131,37,131,Northampton County,20186,19861,325
0500000US37159,37,159,Rowan County,139605,133333,6272
0500000US37181,37,181,Vance County,44482,42289,2193
0500000US37053,37,053,Currituck County,25796,25276,520
0500000US37179,37,179,Union County,226694,206230,20464
0500000US37067,37,067,Forsyth County,371573,338962,32611
0500000US37127,37,127,Nash County,94003,90021,3982
0500000US37017,37,017,Bladen County,33778,32364,1414
0500000US37055,37,055,Dare County,35741,34028,1713
0500000US37185,37,185,Warren County,20033,19382,651
0500000US37195,37,195,Wilson County,81336,76324,5012
0500000US37015,37,015,Bertie County,19644,19470,174
0500000US37073,37,073,Gates County,11563,11497,66
0500000US37075,37,075,Graham County,8557,8474,83
0500000US37117,37,117,Martin County,23054,22611,443
0500000US37115,37,115,Madison County,21405,20997,408
0500000US37137,37,137,Pamlico County,12742,12376,366
0500000US37143,37,143,Perquimans County,13459,13181,278
0500000US37149,37,149,Polk County,20458,19718,740
0500000US37151,37,151,Randolph County,142958,133730,9228
0500000US37157,37,157,Rockingham County,91270,87854,3416
0500000US37169,37,169,Stokes County,45905,45199,706
0500000US37187,37,187,Washington County,12156,11849,307
0500000US37029,37,029,Camden County,10447,10145,302
0500000US37043,37,043,Clay County,10813,10469,344
0500000US37051,37,051,Cumberland County,332106,310865,21241
0500000US37071,37,071,Gaston County,216585,204586,11999
0500000US37081,37,081,Guilford County,523582,469638,53944
0500000US37099,37,099,Jackson County,42256,40989,1267
0500000US37125,37,125,Moore County,95629,91348,4281
0500000US37155,37,155,Robeson County,133442,127802,5640
0500000US37167,37,167,Stanly County,61114,59265,1849
0500000US37183,37,183,Wake County,1046558,908101,138457
0500000US37199,37,199,Yancey County,17667,17117,550
0500000US37037,37,037,Chatham County,69791,63742,6049
0500000US37111,37,111,McDowell County,45109,43357,1752
0500000US37101,37,101,Johnston County,191172,176492,14680
0500000US37103,37,103,Jones County,9695,9415,280
0500000US37145,37,145,Person County,39305,38136,1169
0500000US37019,37,019,Brunswick County,126860,121798,5062
0500000US37009,37,009,Ashe County,26786,25838,948
0500000US37013,37,013,Beaufort County,47243,45840,1403
0500000US37107,37,107,Lenoir County,57227,54754,2473
0500000US37109,37,109,Lincoln County,81441,77510,3931
0500000US37133,37,133,Onslow County,193912,186228,7684
0500000US37135,37,135,Orange County,142938,123954,18984
0500000US37161,37,161,Rutherford County,66532,64901,1631
0500000US37163,37,163,Sampson County,63561,57330,6231
0500000US37197,37,197,Yadkin County,37665,35782,1883
0500000US37011,37,011,Avery County,17501,16926,575
0500000US37023,37,023,Burke County,89712,85764,3948
0500000US37033,37,033,Caswell County,22746,22179,567
0500000US37059,37,059,Davie County,41991,40023,1968
0500000US37061,37,061,Duplin County,59062,52078,6984
0500000US37063,37,063,Durham County,306457,264164,42293
0500000US37105,37,105,Lee County,60125,53909,6216
0500000US37129,37,129,New Hanover County,224231,212857,11374
0500000US37191,37,191,Wayne County,124002,114395,9607
0500000US37165,37,165,Scotland County,35262,34456,806
0500000US37083,37,083,Halifax County,51737,50716,1021
0500000US37001,37,001,Alamance County,160576,147921,12655
0500000US38013,38,013,Burke County,2213,2153,60
0500000US38061,38,061,Mountrail County,10152,9866,286
0500000US38105,38,105,Williams County,34061,32139,1922
0500000US38007,38,007,Billings County,946,916,30
0500000US38043,38,043,Kidder County,2460,2419,41
0500000US38019,38,019,Cavalier County,3824,3791,33
0500000US38037,38,037,Grant County,2380,2363,17
0500000US38067,38,067,Pembina County,7016,6719,297
0500000US38091,38,091,Steele County,1910,1888,22
0500000US38041,38,041,Hettinger County,2576,2547,29
0500000US38045,38,045,LaMoure County,4100,4026,74
0500000US38059,38,059,Morton County,30544,30102,442
0500000US38017,38,017,Cass County,174202,161665,12537
0500000US38025,38,025,Dunn County,4387,4287,100
0500000US38029,38,029,Emmons County,3352,3303,49
0500000US38051,38,051,McIntosh County,2654,2594,60
0500000US38063,38,063,Nelson County,2920,2862,58
0500000US38077,38,077,Richland County,16288,16001,287
0500000US38079,38,079,Rolette County,14603,14539,64
0500000US38099,38,099,Walsh County,10802,10364,438
0500000US38001,38,001,Adams County,2351,2277,74
0500000US38009,38,009,Bottineau County,6589,6418,171
0500000US38003,38,003,Barnes County,10836,10651,185
0500000US38027,38,027,Eddy County,2313,2306,7
0500000US38035,38,035,Grand Forks County,70400,66610,3790
0500000US38053,38,053,McKenzie County,12536,12217,319
0500000US38057,38,057,Mercer County,8570,8454,116
0500000US38055,38,055,McLean County,9608,9496,112
0500000US38069,38,069,Pierce County,4210,4160,50
0500000US38073,38,073,Ransom County,5361,5188,173
0500000US38085,38,085,Sioux County,4413,4408,5
0500000US38011,38,011,Bowman County,3195,3172,23
0500000US38033,38,033,Golden Valley County,1882,1872,10
0500000US38047,38,047,Logan County,1927,1908,19
0500000US38095,38,095,Towner County,2246,2158,88
0500000US38093,38,093,Stutsman County,21064,20674,390
0500000US38023,38,023,Divide County,2369,2236,133
0500000US38031,38,031,Foster County,3290,3262,28
0500000US38081,38,081,Sargent County,3883,3756,127
0500000US38087,38,087,Slope County,704,703,1
0500000US38089,38,089,Stark County,30876,29872,1004
0500000US39053,39,053,Gallia County,30195,29934,261
0500000US39077,39,077,Huron County,58457,57222,1235
0500000US39009,39,009,Athens County,65936,62920,3016
0500000US39001,39,001,Adams County,27878,27698,180
0500000US39103,39,103,Medina County,177257,172175,5082
0500000US39159,39,159,Union County,55654,53168,2486
0500000US39021,39,021,Champaign County,38864,38466,398
0500000US39125,39,125,Paulding County,18872,18607,265
0500000US39057,39,057,Greene County,165811,157688,8123
0500000US39049,39,049,Franklin County,1275333,1139762,135571
0500000US39101,39,101,Marion County,65344,64359,985
0500000US39115,39,115,Morgan County,14702,14617,85
0500000US39169,39,169,Wayne County,116208,113674,2534
0500000US39175,39,175,Wyandot County,22107,21662,445
0500000US39017,39,017,Butler County,378294,356470,21824
0500000US39067,39,067,Harrison County,15307,15203,104
0500000US39083,39,083,Knox County,61215,60470,745
0500000US39139,39,139,Richland County,121324,119480,1844
0500000US39163,39,163,Vinton County,13111,13067,44
0500000US39063,39,063,Hancock County,75690,72782,2908
0500000US39045,39,045,Fairfield County,152910,147935,4975
0500000US39039,39,039,Defiance County,38279,37517,762
0500000US39069,39,069,Henry County,27316,26896,420
0500000US39081,39,081,Jefferson County,66886,66009,877
0500000US39137,39,137,Putnam County,33969,33565,404
0500000US39027,39,027,Clinton County,41896,41299,597
0500000US39047,39,047,Fayette County,28645,28146,499
0500000US39129,39,129,Pickaway County,57420,56707,713
0500000US39091,39,091,Logan County,45307,44731,576
0500000US39153,39,153,Summit County,541810,514566,27244
0500000US39143,39,143,Sandusky County,59299,58491,808
0500000US39149,39,149,Shelby County,48797,47874,923
0500000US27033,27,033,Cottonwood County,11372,10718,654
0500000US27139,27,139,Scott County,143372,130197,13175
0500000US27039,27,039,Dodge County,20582,20103,479
0500000US27157,27,157,Wabasha County,21500,21079,421
0500000US27117,27,117,Pipestone County,9185,8587,598
0500000US27035,27,035,Crow Wing County,63855,62957,898
0500000US27107,27,107,Norman County,6559,6438,121
0500000US27171,27,171,Wright County,132745,129094,3651
0500000US27103,27,103,Nicollet County,33783,32279,1504
0500000US27041,27,041,Douglas County,37203,36747,456
0500000US27051,27,051,Grant County,5938,5867,71
0500000US27069,27,069,Kittson County,4337,4227,110
0500000US27079,27,079,Le Sueur County,27983,27195,788
0500000US27087,27,087,Mahnomen County,5506,5460,46
0500000US27025,27,025,Chisago County,54727,53781,946
0500000US27127,27,127,Redwood County,15331,14975,356
0500000US27173,27,173,Yellow Medicine County,9868,9695,173
0500000US27153,27,153,Todd County,24440,23606,834
0500000US27007,27,007,Beltrami County,46117,45325,792
0500000US27013,27,013,Blue Earth County,66322,63375,2947
0500000US27055,27,055,Houston County,18663,18463,200
0500000US27073,27,073,Lac qui Parle County,6773,6595,178
0500000US27077,27,077,Lake of the Woods County,3809,3759,50
0500000US27111,27,111,Otter Tail County,57992,56536,1456
0500000US27161,27,161,Waseca County,18809,18139,670
0500000US27137,27,137,St. Louis County,200080,195406,4674
0500000US27003,27,003,Anoka County,347431,317848,29583
0500000US27145,27,145,Stearns County,156819,146192,10627
0500000US27081,27,081,Lincoln County,5707,5669,38
0500000US27089,27,089,Marshall County,9392,9231,161
0500000US27095,27,095,Mille Lacs County,25728,25326,402
0500000US27163,27,163,Washington County,253317,235984,17333
0500000US27017,27,017,Carlton County,35540,35119,421
0500000US27065,27,065,Kanabec County,16004,15835,169
0500000US27071,27,071,Koochiching County,12644,11909,735
0500000US27097,27,097,Morrison County,32949,32505,444
0500000US27131,27,131,Rice County,65765,60651,5114
0500000US27147,27,147,Steele County,36676,35133,1543
0500000US27125,27,125,Red Lake County,4008,3963,45
0500000US27001,27,001,Aitkin County,15834,15635,199
0500000US27043,27,043,Faribault County,13896,13598,298
0500000US27101,27,101,Murray County,8353,8098,255
0500000US27067,27,067,Kandiyohi County,42658,39116,3542
0500000US27075,27,075,Lake County,10569,10365,204
0500000US27133,27,133,Rock County,9413,9249,164
0500000US27143,27,143,Sibley County,14912,14100,812
0500000US27155,27,155,Traverse County,3337,3278,59
0500000US27005,27,005,Becker County,33773,33251,522
0500000US27053,27,053,Hennepin County,1235478,1061498,173980
0500000US27015,27,015,Brown County,25211,24718,493
0500000US27023,27,023,Chippewa County,12010,11319,691
0500000US27029,27,029,Clearwater County,8812,8717,95
0500000US27057,27,057,Hubbard County,20862,20568,294
0500000US27059,27,059,Isanti County,38974,38369,605
0500000US27091,27,091,Martin County,19964,19733,231
0500000US27099,27,099,Mower County,39602,35662,3940
0500000US27115,27,115,Pine County,29129,28709,420
0500000US27109,27,109,Olmsted County,153065,136349,16716
0500000US27159,27,159,Wadena County,13646,13537,109
0500000US27009,27,009,Benton County,39779,38192,1587
0500000US27047,27,047,Freeborn County,30526,28935,1591
0500000US27085,27,085,McLeod County,35825,34665,1160
0500000US27121,27,121,Pope County,10980,10843,137
0500000US27149,27,149,Stevens County,9784,9281,503
0500000US27151,27,151,Swift County,9411,9185,226
0500000US28051,28,051,Holmes County,18075,18065,10
0500000US28005,28,005,Amite County,12468,12396,72
0500000US28013,28,013,Calhoun County,14571,14134,437
0500000US28141,28,141,Tishomingo County,19478,19170,308
0500000US28153,28,153,Wayne County,20422,20396,26
0500000US48015,48,015,Austin County,29565,26362,3203
0500000US48261,48,261,Kenedy County,595,496,99
0500000US48355,48,355,Nueces County,360486,329700,30786
0500000US48089,48,089,Colorado County,21022,18859,2163
0500000US48409,48,409,San Patricio County,67046,63008,4038
0500000US48379,48,379,Rains County,11473,11086,387
0500000US48381,48,381,Randall County,132475,125494,6981
0500000US48385,48,385,Real County,3389,3289,100
0500000US48411,48,411,San Saba County,5962,5284,678
0500000US48413,48,413,Schleicher County,3061,2685,376
0500000US48431,48,431,Sterling County,1141,1073,68
0500000US48507,48,507,Zavala County,12131,11107,1024
0500000US48057,48,057,Calhoun County,21807,19257,2550
0500000US48065,48,065,Carson County,6032,5918,114
0500000US48155,48,155,Foard County,1408,1357,51
0500000US48161,48,161,Freestone County,19709,18357,1352
0500000US48175,48,175,Goliad County,7531,7334,197
0500000US48193,48,193,Hamilton County,8269,7911,358
0500000US48197,48,197,Hardeman County,3952,3717,235
0500000US48335,48,335,Mitchell County,8558,8045,513
0500000US48045,48,045,Briscoe County,1546,1438,108
0500000US48285,48,285,Lavaca County,19941,19020,921
0500000US48445,48,445,Terry County,12615,11301,1314
0500000US48243,48,243,Jeff Davis County,2234,1901,333
0500000US48247,48,247,Jim Hogg County,5282,5073,209
0500000US48339,48,339,Montgomery County,554445,480685,73760
0500000US48111,48,111,Dallam County,7243,5618,1625
0500000US48479,48,479,Webb County,272053,200653,71400
0500000US48011,48,011,Armstrong County,1916,1877,39
0500000US48069,48,069,Castro County,7787,6224,1563
0500000US48273,48,273,Kleberg County,31425,29551,1874
0500000US48489,48,489,Willacy County,21754,18085,3669
0500000US48107,48,107,Crosby County,5861,5683,178
0500000US48151,48,151,Fisher County,3883,3708,175
0500000US48131,48,131,Duval County,11355,10671,684
0500000US48031,48,031,Blanco County,11279,10628,651
0500000US48241,48,241,Jasper County,35504,34556,948
0500000US48271,48,271,Kinney County,3675,3037,638
0500000US48117,48,117,Deaf Smith County,18899,15787,3112
0500000US48167,48,167,Galveston County,327089,294995,32094
0500000US48283,48,283,La Salle County,7409,6787,622
0500000US48393,48,393,Roberts County,885,858,27
0500000US48457,48,457,Tyler County,21496,21042,454
0500000US48483,48,483,Wheeler County,5482,5040,442
0500000US48037,48,037,Bowie County,93858,89748,4110
0500000US48043,48,043,Brewster County,9216,8610,606
0500000US48263,48,263,Kent County,749,731,18
0500000US48423,48,423,Smith County,225015,206070,18945
0500000US48105,48,105,Crockett County,3633,3295,338
0500000US48199,48,199,Hardin County,56379,55475,904
0500000US48227,48,227,Howard County,36667,32203,4464
0500000US48289,48,289,Leon County,17098,16049,1049
0500000US48337,48,337,Montague County,19409,18470,939
0500000US48365,48,365,Panola County,23440,22595,845
0500000US49027,49,027,Millard County,12733,11701,1032
0500000US49053,49,053,Washington County,160537,151843,8694
0500000US49025,49,025,Kane County,7350,7146,204
0500000US49019,49,019,Grand County,9616,8780,836
0500000US49033,49,033,Rich County,2350,2337,13
0500000US49051,49,051,Wasatch County,30523,28206,2317
0500000US49003,49,003,Box Elder County,53001,51212,1789
0500000US49021,49,021,Iron County,49691,47500,2191
0500000US49041,49,041,Sevier County,21118,20709,409
0500000US49057,49,057,Weber County,247731,229968,17763
0500000US49013,49,013,Duchesne County,20219,19579,640
0500000US49037,49,037,San Juan County,15281,15143,138
0500000US49035,49,035,Salt Lake County,1120805,977829,142976
0500000US49047,49,047,Uintah County,36323,35497,826
0500000US49009,49,009,Daggett County,612,595,17
0500000US49011,49,011,Davis County,340621,325047,15574
0500000US49055,49,055,Wayne County,2694,2577,117
0500000US49007,49,007,Carbon County,20356,19731,625
0500000US49015,49,015,Emery County,10248,10018,230
0500000US49029,49,029,Morgan County,11391,11141,250
0500000US49005,49,005,Cache County,122336,113893,8443
0500000US49017,49,017,Garfield County,5017,4821,196
0500000US49023,49,023,Juab County,10948,10726,222
0500000US50021,50,021,Rutland County,59273,57767,1506
0500000US50019,50,019,Orleans County,26911,25774,1137
0500000US50013,50,013,Grand Isle County,6965,6672,293
0500000US50017,50,017,Orange County,28937,28339,598
0500000US50007,50,007,Chittenden County,162052,147485,14567
0500000US50015,50,015,Lamoille County,25268,24480,788
0500000US50027,50,027,Windsor County,55427,53590,1837
0500000US50005,50,005,Caledonia County,30425,29750,675
0500000US50025,50,025,Windham County,43150,41658,1492
0500000US50001,50,001,Addison County,36939,35231,1708
0500000US50023,50,023,Washington County,58477,56819,1658
0500000US51185,51,185,Tazewell County,42080,41679,401
0500000US51610,51,610,Falls Church city,14067,11432,2635
0500000US51685,51,685,Manassas Park city,16423,10767,5656
0500000US51735,51,735,Poquoson city,12039,11544,495
0500000US51183,51,183,Sussex County,11486,11202,284
0500000US51820,51,820,Waynesboro city,21926,20998,928
0500000US51770,51,770,Roanoke city,99621,92089,7532
0500000US51775,51,775,Salem city,25519,24864,655
0500000US51710,51,710,Norfolk city,245592,227534,18058
0500000US51037,51,037,Charlotte County,12095,11921,174
0500000US51059,51,059,Fairfax County,1143529,786683,356846
0500000US51081,51,081,Greensville County,11659,11451,208
0500000US51095,51,095,James City County,74153,69348,4805
0500000US51167,51,167,Russell County,27408,27234,174
0500000US51173,51,173,Smyth County,31059,30619,440
0500000US51678,51,678,Lexington city,7110,6795,315
0500000US51031,51,031,Campbell County,55170,53720,1450
0500000US51089,51,089,Henry County,51588,50092,1496
0500000US51099,51,099,King George County,25890,25244,646
0500000US51103,51,103,Lancaster County,10804,10491,313
0500000US51105,51,105,Lee County,24134,23849,285
0500000US51115,51,115,Mathews County,8796,8703,93
0500000US51119,51,119,Middlesex County,10700,10509,191
0500000US51149,51,149,Prince George County,37894,36468,1426
0500000US51165,51,165,Rockingham County,79444,74808,4636
0500000US51169,51,169,Scott County,22009,21737,272
0500000US51181,51,181,Surry County,6600,6514,86
0500000US51011,51,011,Appomattox County,15577,15388,189
0500000US51067,51,067,Franklin County,56233,55095,1138
0500000US51097,51,097,King and Queen County,7052,6864,188
0500000US51121,51,121,Montgomery County,97997,90269,7728
0500000US51127,51,127,New Kent County,21103,20521,582
0500000US51049,51,049,Cumberland County,9786,9681,105
0500000US51075,51,075,Goochland County,22482,21637,845
0500000US51083,51,083,Halifax County,34779,34100,679
0500000US51113,51,113,Madison County,13139,12825,314
0500000US51153,51,153,Prince William County,456749,347542,109207
0500000US51175,51,175,Southampton County,17939,17841,98
0500000US51091,51,091,Highland County,2214,2206,8
0500000US51025,51,025,Brunswick County,16665,16329,336
0500000US51033,51,033,Caroline County,30184,29265,919
0500000US51073,51,073,Gloucester County,37161,36329,832
0500000US51131,51,131,Northampton County,11957,11297,660
0500000US51141,51,141,Patrick County,17859,17525,334
0500000US51145,51,145,Powhatan County,28574,27917,657
0500000US51163,51,163,Rockbridge County,22509,21912,597
0500000US51171,51,171,Shenandoah County,43045,41131,1914
0500000US51061,51,061,Fauquier County,69115,64566,4549
0500000US51036,51,036,Charles City County,6995,6880,115
0500000US51047,51,047,Culpeper County,50450,46026,4424
0500000US51053,51,053,Dinwiddie County,28308,27478,830
0500000US51079,51,079,Greene County,19410,18557,853
0500000US51085,51,085,Hanover County,104449,100535,3914
0500000US51111,51,111,Lunenburg County,12278,11561,717
0500000US51137,51,137,Orange County,35612,33787,1825
0500000US51595,51,595,Emporia city,5381,5218,163
0500000US51197,51,197,Wythe County,28940,28799,141
0500000US51550,51,550,Chesapeake city,237820,224332,13488
0500000US51660,51,660,Harrisonburg city,53391,44204,9187
0500000US51003,51,003,Albemarle County,106355,94881,11474
0500000US51019,51,019,Bedford County,77908,75708,2200
0500000US51023,51,023,Botetourt County,33222,32284,938
0500000US51195,51,195,Wise County,39025,38608,417
0500000US51520,51,520,Bristol city,16843,16689,154
0500000US51740,51,740,Portsmouth city,95311,92267,3044
0500000US51830,51,830,Williamsburg city,14788,13689,1099
0500000US51005,51,005,Alleghany County,15286,15128,158
0500000US51035,51,035,Carroll County,29738,29106,632
0500000US51191,51,191,Washington County,54406,53592,814
0500000US51133,51,133,Northumberland County,12223,12012,211
0500000US51139,51,139,Page County,23749,23405,344
0500000US51187,51,187,Warren County,39449,38170,1279
0500000US51510,51,510,Alexandria city,156505,113143,43362
0500000US51630,51,630,Fredericksburg city,28469,25996,2473
0500000US51650,51,650,Hampton city,135583,128962,6621
0500000US51013,51,013,Arlington County,231803,177023,54780
0500000US51670,51,670,Hopewell city,22408,21550,858
0500000US51027,51,027,Buchanan County,22138,21729,409
0500000US51069,51,069,Frederick County,85153,79887,5266
0500000US51179,51,179,Stafford County,144012,131043,12969
0500000US51199,51,199,York County,67587,62092,5495
0500000US51760,51,760,Richmond city,223787,208775,15012
0500000US51125,51,125,Nelson County,14812,14309,503
0500000US51143,51,143,Pittsylvania County,61676,60400,1276
0500000US51720,51,720,Norton city,3990,3880,110
0500000US51065,51,065,Fluvanna County,26282,25342,940
0500000US51007,51,007,Amelia County,12854,12724,130
0500000US51840,51,840,Winchester city,27789,24345,3444
0500000US51001,51,001,Accomack County,32742,30632,2110
0500000US51063,51,063,Floyd County,15666,15197,469
0500000US51077,51,077,Grayson County,15811,15473,338
0500000US51135,51,135,Nottoway County,15500,14821,679
0500000US54033,54,033,Harrison County,68209,67568,641
0500000US54069,54,069,Ohio County,42547,41884,663
0500000US54013,54,013,Calhoun County,7396,7326,70
0500000US54065,54,065,Morgan County,17624,17320,304
0500000US54081,54,081,Raleigh County,76232,75129,1103
0500000US54007,54,007,Braxton County,14282,14270,12
0500000US54001,54,001,Barbour County,16730,16656,74
0500000US54047,54,047,McDowell County,19217,19045,172
0500000US54099,54,099,Wayne County,40708,40314,394
0500000US54109,54,109,Wyoming County,21711,21635,76
0500000US54035,54,035,Jackson County,29018,28814,204
0500000US54055,54,055,Mercer County,60486,59849,637
0500000US54097,54,097,Upshur County,24605,24468,137
0500000US54101,54,101,Webster County,8518,8494,24
0500000US54003,54,003,Berkeley County,113495,109475,4020
0500000US54019,54,019,Fayette County,44126,43860,266
0500000US54023,54,023,Grant County,11641,11627,14
0500000US54027,54,027,Hampshire County,23363,23173,190
0500000US54089,54,089,Summers County,13018,12919,99
0500000US54009,54,009,Brooke County,22772,22485,287
0500000US54017,54,017,Doddridge County,8536,8481,55
0500000US54025,54,025,Greenbrier County,35347,34891,456
0500000US54031,54,031,Hardy County,13842,13405,437
0500000US54049,54,049,Marion County,56497,55803,694
0500000US54057,54,057,Mineral County,27278,27124,154
0500000US54059,54,059,Mingo County,24741,24719,22
0500000US54029,54,029,Hancock County,29680,29335,345
0500000US54041,54,041,Lewis County,16276,16131,145
0500000US54067,54,067,Nicholas County,25324,25055,269
0500000US54075,54,075,Pocahontas County,8531,8440,91
0500000US54095,54,095,Tyler County,8909,8845,64
0500000US54083,54,083,Randolph County,29065,28883,182
0500000US54091,54,091,Taylor County,16951,16780,171
0500000US54105,54,105,Wirt County,5797,5784,13
0500000US54015,54,015,Clay County,8785,8785,0
0500000US54021,54,021,Gilmer County,8205,7934,271
0500000US54061,54,061,Monongalia County,105252,99262,5990
0500000US54063,54,063,Monroe County,13467,13347,120
0500000US54103,54,103,Wetzel County,15614,15504,110
0500000US54011,54,011,Cabell County,95318,93858,1460
0500000US54039,54,039,Kanawha County,185710,182204,3506
0500000US54071,54,071,Pendleton County,7056,7011,45
0500000US54077,54,077,Preston County,33837,33390,447
0500000US53035,53,035,Kitsap County,262475,245599,16876
0500000US53033,53,033,King County,2163257,1676436,486821
0500000US53051,53,051,Pend Oreille County,13219,12732,487
0500000US53055,53,055,San Juan County,16473,15230,1243
0500000US53075,53,075,Whitman County,48593,43284,5309
0500000US53077,53,077,Yakima County,249325,204088,45237
0500000US53015,53,015,Cowlitz County,105112,100830,4282
0500000US53019,53,019,Ferry County,7576,7468,108
0500000US53041,53,041,Lewis County,76947,73231,3716
0500000US53027,53,027,Grays Harbor County,71967,68410,3557
0500000US53029,53,029,Island County,81636,75821,5815
0500000US53069,53,069,Wahkiakum County,4189,4057,132
0500000US53021,53,021,Franklin County,90660,70173,20487
0500000US53025,53,025,Grant County,94860,76927,17933
0500000US53073,53,073,Whatcom County,216812,194650,22162
0500000US53047,53,047,Okanogan County,41638,37361,4277
0500000US53037,53,037,Kittitas County,44825,42458,2367
0500000US53005,53,005,Benton County,194168,173605,20563
0500000US53013,53,013,Columbia County,4001,3705,296
0500000US53003,53,003,Asotin County,22337,21735,602
0500000US53023,53,023,Garfield County,2224,2161,63
0500000US53045,53,045,Mason County,62627,58892,3735
0500000US53065,53,065,Stevens County,44214,42902,1312
0500000US53063,53,063,Spokane County,497875,470995,26880
0500000US53007,53,007,Chelan County,75757,66925,8832
0500000US55105,55,105,Rock County,161769,154422,7347
0500000US55137,55,137,Waushara County,24116,23390,726
0500000US55001,55,001,Adams County,20073,19546,527
0500000US55007,55,007,Bayfield County,14992,14711,281
0500000US55065,55,065,Lafayette County,16735,16338,397
0500000US55081,55,081,Monroe County,45502,44459,1043
0500000US55093,55,093,Pierce County,41603,40828,775
0500000US55141,55,141,Wood County,73274,71488,1786
0500000US55003,55,003,Ashland County,15712,15524,188
0500000US55015,55,015,Calumet County,49807,48570,1237
0500000US55037,55,037,Florence County,4337,4277,60
0500000US55055,55,055,Jefferson County,84652,81476,3176
0500000US55059,55,059,Kenosha County,168330,157734,10596
0500000US55051,55,051,Iron County,5715,5645,70
0500000US55019,55,019,Clark County,34491,33582,909
0500000US55109,55,109,St. Croix County,87917,85748,2169
0500000US55083,55,083,Oconto County,37556,37024,532
0500000US55069,55,069,Lincoln County,27848,27593,255
0500000US55135,55,135,Waupaca County,51444,50402,1042
0500000US55005,55,005,Barron County,45252,44197,1055
0500000US55113,55,113,Sawyer County,16370,16127,243
0500000US55047,55,047,Green Lake County,18757,18175,582
0500000US55077,55,077,Marquette County,15207,14922,285
0500000US55075,55,075,Marinette County,40537,39965,572
0500000US55101,55,101,Racine County,195398,186179,9219
0500000US55139,55,139,Winnebago County,169926,163940,5986
0500000US55041,55,041,Forest County,9018,8926,92
0500000US55043,55,043,Grant County,51828,50946,882
0500000US55107,55,107,Rusk County,14183,13979,204
0500000US55117,55,117,Sheboygan County,115205,108602,6603
0500000US55067,55,067,Langlade County,19164,18766,398
0500000US55087,55,087,Outagamie County,184754,177291,7463
0500000US55123,55,123,Vernon County,30516,30138,378
0500000US55021,55,021,Columbia County,56954,55571,1383
0500000US55061,55,061,Kewaunee County,20360,19943,417
0500000US55009,55,009,Brown County,259786,244518,15268
0500000US55073,55,073,Marathon County,135264,129656,5608
0500000US55085,55,085,Oneida County,35345,34769,576
0500000US55121,55,121,Trempealeau County,29438,28172,1266
0500000US55129,55,129,Washburn County,15689,15521,168
0500000US55027,55,027,Dodge County,87776,86002,1774
0500000US55127,55,127,Walworth County,103013,96597,6416
0500000US55023,55,023,Crawford County,16288,16151,137
0500000US55071,55,071,Manitowoc County,79407,77288,2119
0500000US55111,55,111,Sauk County,63596,61800,1796
0500000US55013,55,013,Burnett County,15258,15090,168
0500000US55017,55,017,Chippewa County,63635,62825,810
0500000US55029,55,029,Door County,27439,26619,820
0500000US55031,55,031,Douglas County,43402,42383,1019
0500000US55053,55,053,Jackson County,20506,20051,455
0500000US55049,55,049,Iowa County,23620,23191,429
0500000US55089,55,089,Ozaukee County,88284,83948,4336
0500000US55103,55,103,Richland County,17539,17107,432
0500000US56005,56,005,Campbell County,47708,46272,1436
0500000US56019,56,019,Johnson County,8515,8415,100
0500000US56025,56,025,Natrona County,80610,78522,2088
0500000US56009,56,009,Converse County,13997,13722,275
0500000US56027,56,027,Niobrara County,2448,2442,6
0500000US56039,56,039,Teton County,23059,20481,2578
0500000US56037,56,037,Sweetwater County,44117,41766,2351
0500000US56031,56,031,Platte County,8673,8433,240
0500000US56033,56,033,Sheridan County,30012,29369,643
0500000US56003,56,003,Big Horn County,11901,11526,375
0500000US56011,56,011,Crook County,7410,7352,58
0500000US56029,56,029,Park County,29121,28407,714
0500000US56001,56,001,Albany County,38102,35313,2789
0500000US56007,56,007,Carbon County,15477,14562,915
0500000US56015,56,015,Goshen County,13438,13150,288
0500000US56041,56,041,Uinta County,20609,19966,643
0500000US56043,56,043,Washakie County,8129,8019,110
0500000US56017,56,017,Hot Springs County,4680,4666,14
0500000US56013,56,013,Fremont County,40076,39581,495
0500000US56035,56,035,Sublette County,9951,9642,309
0500000US56045,56,045,Weston County,7100,6806,294
0500000US01099,01,099,Monroe County,21512,21376,136
0500000US01079,01,079,Lawrence County,33171,32847,324
0500000US01081,01,081,Lee County,159287,150602,8685
0500000US01107,01,107,Pickens County,20298,19635,663
0500000US01119,01,119,Sumter County,12985,12717,268
0500000US01023,01,023,Choctaw County,13075,13010,65
0500000US01091,01,091,Marengo County,19538,19451,87
0500000US01113,01,113,Russell County,58213,56732,1481
0500000US01039,01,039,Covington County,37351,37073,278
0500000US01041,01,041,Crenshaw County,13865,13595,270
0500000US01077,01,077,Lauderdale County,92585,90680,1905
0500000US01085,01,085,Lowndes County,10236,10204,32
0500000US01083,01,083,Limestone County,93052,89613,3439
0500000US01115,01,115,St. Clair County,87306,85807,1499
0500000US01133,01,133,Winston County,23875,23616,259
0500000US01043,01,043,Cullman County,82313,80328,1985
0500000US01051,01,051,Elmore County,81212,79766,1446
0500000US01071,01,071,Jackson County,52094,51195,899
0500000US01121,01,121,Talladega County,80565,79174,1391
0500000US01129,01,129,Washington County,16643,16468,175
0500000US01031,01,031,Coffee County,51288,49448,1840
0500000US01103,01,103,Morgan County,119122,114075,5047
0500000US01021,01,021,Chilton County,43930,41960,1970
0500000US01033,01,033,Colbert County,54495,53590,905
0500000US01045,01,045,Dale County,49255,47618,1637
0500000US01055,01,055,Etowah County,102939,99962,2977
0500000US01049,01,049,DeKalb County,71200,65875,5325
0500000US01075,01,075,Lamar County,13933,13847,86
0500000US01111,01,111,Randolph County,22574,22214,360
0500000US01097,01,097,Mobile County,414659,401061,13598
0500000US01127,01,127,Walker County,64493,63590,903
0500000US01029,01,029,Cleburne County,14938,14713,225
0500000US01063,01,063,Greene County,8426,8418,8
0500000US01005,01,005,Barbour County,25782,25136,646
0500000US01011,01,011,Bullock County,10352,10256,96
0500000US01015,01,015,Calhoun County,115098,112039,3059
0500000US01025,01,025,Clarke County,24387,24294,93
0500000US01101,01,101,Montgomery County,226941,216322,10619
0500000US01095,01,095,Marshall County,95145,88900,6245
0500000US01067,01,067,Henry County,17124,16939,185
0500000US01089,01,089,Madison County,357560,337989,19571
0500000US01123,01,123,Tallapoosa County,40636,40039,597
0500000US01131,01,131,Wilcox County,10809,10751,58
0500000US02068,02,068,Denali Borough,2232,2005,227
0500000US02122,02,122,Kenai Peninsula Borough,58220,56404,1816
0500000US02016,02,016,Aleutians West Census Area,5750,3470,2280
0500000US02060,02,060,Bristol Bay Borough,890,873,17
0500000US02150,02,150,Kodiak Island Borough,13649,11002,2647
0500000US02188,02,188,Northwest Arctic Borough,7734,7637,97
0500000US02050,02,050,Bethel Census Area,18040,17673,367
0500000US02185,02,185,North Slope Borough,9797,9223,574
0500000US02220,02,220,Sitka City and Borough,8738,8045,693
0500000US02090,02,090,Fairbanks North Star Borough,99653,94517,5136
0500000US02130,02,130,Ketchikan Gateway Borough,13804,12645,1159
0500000US02170,02,170,Matanuska-Susitna Borough,103464,99739,3725
0500000US02180,02,180,Nome Census Area,9925,9640,285
0500000US02070,02,070,Dillingham Census Area,4975,4832,143
0500000US02100,02,100,Haines Borough,2518,2353,165
0500000US02282,02,282,Yakutat City and Borough,689,635,54
0500000US02110,02,110,Juneau City and Borough,32330,29446,2884
0500000US02164,02,164,Lake and Peninsula Borough,1375,1336,39
0500000US02240,02,240,Southeast Fairbanks Census Area,6876,6196,680
0500000US02290,02,290,Yukon-Koyukuk Census Area,5415,5338,77
0500000US02020,02,020,Anchorage Municipality,296112,264444,31668
0500000US02013,02,013,Aleutians East Borough,3425,2307,1118
0500000US02230,02,230,Skagway Municipality,1061,989,72
0500000US02198,02,198,Prince of Wales-Hyder Census Area,6474,6300,174
0500000US02195,02,195,Petersburg Borough,3255,2896,359
0500000US02158,02,158,Kusilvak Census Area,8198,8109,89
0500000US04013,04,013,Maricopa County,4253913,3620968,632945
0500000US04009,04,009,Graham County,37879,36506,1373
0500000US04023,04,023,Santa Cruz County,46584,31620,14964
0500000US04012,04,012,La Paz County,20701,18428,2273
0500000US04015,04,015,Mohave County,206064,192176,13888
0500000US04005,04,005,Coconino County,140217,133424,6793
0500000US04027,04,027,Yuma County,207829,152329,55500
0500000US04011,04,011,Greenlee County,9504,9201,303
0500000US04021,04,021,Pinal County,419721,381159,38562
0500000US05123,05,123,St. Francis County,26294,25915,379
0500000US05145,05,145,White County,78804,76581,2223
0500000US05099,05,099,Nevada County,8440,8390,50
0500000US05037,05,037,Cross County,16998,16926,72
0500000US05043,05,043,Drew County,18502,18282,220
0500000US05027,05,027,Columbia County,23892,23420,472
0500000US05125,05,125,Saline County,118009,114390,3619
0500000US05141,05,141,Van Buren County,16684,16501,183
0500000US05065,05,065,Izard County,13559,13307,252
0500000US05079,05,079,Lincoln County,13695,13441,254
0500000US05083,05,083,Logan County,21757,21361,396
0500000US05035,05,035,Crittenden County,49013,48202,811
0500000US05047,05,047,Franklin County,17780,17463,317
0500000US05109,05,109,Pike County,10808,10368,440
0500000US05069,05,069,Jefferson County,70424,69318,1106
0500000US05097,05,097,Montgomery County,8993,8691,302
0500000US05127,05,127,Scott County,10442,10237,205
0500000US05131,05,131,Sebastian County,127461,115954,11507
0500000US05007,05,007,Benton County,258980,229609,29371
0500000US05017,05,017,Chicot County,10826,10602,224
0500000US05071,05,071,Johnson County,26291,23840,2451
0500000US05077,05,077,Lee County,9398,9311,87
0500000US05041,05,041,Desha County,11887,11419,468
0500000US05049,05,049,Fulton County,12139,11989,150
0500000US05051,05,051,Garland County,98296,94871,3425
0500000US05115,05,115,Pope County,63644,60319,3325
0500000US05117,05,117,Prairie County,8244,8239,5
0500000US39161,39,161,Van Wert County,28281,28123,158
0500000US39167,39,167,Washington County,60671,59859,812
0500000US39171,39,171,Williams County,36936,36527,409
0500000US39011,39,011,Auglaize County,45784,45307,477
0500000US39029,39,029,Columbiana County,104003,102949,1054
0500000US39037,39,037,Darke County,51734,51166,568
0500000US39123,39,123,Ottawa County,40709,40270,439
0500000US39051,39,051,Fulton County,42305,41617,688
0500000US39065,39,065,Hardin County,31542,31090,452
0500000US39079,39,079,Jackson County,32524,32226,298
0500000US39095,39,095,Lucas County,432379,415835,16544
0500000US39117,39,117,Morrow County,34976,34824,152
0500000US39121,39,121,Noble County,14443,14338,105
0500000US39135,39,135,Preble County,41207,40851,356
0500000US39147,39,147,Seneca County,55475,54498,977
0500000US39151,39,151,Stark County,373475,365574,7901
0500000US39003,39,003,Allen County,103642,102210,1432
0500000US39031,39,031,Coshocton County,36574,36347,227
0500000US39033,39,033,Crawford County,42021,41532,489
0500000US39041,39,041,Delaware County,197008,182719,14289
0500000US39059,39,059,Guernsey County,39274,38902,372
0500000US39073,39,073,Hocking County,28495,28301,194
0500000US39107,39,107,Mercer County,40806,40272,534
0500000US39141,39,141,Ross County,77051,76284,767
0500000US39035,39,035,Cuyahoga County,1253783,1163154,90629
0500000US39093,39,093,Lorain County,306713,297698,9015
0500000US39109,39,109,Miami County,104800,102744,2056
0500000US39113,39,113,Montgomery County,532034,506330,25704
0500000US39155,39,155,Trumbull County,201794,198704,3090
0500000US39173,39,173,Wood County,129936,125558,4378
0500000US39007,39,007,Ashtabula County,98136,96645,1491
0500000US40001,40,001,Adair County,22113,21732,381
0500000US40137,40,137,Stephens County,43983,42727,1256
0500000US40025,40,025,Cimarron County,2189,2021,168
0500000US40019,40,019,Carter County,48406,46918,1488
0500000US40053,40,053,Grant County,4418,4367,51
0500000US40055,40,055,Greer County,5943,5880,63
0500000US40087,40,087,McClain County,38634,37483,1151
0500000US40091,40,091,McIntosh County,19819,19642,177
0500000US40099,40,099,Murray County,13875,13543,332
0500000US40103,40,103,Noble County,11411,11354,57
0500000US40115,40,115,Ottawa County,31566,30800,766
0500000US40135,40,135,Sequoyah County,41359,40644,715
0500000US40145,40,145,Wagoner County,77850,74885,2965
0500000US40151,40,151,Woods County,9127,8837,290
0500000US40015,40,015,Caddo County,29342,27870,1472
0500000US40101,40,101,Muskogee County,69084,67135,1949
0500000US40107,40,107,Okfuskee County,12115,11910,205
0500000US40013,40,013,Bryan County,45759,44719,1040
0500000US40059,40,059,Harper County,3847,3312,535
0500000US40071,40,071,Kay County,44880,43628,1252
0500000US40035,40,035,Craig County,14493,14263,230
0500000US40143,40,143,Tulsa County,642781,586031,56750
0500000US40017,40,017,Canadian County,136710,130611,6099
0500000US40057,40,057,Harmon County,2721,2549,172
0500000US40077,40,077,Latimer County,10495,10354,141
0500000US40113,40,113,Osage County,47311,46688,623
0500000US40139,40,139,Texas County,21121,15604,5517
0500000US40127,40,127,Pushmataha County,11119,11032,87
0500000US40047,40,047,Garfield County,62190,57893,4297
0500000US40069,40,069,Johnston County,11041,10959,82
0500000US40121,40,121,Pittsburg County,44382,43413,969
0500000US40129,40,129,Roger Mills County,3708,3641,67
0500000US40153,40,153,Woodward County,20967,19704,1263
0500000US40021,40,021,Cherokee County,48599,46913,1686
0500000US40041,40,041,Delaware County,42112,41206,906
0500000US40045,40,045,Ellis County,4072,3972,100
0500000US40051,40,051,Grady County,54733,53567,1166
0500000US40119,40,119,Payne County,81512,75866,5646
0500000US40125,40,125,Pottawatomie County,72000,70526,1474
0500000US40037,40,037,Creek County,71160,69661,1499
0500000US40141,40,141,Tillman County,7515,7019,496
0500000US40149,40,149,Washita County,11432,11132,300
0500000US40033,40,033,Cotton County,5929,5915,14
0500000US40075,40,075,Kiowa County,9001,8822,179
0500000US40079,40,079,Le Flore County,49909,48207,1702
0500000US40089,40,089,McCurtain County,32966,32140,826
0500000US40093,40,093,Major County,7718,7284,434
0500000US40097,40,097,Mayes County,40980,40525,455
0500000US40109,40,109,Oklahoma County,782051,699743,82308
0500000US40039,40,039,Custer County,29209,27225,1984
0500000US40007,40,007,Beaver County,5415,4906,509
0500000US40085,40,085,Love County,9933,9390,543
0500000US40009,40,009,Beckham County,22621,21789,832
0500000US40023,40,023,Choctaw County,14886,14733,153
0500000US40065,40,065,Jackson County,25384,23776,1608
0500000US40081,40,081,Lincoln County,34854,34500,354
0500000US41047,41,047,Marion County,335553,293195,42358
0500000US41029,41,029,Jackson County,214267,201295,12972
0500000US41023,41,023,Grant County,7183,6999,184
0500000US41031,41,031,Jefferson County,23143,21660,1483
0500000US41005,41,005,Clackamas County,405788,373126,32662
0500000US41043,41,043,Linn County,122870,117253,5617
0500000US41057,41,057,Tillamook County,26076,24686,1390
0500000US41001,41,001,Baker County,15984,15615,369
0500000US41033,41,033,Josephine County,85481,81934,3547
0500000US41059,41,059,Umatilla County,76898,68505,8393
0500000US41041,41,041,Lincoln County,47881,45482,2399
0500000US41009,41,009,Columbia County,50851,49513,1338
0500000US41055,41,055,Sherman County,1605,1588,17
0500000US41065,41,065,Wasco County,25866,23701,2165
0500000US41039,41,039,Lane County,368882,346792,22090
0500000US41045,41,045,Malheur County,30431,27423,3008
0500000US41067,41,067,Washington County,581821,480269,101552
0500000US41049,41,049,Morrow County,11215,9324,1891
0500000US41007,41,007,Clatsop County,38562,36664,1898
0500000US41015,41,015,Curry County,22507,21770,737
0500000US41021,41,021,Gilliam County,1907,1868,39
0500000US41037,41,037,Lake County,7843,7601,242
0500000US41061,41,061,Union County,26028,25067,961
0500000US42045,42,045,Delaware County,563527,506415,57112
0500000US42119,42,119,Union County,45114,43819,1295
0500000US42127,42,127,Wayne County,51536,50051,1485
0500000US42043,42,043,Dauphin County,274515,254048,20467
0500000US42053,42,053,Forest County,7351,7219,132
0500000US42089,42,089,Monroe County,167586,150455,17131
0500000US42101,42,101,Philadelphia County,1575522,1357033,218489
0500000US42129,42,129,Westmoreland County,354751,349167,5584
0500000US42013,42,013,Blair County,123842,122325,1517
0500000US42021,42,021,Cambria County,134550,132844,1706
0500000US42011,42,011,Berks County,416642,385556,31086
0500000US42061,42,061,Huntingdon County,45421,44747,674
0500000US42073,42,073,Lawrence County,87382,86020,1362
0500000US42087,42,087,Mifflin County,46362,46013,349
0500000US42041,42,041,Cumberland County,247433,231720,15713
0500000US42003,42,003,Allegheny County,1225561,1155860,69701
0500000US42109,42,109,Snyder County,40466,39845,621
0500000US42115,42,115,Susquehanna County,41340,40649,691
0500000US42039,42,039,Crawford County,86164,85055,1109
0500000US42049,42,049,Erie County,275972,262823,13149
0500000US42057,42,057,Fulton County,14506,14396,110
0500000US42067,42,067,Juniata County,24562,24009,553
0500000US42107,42,107,Schuylkill County,143555,140918,2637
0500000US42131,42,131,Wyoming County,27588,27252,336
0500000US42001,42,001,Adams County,102023,97917,4106
0500000US42005,42,005,Armstrong County,66331,66023,308
0500000US42035,42,035,Clinton County,39074,38543,531
0500000US42025,42,025,Carbon County,63931,62165,1766
0500000US42027,42,027,Centre County,161443,147349,14094
0500000US42097,42,097,Northumberland County,92325,91260,1065
0500000US42095,42,095,Northampton County,301778,278980,22798
0500000US42023,42,023,Cameron County,4686,4579,107
0500000US42121,42,121,Venango County,52376,51997,379
0500000US42007,42,007,Beaver County,166896,163977,2919
0500000US42017,42,017,Bucks County,626370,569958,56412
0500000US42069,42,069,Lackawanna County,211454,199800,11654
0500000US42083,42,083,McKean County,41806,41173,633
0500000US42051,42,051,Fayette County,132289,130586,1703
0500000US42091,42,091,Montgomery County,821301,732616,88685
0500000US42059,42,059,Greene County,37144,36830,314
0500000US42075,42,075,Lebanon County,138674,133038,5636
0500000US42079,42,079,Luzerne County,317884,297596,20288
0500000US42093,42,093,Montour County,18294,17499,795
0500000US42037,42,037,Columbia County,66220,64699,1521
0500000US42019,42,019,Butler County,186566,182054,4512
0500000US42065,42,065,Jefferson County,44084,43817,267
0500000US42071,42,071,Lancaster County,538347,511258,27089
0500000US42099,42,099,Perry County,45924,45382,542
0500000US42105,42,105,Potter County,16937,16776,161
0500000US42117,42,117,Tioga County,41226,40707,519
0500000US44007,44,007,Providence County,634533,516606,117927
0500000US44001,44,001,Bristol County,48900,44424,4476
0500000US44005,44,005,Newport County,83075,77344,5731
0500000US45003,45,003,Aiken County,166926,159149,7777
0500000US45071,45,071,Newberry County,38068,36438,1630
0500000US45037,45,037,Edgefield County,26769,25703,1066
0500000US45027,45,027,Clarendon County,34017,33470,547
0500000US45029,45,029,Colleton County,37568,36535,1033
0500000US45085,45,085,Sumter County,106995,103443,3552
0500000US45063,45,063,Lexington County,286316,271831,14485
0500000US45011,45,011,Barnwell County,21577,21233,344
0500000US45015,45,015,Berkeley County,209065,197749,11316
0500000US45031,45,031,Darlington County,67253,66032,1221
0500000US45043,45,043,Georgetown County,61605,60013,1592
0500000US45091,45,091,York County,258641,245753,12888
0500000US45007,45,007,Anderson County,195995,190362,5633
0500000US45025,45,025,Chesterfield County,46024,44597,1427
0500000US45047,45,047,Greenwood County,70264,67343,2921
0500000US45051,45,051,Horry County,320915,301317,19598
0500000US45055,45,055,Kershaw County,64361,62946,1415
0500000US45075,45,075,Orangeburg County,88454,86823,1631
0500000US45001,45,001,Abbeville County,24657,24325,332
0500000US45009,45,009,Bamberg County,14600,14395,205
0500000US45017,45,017,Calhoun County,14713,14377,336
0500000US45033,45,033,Dillon County,30871,30216,655
0500000US45079,45,079,Richland County,408263,385880,22383
0500000US45039,45,039,Fairfield County,22712,22428,284
0500000US45049,45,049,Hampton County,19807,19285,522
0500000US45045,45,045,Greenville County,498402,457841,40561
0500000US45057,45,057,Lancaster County,89546,85989,3557
0500000US45035,45,035,Dorchester County,155474,148704,6770
0500000US45041,45,041,Florence County,138561,134656,3905
0500000US45059,45,059,Laurens County,66710,65029,1681
0500000US45065,45,065,McCormick County,9606,9385,221
0500000US45077,45,077,Pickens County,122746,118489,4257
0500000US45087,45,087,Union County,27644,27473,171
0500000US45089,45,089,Williamsburg County,31794,31278,516
0500000US46003,46,003,Aurora County,2759,2646,113
0500000US46051,46,051,Grant County,7217,7032,185
0500000US46123,46,123,Tripp County,5468,5410,58
0500000US46071,46,071,Jackson County,3287,3273,14
0500000US46099,46,099,Minnehaha County,186749,173263,13486
0500000US46033,46,033,Custer County,8573,8359,214
0500000US46069,46,069,Hyde County,1331,1318,13
0500000US46025,46,025,Clark County,3673,3648,25
0500000US46049,46,049,Faulk County,2322,2320,2
0500000US46077,46,077,Kingsbury County,4967,4946,21
0500000US46129,46,129,Walworth County,5510,5339,171
0500000US46027,46,027,Clay County,13925,13486,439
0500000US46037,46,037,Day County,5506,5484,22
0500000US46043,46,043,Douglas County,2930,2873,57
0500000US46063,46,063,Harding County,1311,1281,30
0500000US46089,46,089,McPherson County,2364,2351,13
0500000US46109,46,109,Roberts County,10285,10162,123
0500000US46119,46,119,Sully County,1331,1331,0
0500000US46083,46,083,Lincoln County,54914,53553,1361
0500000US46079,46,079,Lake County,12574,12385,189
0500000US46081,46,081,Lawrence County,25234,24595,639
0500000US46029,46,029,Codington County,27993,27529,464
0500000US46019,46,019,Butte County,10177,10101,76
0500000US46031,46,031,Corson County,4168,4158,10
0500000US46045,46,045,Edmunds County,3940,3878,62
0500000US46021,46,021,Campbell County,1435,1423,12
0500000US46007,46,007,Bennett County,3437,3417,20
0500000US46055,46,055,Haakon County,2082,2074,8
0500000US46075,46,075,Jones County,735,729,6
0500000US46093,46,093,Meade County,27424,26933,491
0500000US46125,46,125,Turner County,8264,8201,63
0500000US46013,46,013,Brown County,38840,37399,1441
0500000US46061,46,061,Hanson County,3397,3394,3
0500000US46087,46,087,McCook County,5511,5363,148
0500000US46095,46,095,Mellette County,2055,2049,6
0500000US46105,46,105,Perkins County,2907,2886,21
0500000US46103,46,103,Pennington County,109294,106559,2735
0500000US46127,46,127,Union County,15177,14784,393
0500000US46097,46,097,Miner County,2229,2189,40
0500000US46137,46,137,Ziebach County,2814,2790,24
0500000US46039,46,039,Deuel County,4306,4258,48
0500000US46009,46,009,Bon Homme County,6969,6868,101
0500000US46015,46,015,Brule County,5256,5193,63
0500000US46047,46,047,Fall River County,6774,6660,114
0500000US46053,46,053,Gregory County,4201,4151,50
0500000US46102,46,102,Oglala Lakota County,14335,14288,47
0500000US47119,47,119,Maury County,89776,86220,3556
0500000US47173,47,173,Union County,19293,19162,131
0500000US47125,47,125,Montgomery County,196387,186935,9452
0500000US47043,47,043,Dickson County,51988,50971,1017
0500000US47129,47,129,Morgan County,21596,21438,158
0500000US47061,47,061,Grundy County,13331,13249,82
0500000US47123,47,123,Monroe County,45876,44541,1335
0500000US47079,47,079,Henry County,32279,31858,421
0500000US47029,47,029,Cocke County,35336,35118,218
0500000US47033,47,033,Crockett County,14499,13883,616
0500000US47041,47,041,DeKalb County,19601,18402,1199
0500000US47095,47,095,Lake County,7526,7475,51
0500000US47093,47,093,Knox County,456185,433744,22441
0500000US47101,47,101,Lewis County,11956,11856,100
0500000US47107,47,107,McMinn County,52773,51452,1321
0500000US47117,47,117,Marshall County,32269,31301,968
0500000US47131,47,131,Obion County,30520,29974,546
0500000US47143,47,143,Rhea County,32628,31696,932
0500000US47151,47,151,Scott County,21954,21894,60
0500000US47167,47,167,Tipton County,61446,60446,1000
0500000US47001,47,001,Anderson County,75775,73142,2633
0500000US47045,47,045,Dyer County,37576,36854,722
0500000US47049,47,049,Fentress County,17994,17839,155
0500000US47053,47,053,Gibson County,49175,48608,567
0500000US47065,47,065,Hamilton County,357546,339706,17840
0500000US47105,47,105,Loudon County,51610,47866,3744
0500000US47149,47,149,Rutherford County,307128,285318,21810
0500000US47159,47,159,Smith County,19458,19185,273
0500000US47189,47,189,Wilson County,132663,126290,6373
0500000US47163,47,163,Sullivan County,156734,154114,2620
0500000US47177,47,177,Warren County,40454,38261,2193
0500000US47179,47,179,Washington County,127055,121935,5120
0500000US47005,47,005,Benton County,16112,15931,181
0500000US47013,47,013,Campbell County,39687,39401,286
0500000US47015,47,015,Cannon County,13976,13696,280
0500000US47047,47,047,Fayette County,39692,39010,682
0500000US47067,47,067,Hancock County,6585,6490,95
0500000US47091,47,091,Johnson County,17789,17490,299
0500000US47103,47,103,Lincoln County,33711,33172,539
0500000US47127,47,127,Moore County,6322,6228,94
0500000US47051,47,051,Franklin County,41512,40406,1106
0500000US47009,47,009,Blount County,128443,124723,3720
0500000US47019,47,019,Carter County,56391,55816,575
0500000US47057,47,057,Grainger County,23013,22487,526
0500000US47097,47,097,Lauderdale County,26297,25790,507
0500000US47099,47,099,Lawrence County,42937,42536,401
0500000US47115,47,115,Marion County,28417,28189,228
0500000US47133,47,133,Overton County,22004,21679,325
0500000US47165,47,165,Sumner County,179473,172196,7277
0500000US47169,47,169,Trousdale County,9573,9487,86
0500000US47187,47,187,Williamson County,218648,202177,16471
0500000US47027,47,027,Clay County,7686,7651,35
0500000US47059,47,059,Greene County,68669,67868,801
0500000US47157,47,157,Shelby County,937005,876543,60462
0500000US47175,47,175,Van Buren County,5704,5629,75
0500000US47077,47,077,Henderson County,27859,27513,346
0500000US47081,47,081,Hickman County,24678,24371,307
0500000US47089,47,089,Jefferson County,53247,51920,1327
0500000US47153,47,153,Sequatchie County,14730,14463,267
0500000US47155,47,155,Sevier County,96287,91373,4914
0500000US47017,47,017,Carroll County,28018,27771,247
0500000US47023,47,023,Chester County,17150,16876,274
0500000US47037,47,037,Davidson County,684017,596472,87545
0500000US47087,47,087,Jackson County,11615,11512,103
0500000US47135,47,135,Perry County,7912,7814,98
0500000US47145,47,145,Roane County,52897,52051,846
0500000US47121,47,121,Meigs County,11962,11772,190
0500000US47063,47,063,Hamblen County,63740,59909,3831
0500000US47075,47,075,Haywood County,17779,17479,300
0500000US48143,48,143,Erath County,41482,38249,3233
0500000US48039,48,039,Brazoria County,353999,306625,47374
0500000US48345,48,345,Motley County,1156,1156,0
0500000US48129,48,129,Donley County,3387,3313,74
0500000US48013,48,013,Atascosa County,48828,45780,3048
0500000US48083,48,083,Coleman County,8391,8064,327
0500000US48353,48,353,Nolan County,14966,14126,840
0500000US48229,48,229,Hudspeth County,4098,2588,1510
0500000US48325,48,325,Medina County,49334,46706,2628
0500000US48475,48,475,Ward County,11586,10580,1006
0500000US48213,48,213,Henderson County,80460,76023,4437
0500000US48203,48,203,Harrison County,66645,62406,4239
0500000US48327,48,327,Menard County,2123,1969,154
0500000US48277,48,277,Lamar County,49532,47443,2089
0500000US48149,48,149,Fayette County,25066,23404,1662
0500000US48491,48,491,Williamson County,527057,462984,64073
0500000US48373,48,373,Polk County,47837,44755,3082
0500000US48391,48,391,Refugio County,7236,7070,166
0500000US48055,48,055,Caldwell County,41401,37125,4276
0500000US48487,48,487,Wilbarger County,12906,12337,569
0500000US48383,48,383,Reagan County,3752,2997,755
0500000US48189,48,189,Hale County,34113,30696,3417
0500000US48419,48,419,Shelby County,25478,23024,2454
0500000US48399,48,399,Runnels County,10310,9884,426
0500000US48407,48,407,San Jacinto County,27819,26474,1345
0500000US48451,48,451,Tom Green County,117466,109740,7726
0500000US48469,48,469,Victoria County,91970,85824,6146
0500000US48473,48,473,Waller County,49987,42602,7385
0500000US48485,48,485,Wichita County,131818,122907,8911
0500000US48493,48,493,Wilson County,48198,45782,2416
0500000US48219,48,219,Hockley County,23162,21340,1822
0500000US48323,48,323,Maverick County,57970,40113,17857
0500000US48329,48,329,Midland County,164194,142395,21799
0500000US48297,48,297,Live Oak County,12123,11301,822
0500000US48299,48,299,Llano County,20640,19790,850
0500000US48147,48,147,Fannin County,34175,32356,1819
0500000US48255,48,255,Karnes County,15387,14169,1218
0500000US48041,48,041,Brazos County,219193,189594,29599
0500000US48067,48,067,Cass County,30087,29501,586
0500000US48165,48,165,Gaines County,20321,14566,5755
0500000US48179,48,179,Gray County,22685,20400,2285
0500000US48313,48,313,Madison County,14128,12788,1340
0500000US48237,48,237,Jack County,8842,8319,523
0500000US48259,48,259,Kendall County,41982,39503,2479
0500000US48035,48,035,Bosque County,18122,17030,1092
0500000US48029,48,029,Bexar County,1925865,1669855,256010
0500000US48017,48,017,Bailey County,7092,5779,1313
0500000US48023,48,023,Baylor County,3591,3538,53
0500000US48061,48,061,Cameron County,421750,322499,99251
0500000US48121,48,121,Denton County,807047,686118,120929
0500000US48477,48,477,Washington County,34796,32134,2662
0500000US48343,48,343,Morris County,12424,11987,437
0500000US48429,48,429,Stephens County,9372,8958,414
0500000US48201,48,201,Harris County,4602523,3402752,1199771
0500000US48003,48,003,Andrews County,17818,15227,2591
0500000US48171,48,171,Gillespie County,26208,23403,2805
0500000US48177,48,177,Gonzales County,20667,18150,2517
0500000US48305,48,305,Lynn County,5808,5482,326
0500000US48503,48,503,Young County,18114,17034,1080
0500000US48505,48,505,Zapata County,14369,10497,3872
0500000US48221,48,221,Hood County,56901,55468,1433
0500000US48223,48,223,Hopkins County,36240,33611,2629
0500000US48357,48,357,Ochiltree County,10348,8242,2106
0500000US48269,48,269,King County,228,219,9
0500000US48275,48,275,Knox County,3733,3465,268
0500000US48309,48,309,McLennan County,248429,226734,21695
0500000US48073,48,073,Cherokee County,51903,46774,5129
0500000US48095,48,095,Concho County,4233,3112,1121
0500000US48119,48,119,Delta County,5215,5142,73
0500000US48137,48,137,Edwards County,2055,1962,93
0500000US48133,48,133,Eastland County,18270,17587,683
0500000US48253,48,253,Jones County,19891,19182,709
0500000US48389,48,389,Reeves County,15125,12036,3089
0500000US48403,48,403,Sabine County,10458,10339,119
0500000US48421,48,421,Sherman County,3058,2564,494
0500000US48437,48,437,Swisher County,7484,6762,722
0500000US48231,48,231,Hunt County,92152,86135,6017
0500000US48063,48,063,Camp County,12813,11532,1281
0500000US48195,48,195,Hansford County,5547,4133,1414
0500000US48187,48,187,Guadalupe County,155137,144051,11086
0500000US48077,48,077,Clay County,10387,10107,280
0500000US48217,48,217,Hill County,35399,32790,2609
0500000US48347,48,347,Nacogdoches County,65558,60262,5296
0500000US48369,48,369,Parmer County,9852,7772,2080
0500000US48377,48,377,Presidio County,7123,4211,2912
0500000US48465,48,465,Val Verde County,49027,38212,10815
0500000US48135,48,135,Ector County,158342,137473,20869
0500000US48173,48,173,Glasscock County,1430,1100,330
0500000US48185,48,185,Grimes County,27630,25451,2179
0500000US48085,48,085,Collin County,944350,748933,195417
0500000US48005,48,005,Angelina County,87607,80194,7413
0500000US48101,48,101,Cottle County,1623,1582,41
0500000US48209,48,209,Hays County,204150,186261,17889
0500000US48295,48,295,Lipscomb County,3469,3060,409
0500000US48321,48,321,Matagorda County,36743,32671,4072
0500000US48371,48,371,Pecos County,15797,13636,2161
0500000US48397,48,397,Rockwall County,93642,85145,8497
0500000US48401,48,401,Rusk County,53595,49854,3741
0500000US48447,48,447,Throckmorton County,1567,1561,6
0500000US48471,48,471,Walker County,71539,65546,5993
0500000US48499,48,499,Wood County,43815,42209,1606
0500000US48007,48,007,Aransas County,24763,22991,1772
0500000US48075,48,075,Childress County,7226,6484,742
0500000US48081,48,081,Coke County,3275,3168,107
0500000US48099,48,099,Coryell County,75389,70477,4912
0500000US48211,48,211,Hemphill County,4061,3432,629
0500000US48341,48,341,Moore County,21801,16374,5427
0500000US48349,48,349,Navarro County,48583,42496,6087
0500000US48405,48,405,San Augustine County,8327,8008,319
0500000US48417,48,417,Shackelford County,3311,3219,92
0500000US48427,48,427,Starr County,63894,44642,19252
0500000US48461,48,461,Upton County,3634,3250,384
0500000US48021,48,021,Bastrop County,82577,73571,9006
0500000US48191,48,191,Hall County,3074,2774,300
0500000US48159,48,159,Franklin County,10679,10022,657
0500000US48163,48,163,Frio County,19394,16380,3014
0500000US48281,48,281,Lampasas County,20640,19768,872
0500000US48319,48,319,Mason County,4161,3748,413
0500000US48125,48,125,Dickens County,2216,2096,120
0500000US48439,48,439,Tarrant County,2019977,1695990,323987
0500000US48001,48,001,Anderson County,57863,54247,3616
0500000US48239,48,239,Jackson County,14820,13445,1375
0500000US48331,48,331,Milam County,24664,23531,1133
0500000US48093,48,093,Comanche County,13495,12330,1165
0500000US48047,48,047,Brooks County,7180,6420,760
0500000US19029,19,029,Cass County,13191,12972,219
0500000US19035,19,035,Cherokee County,11468,11354,114
0500000US19047,19,047,Crawford County,17132,14258,2874
0500000US19057,19,057,Des Moines County,39600,38885,715
0500000US19065,19,065,Fayette County,19929,19677,252
0500000US19085,19,085,Harrison County,14143,14071,72
0500000US19109,19,109,Kossuth County,15075,14882,193
0500000US19129,19,129,Mills County,14957,14763,194
0500000US19133,19,133,Monona County,8796,8731,65
0500000US19139,19,139,Muscatine County,42950,40259,2691
0500000US19143,19,143,Osceola County,6115,5870,245
0500000US19153,19,153,Polk County,474274,431709,42565
0500000US19187,19,187,Webster County,36757,35786,971
0500000US19169,19,169,Story County,96922,87543,9379
0500000US19193,19,193,Woodbury County,102398,93769,8629
0500000US19013,19,013,Black Hawk County,133009,125488,7521
0500000US19075,19,075,Grundy County,12341,12212,129
0500000US19097,19,097,Jackson County,19395,19193,202
0500000US19105,19,105,Jones County,20568,20209,359
0500000US19111,19,111,Lee County,34541,34187,354
0500000US19131,19,131,Mitchell County,10631,10547,84
0500000US19181,19,181,Warren County,49361,48716,645
0500000US19161,19,161,Sac County,9868,9716,152
0500000US19149,19,149,Plymouth County,25039,24410,629
0500000US19041,19,041,Clay County,16313,15929,384
0500000US19045,19,045,Clinton County,47218,46392,826
0500000US20183,20,183,Smith County,3663,3649,14
0500000US20067,20,067,Grant County,7616,6372,1244
0500000US20095,20,095,Kingman County,7470,7378,92
0500000US20131,20,131,Nemaha County,10104,9993,111
0500000US20149,20,149,Pottawatomie County,23545,23013,532
0500000US20021,20,021,Cherokee County,20331,20061,270
0500000US20015,20,015,Butler County,66468,64702,1766
0500000US20105,20,105,Lincoln County,3097,3081,16
0500000US20191,20,191,Sumner County,23208,22982,226
0500000US20195,20,195,Trego County,2858,2813,45
0500000US20205,20,205,Wilson County,8780,8688,92
0500000US20207,20,207,Woodson County,3170,3156,14
0500000US20135,20,135,Ness County,2955,2740,215
0500000US20141,20,141,Osborne County,3603,3570,33
0500000US20011,20,011,Bourbon County,14702,14443,259
0500000US20075,20,075,Hamilton County,2616,2176,440
0500000US20097,20,097,Kiowa County,2526,2402,124
0500000US20177,20,177,Shawnee County,178284,171032,7252
0500000US20181,20,181,Sherman County,5966,5816,150
0500000US20193,20,193,Thomas County,7824,7514,310
0500000US20125,20,125,Montgomery County,32970,31981,989
0500000US20127,20,127,Morris County,5566,5461,105
0500000US20153,20,153,Rawlins County,2509,2418,91
0500000US20163,20,163,Rooks County,5118,5076,42
0500000US20025,20,025,Clark County,2053,1996,57
0500000US20053,20,053,Ellsworth County,6293,6187,106
0500000US20077,20,077,Harper County,5673,5582,91
0500000US20167,20,167,Russell County,6977,6865,112
0500000US20111,20,111,Lyon County,33299,29989,3310
0500000US20145,20,145,Pawnee County,6709,6615,94
0500000US20001,20,001,Allen County,12630,12474,156
0500000US20033,20,033,Comanche County,1780,1725,55
0500000US20049,20,049,Elk County,2562,2540,22
0500000US20063,20,063,Gove County,2619,2561,58
0500000US20079,20,079,Harvey County,34555,33058,1497
0500000US20083,20,083,Hodgeman County,1842,1748,94
0500000US20093,20,093,Kearny County,3932,3420,512
0500000US20185,20,185,Stafford County,4214,3991,223
0500000US20113,20,113,McPherson County,28630,28257,373
0500000US20139,20,139,Osage County,15882,15805,77
0500000US20071,20,071,Greeley County,1200,1098,102
0500000US20031,20,031,Coffey County,8296,8235,61
0500000US20037,20,037,Crawford County,39108,37626,1482
0500000US20051,20,051,Ellis County,28878,27982,896
0500000US20073,20,073,Greenwood County,6156,6101,55
0500000US20099,20,099,Labette County,20367,20216,151
0500000US20107,20,107,Linn County,9635,9590,45
0500000US20173,20,173,Sedgwick County,512064,468857,43207
0500000US20175,20,175,Seward County,22692,15840,6852
0500000US20157,20,157,Republic County,4686,4613,73
0500000US20065,20,065,Graham County,2545,2514,31
0500000US20091,20,091,Johnson County,585502,534448,51054
0500000US20045,20,045,Douglas County,119319,110620,8699
0500000US20179,20,179,Sheridan County,2506,2436,70
0500000US20121,20,121,Miami County,33127,32811,316
0500000US20069,20,069,Gray County,6037,5386,651
0500000US20199,20,199,Wallace County,1575,1520,55
0500000US20189,20,189,Stevens County,5686,4643,1043
0500000US20201,20,201,Washington County,5525,5388,137
0500000US20019,20,019,Chautauqua County,3367,3355,12
0500000US20129,20,129,Morton County,2838,2499,339
0500000US20155,20,155,Reno County,63101,61321,1780
0500000US20029,20,029,Cloud County,9060,8881,179
0500000US20043,20,043,Doniphan County,7736,7682,54
0500000US20081,20,081,Haskell County,4047,3247,800
0500000US20101,20,101,Lane County,1642,1616,26
0500000US20171,20,171,Scott County,4949,4492,457
0500000US20133,20,133,Neosho County,16125,15754,371
0500000US20013,20,013,Brown County,9664,9570,94
0500000US20147,20,147,Phillips County,5408,5317,91
0500000US20161,20,161,Riley County,75296,68554,6742
0500000US20039,20,039,Decatur County,2881,2803,78
0500000US20087,20,087,Jefferson County,18888,18761,127
0500000US21031,21,031,Butler County,12745,12529,216
0500000US21061,21,061,Edmonson County,12122,12049,73
0500000US21097,21,097,Harrison County,18668,18496,172
0500000US21023,21,023,Bracken County,8306,8197,109
0500000US21143,21,143,Lyon County,8186,7967,219
0500000US21063,21,063,Elliott County,7517,7499,18
0500000US21111,21,111,Jefferson County,767154,710403,56751
0500000US21123,21,123,Larue County,14156,13834,322
0500000US21161,21,161,Mason County,17153,16814,339
0500000US21167,21,167,Mercer County,21516,20937,579
0500000US21201,21,201,Robertson County,2143,2142,1
0500000US21207,21,207,Russell County,17760,17271,489
0500000US21229,21,229,Washington County,12019,11686,333
0500000US21007,21,007,Ballard County,8090,7918,172
0500000US21009,21,009,Barren County,43680,42919,761
0500000US21087,21,087,Green County,11023,10927,96
0500000US21091,21,091,Hancock County,8719,8642,77
0500000US21159,21,159,Martin County,11919,11895,24
0500000US21093,21,093,Hardin County,108095,103857,4238
0500000US21149,21,149,McLean County,9331,9257,74
0500000US21183,21,183,Ohio County,24071,23786,285
0500000US21197,21,197,Powell County,12321,12220,101
0500000US21233,21,233,Webster County,13155,12698,457
0500000US21033,21,033,Caldwell County,12727,12657,70
0500000US21045,21,045,Casey County,15796,15607,189
0500000US21047,21,047,Christian County,72263,70049,2214
0500000US21085,21,085,Grayson County,26178,25875,303
0500000US21103,21,103,Henry County,15814,15538,276
0500000US21107,21,107,Hopkins County,45664,45095,569
0500000US21109,21,109,Jackson County,13373,13373,0
0500000US21125,21,125,Laurel County,60180,59860,320
0500000US21157,21,157,Marshall County,31166,30813,353
0500000US21163,21,163,Meade County,28326,27832,494
0500000US21173,21,173,Montgomery County,27759,27493,266
0500000US21181,21,181,Nicholas County,7100,7036,64
0500000US21185,21,185,Oldham County,65374,63305,2069
0500000US21187,21,187,Owen County,10741,10737,4
0500000US21203,21,203,Rockcastle County,16827,16798,29
0500000US21209,21,209,Scott County,53517,51615,1902
0500000US21227,21,227,Warren County,126427,114711,11716
0500000US21003,21,003,Allen County,20794,20589,205
0500000US21017,21,017,Bourbon County,20144,19154,990
0500000US21019,21,019,Boyd County,48091,47596,495
0500000US21029,21,029,Bullitt County,79466,78533,933
0500000US21055,21,055,Crittenden County,9083,9039,44
0500000US21067,21,067,Fayette County,318734,288305,30429
0500000US21075,21,075,Fulton County,6210,6153,57
0500000US21115,21,115,Johnson County,22843,22616,227
0500000US21165,21,165,Menifee County,6405,6397,8
0500000US21175,21,175,Morgan County,13285,13116,169
0500000US21193,21,193,Perry County,26917,26492,425
0500000US21237,21,237,Wolfe County,7223,7209,14
0500000US21051,21,051,Clay County,20621,20457,164
0500000US21013,21,013,Bell County,27188,27073,115
0500000US21025,21,025,Breathitt County,13116,13051,65
0500000US21083,21,083,Graves County,37294,36074,1220
0500000US21099,21,099,Hart County,18627,18460,167
0500000US21231,21,231,Wayne County,20609,20333,276
0500000US21155,21,155,Marion County,19232,18926,306
0500000US21221,21,221,Trigg County,14344,14179,165
0500000US21015,21,015,Boone County,129095,122259,6836
0500000US21131,21,131,Leslie County,10472,10442,30
0500000US21121,21,121,Knox County,31467,31062,405
0500000US21127,21,127,Lawrence County,15783,15587,196
0500000US21139,21,139,Livingston County,9263,9235,28
0500000US21195,21,195,Pike County,60483,59977,506
0500000US21211,21,211,Shelby County,46786,43812,2974
0500000US21005,21,005,Anderson County,22214,21912,302
0500000US21027,21,027,Breckinridge County,20080,19945,135
0500000US21073,21,073,Franklin County,50296,48336,1960
0500000US21117,21,117,Kenton County,164688,159654,5034
0500000US21151,21,151,Madison County,89700,87134,2566
0500000US21153,21,153,Magoffin County,12666,12646,20
0500000US21189,21,189,Owsley County,4463,4455,8
0500000US21213,21,213,Simpson County,18063,17693,370
0500000US21217,21,217,Taylor County,25500,25054,446
0500000US21219,21,219,Todd County,12350,12052,298
0500000US21039,21,039,Carlisle County,4841,4807,34
0500000US21053,21,053,Clinton County,10211,10135,76
0500000US21077,21,077,Gallatin County,8703,8458,245
0500000US21079,21,079,Garrard County,17328,17106,222
0500000US21069,21,069,Fleming County,14479,14406,73
0500000US21037,21,037,Campbell County,92267,90311,1956
0500000US22113,22,113,Vermilion Parish,59867,58406,1461
0500000US22089,22,089,St. Charles Parish,52724,50831,1893
0500000US22029,22,029,Concordia Parish,20021,19838,183
0500000US22107,22,107,Tensas Parish,4666,4638,28
0500000US22093,22,093,St. James Parish,21357,21211,146
0500000US22043,22,043,Grant Parish,22348,21593,755
0500000US22051,22,051,Jefferson Parish,435300,378602,56698
0500000US22013,22,013,Bienville Parish,13668,13575,93
0500000US22015,22,015,Bossier Parish,126131,121164,4967
0500000US22023,22,023,Cameron Parish,6868,6535,333
0500000US22037,22,037,East Feliciana Parish,19499,19347,152
0500000US22095,22,095,St. John the Baptist Parish,43446,41898,1548
0500000US22075,22,075,Plaquemines Parish,23373,22061,1312
0500000US22073,22,073,Ouachita Parish,156075,153374,2701
0500000US22079,22,079,Rapides Parish,131546,127899,3647
0500000US22117,22,117,Washington Parish,46457,45782,675
0500000US22097,22,097,St. Landry Parish,83449,82446,1003
0500000US22105,22,105,Tangipahoa Parish,130504,127685,2819
0500000US22001,22,001,Acadia Parish,62568,61565,1003
0500000US22101,22,101,St. Mary Parish,51734,49724,2010
0500000US22123,22,123,West Carroll Parish,11180,11087,93
0500000US22103,22,103,St. Tammany Parish,252093,242310,9783
0500000US22111,22,111,Union Parish,22475,22008,467
0500000US22021,22,021,Caldwell Parish,9996,9750,246
0500000US22017,22,017,Caddo Parish,248361,242705,5656
0500000US22035,22,035,East Carroll Parish,7225,7173,52
0500000US22005,22,005,Ascension Parish,121176,117615,3561
0500000US22055,22,055,Lafayette Parish,240091,230014,10077
0500000US22045,22,045,Iberia Parish,72691,69903,2788
0500000US22087,22,087,St. Bernard Parish,45694,43347,2347
0500000US22091,22,091,St. Helena Parish,10411,10361,50
0500000US22121,22,121,West Baton Rouge Parish,25860,25579,281
0500000US22031,22,031,De Soto Parish,27216,26889,327
0500000US22081,22,081,Red River Parish,8618,8545,73
0500000US22063,22,063,Livingston Parish,138111,134994,3117
0500000US22069,22,069,Natchitoches Parish,38963,38343,620
0500000US22071,22,071,Orleans Parish,389648,367865,21783
0500000US22025,22,025,Catahoula Parish,9893,9842,51
0500000US22019,22,019,Calcasieu Parish,200182,194579,5603
0500000US22041,22,041,Franklin Parish,20322,20243,79
0500000US22007,22,007,Assumption Parish,22714,22384,330
0500000US22049,22,049,Jackson Parish,15926,15719,207
0500000US22083,22,083,Richland Parish,20474,20410,64
0500000US22099,22,099,St. Martin Parish,53752,52799,953
0500000US22127,22,127,Winn Parish,14494,14451,43
0500000US22033,22,033,East Baton Rouge Parish,444094,419728,24366
0500000US22003,22,003,Allen Parish,25661,24660,1001
0500000US22065,22,065,Madison Parish,11472,11391,81
0500000US23017,23,017,Oxford County,57325,56487,838
0500000US23027,23,027,Waldo County,39418,38491,927
0500000US23019,23,019,Penobscot County,151748,147605,4143
0500000US23001,23,001,Androscoggin County,107444,103941,3503
0500000US23003,23,003,Aroostook County,68269,65263,3006
0500000US23005,23,005,Cumberland County,290944,273072,17872
0500000US23013,23,013,Knox County,39823,38727,1096
0500000US23031,23,031,York County,203102,196366,6736
0500000US23007,23,007,Franklin County,30019,29642,377
0500000US23025,23,025,Somerset County,50710,49883,827
0500000US24047,24,047,Worcester County,51564,49233,2331
0500000US24510,24,510,Baltimore city,614700,564882,49818
0500000US24041,24,041,Talbot County,37211,34951,2260
0500000US24025,24,025,Harford County,251025,236994,14031
0500000US24027,24,027,Howard County,315327,248761,66566
0500000US24003,24,003,Anne Arundel County,567696,520444,47252
0500000US24005,24,005,Baltimore County,827625,724649,102976
0500000US24009,24,009,Calvert County,91082,88433,2649
0500000US24023,24,023,Garrett County,29376,29065,311
0500000US24031,24,031,Montgomery County,1040133,704049,336084
0500000US24013,24,013,Carroll County,167522,161173,6349
0500000US24035,24,035,Queen Anne's County,49355,47267,2088
0500000US24037,24,037,St. Mary's County,111531,106149,5382
0500000US24017,24,017,Charles County,157671,148147,9524
0500000US24019,24,019,Dorchester County,32261,31153,1108
0500000US24043,24,043,Washington County,149811,142356,7455
0500000US24045,24,045,Wicomico County,102172,93730,8442
0500000US24015,24,015,Cecil County,102517,98943,3574
0500000US24011,24,011,Caroline County,32875,31318,1557
0500000US25025,25,025,Suffolk County,791766,555792,235974
0500000US25001,25,001,Barnstable County,213690,197042,16648
0500000US25007,25,007,Dukes County,17313,15215,2098
0500000US25017,25,017,Middlesex County,1595192,1259620,335572
0500000US25003,25,003,Berkshire County,127328,119122,8206
0500000US25005,25,005,Bristol County,558905,486633,72272
0500000US25013,25,013,Hampden County,469116,428602,40514
0500000US25023,25,023,Plymouth County,512135,464334,47801
0500000US25009,25,009,Essex County,781024,650735,130289
0500000US25011,25,011,Franklin County,70935,67037,3898
0500000US25021,25,021,Norfolk County,698249,574743,123506
0500000US25015,25,015,Hampshire County,161159,147486,13673
0500000US25019,25,019,Nantucket County,11101,9978,1123
0500000US26115,26,115,Monroe County,149699,146337,3362
0500000US26005,26,005,Allegan County,115250,111635,3615
0500000US26059,26,059,Hillsdale County,45830,45304,526
0500000US26003,26,003,Alger County,9194,9111,83
0500000US26127,26,127,Oceana County,26417,24912,1505
0500000US26089,26,089,Leelanau County,21639,21007,632
0500000US26035,26,035,Clare County,30616,30126,490
0500000US26083,26,083,Keweenaw County,2130,2105,25
0500000US26073,26,073,Isabella County,70775,68314,2461
0500000US26139,26,139,Ottawa County,284034,267832,16202
0500000US26157,26,157,Tuscola County,53250,52805,445
0500000US26007,26,007,Alpena County,28612,28207,405
0500000US26067,26,067,Ionia County,64176,63197,979
0500000US26111,26,111,Midland County,83389,80174,3215
0500000US26021,26,021,Berrien County,154807,145765,9042
0500000US26135,26,135,Oscoda County,8277,8174,103
0500000US26039,26,039,Crawford County,13836,13573,263
0500000US26037,26,037,Clinton County,77896,75405,2491
0500000US26057,26,057,Gratiot County,41067,40656,411
0500000US26063,26,063,Huron County,31543,31070,473
0500000US26091,26,091,Lenawee County,98474,96387,2087
0500000US26105,26,105,Mason County,28884,28299,585
0500000US26117,26,117,Montcalm County,63209,62324,885
0500000US26149,26,149,St. Joseph County,60897,58848,2049
0500000US26147,26,147,St. Clair County,159566,155329,4237
0500000US26161,26,161,Washtenaw County,365961,320470,45491
0500000US26011,26,011,Arenac County,15165,14972,193
0500000US26027,26,027,Cass County,51460,50575,885
0500000US26071,26,071,Iron County,11212,11041,171
0500000US26143,26,143,Roscommon County,23877,23465,412
0500000US26163,26,163,Wayne County,1761382,1604089,157293
0500000US26023,26,023,Branch County,43584,42196,1388
0500000US26075,26,075,Jackson County,158913,156091,2822
0500000US26097,26,097,Mackinac County,10817,10523,294
0500000US26009,26,009,Antrim County,23177,22758,419
0500000US26061,26,061,Houghton County,36360,34654,1706
0500000US26069,26,069,Iosco County,25247,24674,573
0500000US26085,26,085,Lake County,11763,11583,180
0500000US26119,26,119,Montmorency County,9261,9161,100
0500000US26141,26,141,Presque Isle County,12797,12632,165
0500000US26077,26,077,Kalamazoo County,261573,248596,12977
0500000US26107,26,107,Mecosta County,43264,42516,748
0500000US26103,26,103,Marquette County,66939,65591,1348
0500000US26123,26,123,Newaygo County,48142,47154,988
0500000US26133,26,133,Osceola County,23232,23015,217
0500000US26137,26,137,Otsego County,24397,23971,426
0500000US26025,26,025,Calhoun County,134473,129449,5024
0500000US26031,26,031,Cheboygan County,25458,25096,362
0500000US26095,26,095,Luce County,6364,6257,107
0500000US26081,26,081,Kent County,643140,589599,53541
0500000US26099,26,099,Macomb County,868704,773624,95080
0500000US26145,26,145,Saginaw County,192778,188008,4770
0500000US26155,26,155,Shiawassee County,68493,67858,635
0500000US26013,26,013,Baraga County,8507,8382,125
0500000US26017,26,017,Bay County,104786,103256,1530
0500000US26029,26,029,Charlevoix County,26219,25745,474
0500000US26045,26,045,Eaton County,109155,105106,4049
0500000US26041,26,041,Delta County,36190,35739,451
0500000US26053,26,053,Gogebic County,15414,15204,210
0500000US26047,26,047,Emmet County,33039,32433,606
0500000US05147,05,147,Woodruff County,6660,6625,35
0500000US05023,05,023,Cleburne County,25230,24870,360
0500000US05025,05,025,Cleveland County,8226,8094,132
0500000US05067,05,067,Jackson County,17225,17133,92
0500000US05057,05,057,Hempstead County,22018,20822,1196
0500000US05135,05,135,Sharp County,17043,16912,131
0500000US05137,05,137,Stone County,12446,12401,45
0500000US05143,05,143,Washington County,228529,203509,25020
0500000US05005,05,005,Baxter County,41219,40484,735
0500000US05003,05,003,Ashley County,20537,19981,556
0500000US05031,05,031,Craighead County,105701,101303,4398
0500000US05055,05,055,Greene County,44623,44325,298
0500000US05073,05,073,Lafayette County,6915,6792,123
0500000US05105,05,105,Perry County,10322,10267,55
0500000US05107,05,107,Phillips County,19034,18927,107
0500000US05111,05,111,Poinsett County,24054,23898,156
0500000US05133,05,133,Sevier County,17193,14355,2838
0500000US05149,05,149,Yell County,21573,19515,2058
0500000US05013,05,013,Calhoun County,5202,5172,30
0500000US05019,05,019,Clark County,22385,21759,626
0500000US05011,05,011,Bradley County,10948,10215,733
0500000US05095,05,095,Monroe County,7249,7201,48
0500000US05113,05,113,Polk County,20163,19248,915
0500000US05103,05,103,Ouachita County,24106,23970,136
0500000US05101,05,101,Newton County,7848,7794,54
0500000US05081,05,081,Little River County,12417,12380,37
0500000US05015,05,015,Carroll County,27887,25492,2395
0500000US05091,05,091,Miller County,43759,43060,699
0500000US06033,06,033,Lake County,64148,58466,5682
0500000US06043,06,043,Mariposa County,17540,16293,1247
0500000US06115,06,115,Yuba County,75493,66060,9433
0500000US06013,06,013,Contra Costa County,1133247,850039,283208
0500000US06035,06,035,Lassen County,31185,29559,1626
0500000US06083,06,083,Santa Barbara County,443738,342132,101606
0500000US06097,06,097,Sonoma County,501317,418378,82939
0500000US06025,06,025,Imperial County,180216,124173,56043
0500000US06051,06,051,Mono County,14174,11685,2489
0500000US06001,06,001,Alameda County,1643700,1111462,532238
0500000US06067,06,067,Sacramento County,1510023,1195438,314585
0500000US06055,06,055,Napa County,140530,109061,31469
0500000US06053,06,053,Monterey County,433212,303311,129901
0500000US06091,06,091,Sierra County,2930,2865,65
0500000US06073,06,073,San Diego County,3302833,2528468,774365
0500000US06113,06,113,Yolo County,214977,165855,49122
0500000US06023,06,023,Humboldt County,135768,128382,7386
0500000US06003,06,003,Alpine County,1146,1119,27
0500000US06045,06,045,Mendocino County,87422,76100,11322
0500000US06087,06,087,Santa Cruz County,273765,224800,48965
0500000US06037,06,037,Los Angeles County,10098052,6641096,3456956
0500000US06065,06,065,Riverside County,2383286,1867048,516238
0500000US06085,06,085,Santa Clara County,1922200,1177545,744655
0500000US06041,06,041,Marin County,260295,212306,47989
0500000US06093,06,093,Siskiyou County,43540,41285,2255
0500000US06089,06,089,Shasta County,179085,169322,9763
0500000US06015,06,015,Del Norte County,27424,25498,1926
0500000US06021,06,021,Glenn County,27897,22641,5256
0500000US06007,06,007,Butte County,227075,209909,17166
0500000US06063,06,063,Plumas County,18699,17944,755
0500000US06079,06,079,San Luis Obispo County,281455,252344,29111
0500000US06029,06,029,Kern County,883053,706709,176344
0500000US06059,06,059,Orange County,3164182,2208880,955302
0500000US06009,06,009,Calaveras County,45235,42669,2566
0500000US06101,06,101,Sutter County,95872,74548,21324
0500000US06081,06,081,San Mateo County,765935,499203,266732
0500000US06109,06,109,Tuolumne County,53932,51503,2429
0500000US06077,06,077,San Joaquin County,732212,561324,170888
0500000US06005,06,005,Amador County,37829,35687,2142
0500000US08095,08,095,Phillips County,4318,3751,567
0500000US08007,08,007,Archuleta County,12908,12118,790
0500000US08031,08,031,Denver County,693417,585007,108410
0500000US08061,08,061,Kiowa County,1449,1442,7
0500000US08055,08,055,Huerfano County,6583,6397,186
0500000US08009,08,009,Baca County,3563,3427,136
0500000US08015,08,015,Chaffee County,19164,18557,607
0500000US08047,08,047,Gilpin County,5924,5752,172
0500000US08063,08,063,Kit Carson County,7635,7036,599
0500000US08045,08,045,Garfield County,58538,49836,8702
0500000US08051,08,051,Gunnison County,16537,15804,733
0500000US08059,08,059,Jefferson County,570427,532825,37602
0500000US08079,08,079,Mineral County,823,815,8
0500000US08091,08,091,Ouray County,4722,4629,93
0500000US08103,08,103,Rio Blanco County,6465,6286,179
0500000US08115,08,115,Sedgwick County,2350,2280,70
0500000US08021,08,021,Conejos County,8142,7937,205
0500000US08023,08,023,Costilla County,3687,3325,362
0500000US08001,08,001,Adams County,497115,420568,76547
0500000US08037,08,037,Eagle County,54357,44397,9960
0500000US08065,08,065,Lake County,7585,6933,652
0500000US08081,08,081,Moffat County,13060,12094,966
0500000US08097,08,097,Pitkin County,17909,15823,2086
0500000US08017,08,017,Cheyenne County,2039,1878,161
0500000US08025,08,025,Crowley County,5630,5368,262
0500000US08033,08,033,Dolores County,1841,1823,18
0500000US08057,08,057,Jackson County,1296,1213,83
0500000US08069,08,069,Larimer County,338161,319501,18660
0500000US08083,08,083,Montezuma County,25909,25319,590
0500000US08113,08,113,San Miguel County,7968,7264,704
0500000US08013,08,013,Boulder County,321030,286338,34692
0500000US08071,08,071,Las Animas County,14179,13404,775
0500000US08125,08,125,Yuma County,10069,9024,1045
0500000US08107,08,107,Routt County,24874,23416,1458
0500000US08117,08,117,Summit County,30429,27051,3378
0500000US08019,08,019,Clear Creek County,9379,9074,305
0500000US08029,08,029,Delta County,30346,29040,1306
0500000US08101,08,101,Pueblo County,164685,158959,5726
0500000US08087,08,087,Morgan County,28257,24425,3832
0500000US08093,08,093,Park County,17392,16877,515
0500000US08077,08,077,Mesa County,149998,144111,5887
0500000US08099,08,099,Prowers County,12052,10798,1254
0500000US08041,08,041,El Paso County,688153,640492,47661
0500000US08121,08,121,Washington County,4840,4688,152
0500000US08005,08,005,Arapahoe County,636671,541224,95447
0500000US08014,08,014,Broomfield County,66120,60022,6098
0500000US09009,09,009,New Haven County,859339,754400,104939
0500000US09003,09,003,Hartford County,894730,757535,137195
0500000US09015,09,015,Windham County,116538,110643,5895
0500000US09007,09,007,Middlesex County,163368,150873,12495
0500000US09013,09,013,Tolland County,151269,140567,10702
0500000US10003,10,003,New Castle County,555133,493348,61785
0500000US10005,10,005,Sussex County,219540,203852,15688
0500000US11001,11,001,District of Columbia,684498,588340,96158
0500000US12091,12,091,Okaloosa County,200737,186457,14280
0500000US12123,12,123,Taylor County,22098,21463,635
0500000US12133,12,133,Washington County,24566,23748,818
0500000US12031,12,031,Duval County,924229,824312,99917
0500000US12007,12,007,Bradford County,26979,26200,779
0500000US12009,12,009,Brevard County,576808,527132,49676
0500000US12019,12,019,Clay County,207291,192849,14442
0500000US12067,12,067,Lafayette County,8744,8297,447
0500000US12069,12,069,Lake County,335362,305665,29697
0500000US12089,12,089,Nassau County,80578,77439,3139
0500000US12103,12,103,Pinellas County,957875,843671,114204
0500000US12105,12,105,Polk County,668671,601711,66960
0500000US12111,12,111,St. Lucie County,305591,254978,50613
0500000US12043,12,043,Glades County,13363,12060,1303
0500000US12051,12,051,Hendry County,40127,28900,11227
0500000US12061,12,061,Indian River County,150984,135878,15106
0500000US12063,12,063,Jackson County,48472,47010,1462
0500000US12099,12,099,Palm Beach County,1446277,1084618,361659
0500000US12109,12,109,St. Johns County,235503,218713,16790
0500000US12117,12,117,Seminole County,455086,394270,60816
0500000US12086,12,086,Miami-Dade County,2715516,1269394,1446122
0500000US12005,12,005,Bay County,182482,171925,10557
0500000US12035,12,035,Flagler County,107139,94579,12560
0500000US12037,12,037,Franklin County,11736,11343,393
0500000US12047,12,047,Hamilton County,14269,13724,545
0500000US12077,12,077,Liberty County,8365,7941,424
0500000US12119,12,119,Sumter County,120999,114151,6848
0500000US12039,12,039,Gadsden County,46017,43577,2440
0500000US12059,12,059,Holmes County,19430,18945,485
0500000US12071,12,071,Lee County,718679,599253,119426
0500000US12083,12,083,Marion County,348371,322641,25730
0500000US12021,12,021,Collier County,363922,273084,90838
0500000US12095,12,095,Orange County,1321194,1039706,281488
0500000US12101,12,101,Pasco County,510593,461208,49385
0500000US12055,12,055,Highlands County,102101,90968,11133
0500000US12121,12,121,Suwannee County,43924,41655,2269
0500000US12027,12,027,DeSoto County,36399,30407,5992
0500000US12013,12,013,Calhoun County,14444,13931,513
0500000US12023,12,023,Columbia County,69105,66504,2601
0500000US12029,12,029,Dixie County,16437,16094,343
0500000US12107,12,107,Putnam County,72766,70022,2744
0500000US12125,12,125,Union County,15239,14815,424
0500000US12081,12,081,Manatee County,373853,326634,47219
0500000US12075,12,075,Levy County,39961,38338,1623
0500000US12003,12,003,Baker County,27785,27297,488
0500000US12127,12,127,Volusia County,527634,487185,40449
0500000US12073,12,073,Leon County,288102,268533,19569
0500000US12079,12,079,Madison County,18474,17720,754
0500000US12033,12,033,Escambia County,311522,296194,15328
0500000US12053,12,053,Hernando County,182696,170012,12684
0500000US13037,13,037,Calhoun County,6428,6157,271
0500000US13193,13,193,Macon County,13480,13228,252
0500000US13021,13,021,Bibb County,153490,148634,4856
0500000US13197,13,197,Marion County,8484,8044,440
0500000US13249,13,249,Schley County,5211,5167,44
0500000US13023,13,023,Bleckley County,12775,12557,218
0500000US13093,13,093,Dooly County,13905,13350,555
0500000US13119,13,119,Franklin County,22514,21763,751
0500000US13103,13,103,Effingham County,58689,56967,1722
0500000US13171,13,171,Lamar County,18513,18043,470
0500000US13107,13,107,Emanuel County,22499,22067,432
0500000US13239,13,239,Quitman County,2276,2155,121
0500000US13159,13,159,Jasper County,13784,13513,271
0500000US13167,13,167,Johnson County,9730,9651,79
0500000US13179,13,179,Liberty County,62108,58633,3475
0500000US13205,13,205,Mitchell County,22432,21716,716
0500000US13253,13,253,Seminole County,8437,8361,76
0500000US13277,13,277,Tift County,40510,38386,2124
0500000US13289,13,289,Twiggs County,8284,8176,108
0500000US13233,13,233,Polk County,41621,38908,2713
0500000US13263,13,263,Talbot County,6378,6312,66
0500000US13269,13,269,Taylor County,8193,8083,110
0500000US13273,13,273,Terrell County,8859,8667,192
0500000US13275,13,275,Thomas County,44730,43699,1031
0500000US13279,13,279,Toombs County,27048,25386,1662
0500000US13319,13,319,Wilkinson County,9078,8929,149
0500000US13017,13,017,Ben Hill County,17154,16616,538
0500000US13033,13,033,Burke County,22550,22098,452
0500000US13047,13,047,Catoosa County,66299,64732,1567
0500000US13053,13,053,Chattahoochee County,10767,10114,653
0500000US13055,13,055,Chattooga County,24817,24143,674
0500000US13073,13,073,Columbia County,147295,136456,10839
0500000US13087,13,087,Decatur County,26833,26115,718
0500000US13115,13,115,Floyd County,96824,90174,6650
0500000US13117,13,117,Forsyth County,219880,183138,36742
0500000US13137,13,137,Habersham County,44289,40209,4080
0500000US13185,13,185,Lowndes County,114582,109759,4823
0500000US13199,13,199,Meriwether County,21113,20861,252
0500000US13207,13,207,Monroe County,27010,26257,753
0500000US13261,13,261,Sumter County,30352,29202,1150
0500000US13265,13,265,Taliaferro County,1665,1626,39
0500000US13007,13,007,Baker County,3189,3060,129
0500000US13035,13,035,Butts County,23750,23030,720
0500000US13043,13,043,Candler County,10827,10341,486
0500000US13045,13,045,Carroll County,116022,111633,4389
0500000US13079,13,079,Crawford County,12344,12212,132
0500000US13081,13,081,Crisp County,22846,22206,640
0500000US13077,13,077,Coweta County,140516,132020,8496
0500000US13067,13,067,Cobb County,745057,628416,116641
0500000US13083,13,083,Dade County,16227,15882,345
0500000US13297,13,297,Walton County,90132,85540,4592
0500000US13027,13,027,Brooks County,15622,15021,601
0500000US13091,13,091,Dodge County,20919,20606,313
0500000US13105,13,105,Elbert County,19212,18724,488
0500000US13113,13,113,Fayette County,111369,100123,11246
0500000US13165,13,165,Jenkins County,8827,8407,420
0500000US13217,13,217,Newton County,106497,100141,6356
0500000US13227,13,227,Pickens County,30832,30167,665
0500000US13071,13,071,Colquitt County,45606,40828,4778
0500000US13085,13,085,Dawson County,23861,23159,702
0500000US13063,13,063,Clayton County,278666,241090,37576
0500000US13139,13,139,Hall County,195961,163325,32636
0500000US13141,13,141,Hancock County,8535,8349,186
0500000US13189,13,189,McDuffie County,21498,20834,664
0500000US13211,13,211,Morgan County,18235,17798,437
0500000US13149,13,149,Heard County,11677,11453,224
0500000US13095,13,095,Dougherty County,91049,89017,2032
0500000US13111,13,111,Fannin County,24925,24391,534
0500000US13153,13,153,Houston County,151682,143546,8136
0500000US13175,13,175,Laurens County,47418,46728,690
0500000US13255,13,255,Spalding County,64719,62845,1874
0500000US13271,13,271,Telfair County,16115,14061,2054
0500000US13291,13,291,Union County,22775,22124,651
0500000US13303,13,303,Washington County,20461,20084,377
0500000US13311,13,311,White County,28928,28135,793
0500000US13223,13,223,Paulding County,155840,147364,8476
0500000US13231,13,231,Pike County,18082,17806,276
0500000US13245,13,245,Richmond County,201463,194097,7366
0500000US13267,13,267,Tattnall County,25353,24185,1168
0500000US13019,13,019,Berrien County,19025,18540,485
0500000US13295,13,295,Walker County,68824,67870,954
0500000US13135,13,135,Gwinnett County,902298,673782,228516
0500000US13013,13,013,Barrow County,76887,71077,5810
0500000US13049,13,049,Charlton County,12983,11741,1242
0500000US13065,13,065,Clinch County,6743,6545,198
0500000US13015,13,015,Bartow County,103620,97845,5775
0500000US13097,13,097,Douglas County,141840,129716,12124
0500000US13131,13,131,Grady County,24926,23495,1431
0500000US13161,13,161,Jeff Davis County,14991,14305,686
0500000US13209,13,209,Montgomery County,9036,8442,594
0500000US13221,13,221,Oglethorpe County,14784,14520,264
0500000US13243,13,243,Randolph County,7087,7052,35
0500000US13247,13,247,Rockdale County,89011,79962,9049
0500000US13299,13,299,Ware County,35599,34693,906
0500000US13305,13,305,Wayne County,29767,28908,859
0500000US13309,13,309,Wheeler County,7939,7871,68
0500000US13315,13,315,Wilcox County,8846,8599,247
0500000US13009,13,009,Baldwin County,45286,44054,1232
0500000US13031,13,031,Bulloch County,74782,72445,2337
0500000US13059,13,059,Clarke County,124602,112378,12224
0500000US13101,13,101,Echols County,3994,3705,289
0500000US13127,13,127,Glynn County,83974,79439,4535
0500000US13143,13,143,Haralson County,28956,28593,363
0500000US13163,13,163,Jefferson County,15772,15389,383
0500000US13169,13,169,Jones County,28548,28261,287
0500000US13213,13,213,Murray County,39557,36518,3039
0500000US13215,13,215,Muscogee County,196670,186336,10334
0500000US13241,13,241,Rabun County,16457,15585,872
0500000US13259,13,259,Stewart County,6042,4097,1945
0500000US13283,13,283,Treutlen County,6777,6468,309
0500000US13155,13,155,Irwin County,9268,9178,90
0500000US13003,13,003,Atkinson County,8265,7212,1053
0500000US13005,13,005,Bacon County,11228,10828,400
0500000US13025,13,025,Brantley County,18561,18306,255
0500000US16087,16,087,Washington County,10025,9386,639
0500000US16031,16,031,Cassia County,23615,21015,2600
0500000US16045,16,045,Gem County,17052,16538,514
0500000US16085,16,085,Valley County,10401,10341,60
0500000US16003,16,003,Adams County,4019,3951,68
0500000US16069,16,069,Nez Perce County,40155,39536,619
0500000US16055,16,055,Kootenai County,153605,150074,3531
0500000US16061,16,061,Lewis County,3845,3768,77
0500000US16083,16,083,Twin Falls County,83666,76598,7068
0500000US16073,16,073,Owyhee County,11455,10278,1177
0500000US16015,16,015,Boise County,7163,6994,169
0500000US16023,16,023,Butte County,2602,2577,25
0500000US16029,16,029,Caribou County,6918,6719,199
0500000US16001,16,001,Ada County,446052,420283,25769
0500000US16005,16,005,Bannock County,85065,81580,3485
0500000US16011,16,011,Bingham County,45551,42717,2834
0500000US16025,16,025,Camas County,886,871,15
0500000US16027,16,027,Canyon County,212230,194434,17796
0500000US16051,16,051,Jefferson County,27969,26872,1097
0500000US16057,16,057,Latah County,39239,36801,2438
0500000US16075,16,075,Payette County,23041,21481,1560
0500000US16009,16,009,Benewah County,9086,8987,99
0500000US16033,16,033,Clark County,1077,774,303
0500000US16039,16,039,Elmore County,26433,24084,2349
0500000US16043,16,043,Fremont County,12965,12312,653
0500000US16079,16,079,Shoshone County,12526,12334,192
0500000US16049,16,049,Idaho County,16337,16112,225
0500000US15001,15,001,Hawaii County,197658,174140,23518
0500000US15009,15,009,Maui County,165281,134263,31018
0500000US15007,15,007,Kauai County,71377,59001,12376
0500000US15005,15,005,Kalawao County,75,73,2
0500000US17083,17,083,Jersey County,22069,21773,296
0500000US17155,17,155,Putnam County,5746,5578,168
0500000US17039,17,039,De Witt County,16042,15792,250
0500000US17051,17,051,Fayette County,21724,21536,188
0500000US17103,17,103,Lee County,34527,33574,953
0500000US17107,17,107,Logan County,29207,28770,437
0500000US17117,17,117,Macoupin County,45719,45344,375
0500000US17159,17,159,Richland County,15881,15542,339
0500000US17165,17,165,Saline County,24231,23985,246
0500000US17189,17,189,Washington County,14155,14039,116
0500000US17135,17,135,Montgomery County,29009,28728,281
0500000US17195,17,195,Whiteside County,56396,54607,1789
0500000US17001,17,001,Adams County,66427,65397,1030
0500000US17027,17,027,Clinton County,37628,37036,592
0500000US17037,17,037,DeKalb County,104200,96974,7226
0500000US17047,17,047,Edwards County,6507,6477,30
0500000US17079,17,079,Jasper County,9598,9472,126
0500000US17081,17,081,Jefferson County,38169,37459,710
0500000US17197,17,197,Will County,688697,605352,83345
0500000US17199,17,199,Williamson County,67299,66161,1138
0500000US17041,17,041,Douglas County,19714,19008,706
0500000US17057,17,057,Fulton County,35418,34791,627
0500000US17061,17,061,Greene County,13218,13144,74
0500000US17069,17,069,Hardin County,4009,3998,11
0500000US17073,17,073,Henry County,49464,48479,985
0500000US17095,17,095,Knox County,50999,49385,1614
0500000US17097,17,097,Lake County,703619,572604,131015
0500000US17127,17,127,Massac County,14430,14350,80
0500000US17171,17,171,Scott County,5047,5004,43
0500000US17017,17,017,Cass County,12665,11285,1380
0500000US17099,17,099,LaSalle County,110401,106409,3992
0500000US17067,17,067,Hancock County,18112,17883,229
0500000US17063,17,063,Grundy County,50509,48608,1901
0500000US17091,17,091,Kankakee County,111061,105594,5467
0500000US17043,17,043,DuPage County,931743,754529,177214
0500000US17167,17,167,Sangamon County,197661,191564,6097
0500000US17129,17,129,Menard County,12367,12271,96
0500000US17031,17,031,Cook County,5223719,4124060,1099659
0500000US17141,17,141,Ogle County,51328,48745,2583
0500000US17137,17,137,Morgan County,34426,33761,665
0500000US17177,17,177,Stephenson County,45433,44410,1023
0500000US17193,17,193,White County,14025,13850,175
0500000US17203,17,203,Woodford County,38817,38316,501
0500000US17071,17,071,Henderson County,6884,6796,88
0500000US17111,17,111,McHenry County,307789,278250,29539
0500000US17113,17,113,McLean County,173219,161141,12078
0500000US17145,17,145,Perry County,21384,21148,236
0500000US17149,17,149,Pike County,15754,15687,67
0500000US17161,17,161,Rock Island County,145275,133677,11598
0500000US17163,17,163,St. Clair County,263463,255774,7689
0500000US17185,17,185,Wabash County,11573,11346,227
0500000US17013,17,013,Calhoun County,4858,4821,37
0500000US17035,17,035,Cumberland County,10865,10759,106
0500000US17085,17,085,Jo Daviess County,21834,21316,518
0500000US17089,17,089,Kane County,530839,437070,93769
0500000US17101,17,101,Lawrence County,16189,15890,299
0500000US17009,17,009,Brown County,6675,6468,207
0500000US17123,17,123,Marshall County,11794,11623,171
0500000US17075,17,075,Iroquois County,28169,27263,906
0500000US17021,17,021,Christian County,33231,32814,417
0500000US17025,17,025,Clay County,13338,13208,130
0500000US17059,17,059,Gallatin County,5157,5118,39
0500000US17077,17,077,Jackson County,58551,55296,3255
0500000US17133,17,133,Monroe County,33936,33376,560
0500000US17143,17,143,Peoria County,184463,174216,10247
0500000US17181,17,181,Union County,17127,16586,541
0500000US17201,17,201,Winnebago County,286174,262137,24037
0500000US17147,17,147,Piatt County,16427,16238,189
0500000US17153,17,153,Pulaski County,5611,5543,68
0500000US17169,17,169,Schuyler County,7064,6944,120
0500000US17175,17,175,Stark County,5500,5420,80
0500000US17045,17,045,Edgar County,17539,17291,248
0500000US17005,17,005,Bond County,16712,16288,424
0500000US17007,17,007,Boone County,53606,48120,5486
0500000US17011,17,011,Bureau County,33381,32139,1242
0500000US17015,17,015,Carroll County,14562,14233,329
0500000US17029,17,029,Coles County,51736,50518,1218
0500000US17033,17,033,Crawford County,19088,18729,359
0500000US18105,18,105,Monroe County,145403,133398,12005
0500000US18045,18,045,Fountain County,16486,16216,270
0500000US18039,18,039,Elkhart County,203604,187788,15816
0500000US18025,18,025,Crawford County,10581,10562,19
0500000US18017,18,017,Cass County,38084,34642,3442
0500000US18097,18,097,Marion County,944523,855907,88616
0500000US18021,18,021,Clay County,26268,26049,219
0500000US18063,18,063,Hendricks County,160940,153013,7927
0500000US18047,18,047,Franklin County,22842,22723,119
0500000US18053,18,053,Grant County,66944,65907,1037
0500000US18071,18,071,Jackson County,43938,41897,2041
0500000US18067,18,067,Howard County,82387,80501,1886
0500000US18119,18,119,Owen County,20878,20608,270
0500000US18135,18,135,Randolph County,25076,24663,413
0500000US18183,18,183,Whitley County,33649,33209,440
0500000US18013,18,013,Brown County,15034,14775,259
0500000US18023,18,023,Clinton County,32301,30053,2248
0500000US18161,18,161,Union County,7153,7051,102
0500000US18027,18,027,Daviess County,32937,32032,905
0500000US18029,18,029,Dearborn County,49501,48987,514
0500000US18083,18,083,Knox County,37409,37022,387
0500000US18093,18,093,Lawrence County,45619,45035,584
0500000US18123,18,123,Perry County,19141,18947,194
0500000US18131,18,131,Pulaski County,12660,12499,161
0500000US18129,18,129,Posey County,25589,25335,254
0500000US18171,18,171,Warren County,8247,8205,42
0500000US18165,18,165,Vermillion County,15560,15413,147
0500000US18003,18,003,Allen County,370016,345990,24026
0500000US18031,18,031,Decatur County,26552,26066,486
0500000US18043,18,043,Floyd County,76809,75176,1633
0500000US18079,18,079,Jennings County,27727,27355,372
0500000US18081,18,081,Johnson County,151564,145116,6448
0500000US18109,18,109,Morgan County,69727,68843,884
0500000US18051,18,051,Gibson County,33596,33120,476
0500000US18117,18,117,Orange County,19547,19259,288
0500000US18085,18,085,Kosciusko County,78806,75253,3553
0500000US18099,18,099,Marshall County,46595,44550,2045
0500000US18163,18,163,Vanderburgh County,181313,176169,5144
0500000US18009,18,009,Blackford County,12129,11938,191
0500000US18143,18,143,Scott County,23743,23432,311
0500000US18061,18,061,Harrison County,39712,39242,470
0500000US18091,18,091,LaPorte County,110552,106737,3815
0500000US18169,18,169,Wabash County,31631,31168,463
0500000US18073,18,073,Jasper County,33449,32599,850
0500000US18101,18,101,Martin County,10210,10179,31
0500000US18127,18,127,Porter County,168041,161777,6264
0500000US18145,18,145,Shelby County,44399,43326,1073
0500000US18137,18,137,Ripley County,28425,28011,414
0500000US18147,18,147,Spencer County,20526,20235,291
0500000US18153,18,153,Sullivan County,20792,20627,165
0500000US18159,18,159,Tipton County,15218,15004,214
0500000US18157,18,157,Tippecanoe County,189294,167611,21683
0500000US18167,18,167,Vigo County,107693,104142,3551
0500000US18173,18,173,Warrick County,61928,59777,2151
0500000US18057,18,057,Hamilton County,316095,291346,24749
0500000US18033,18,033,DeKalb County,42704,42115,589
0500000US18087,18,087,LaGrange County,38942,38235,707
0500000US18005,18,005,Bartholomew County,81893,73373,8520
0500000US18139,18,139,Rush County,16704,16591,113
0500000US18011,18,011,Boone County,64321,61878,2443
0500000US18049,18,049,Fulton County,20212,19562,650
0500000US18089,18,089,Lake County,486849,453320,33529
0500000US18107,18,107,Montgomery County,38276,37137,1139
0500000US18113,18,113,Noble County,47451,45169,2282
0500000US18001,18,001,Adams County,35195,34833,362
0500000US18041,18,041,Fayette County,23259,23097,162
0500000US19055,19,055,Delaware County,17258,17167,91
0500000US19185,19,185,Wayne County,6413,6339,74
0500000US19113,19,113,Linn County,222121,213008,9113
0500000US19163,19,163,Scott County,172288,165093,7195
0500000US19141,19,141,O'Brien County,13911,13550,361
0500000US19011,19,011,Benton County,25626,25442,184
0500000US19061,19,061,Dubuque County,96802,94155,2647
0500000US19079,19,079,Hamilton County,15110,14578,532
0500000US19151,19,151,Pocahontas County,6898,6641,257
0500000US19175,19,175,Union County,12453,12154,299
0500000US19177,19,177,Van Buren County,7223,7144,79
0500000US19159,19,159,Ringgold County,4984,4932,52
0500000US19001,19,001,Adair County,7124,7018,106
0500000US19009,19,009,Audubon County,5637,5588,49
0500000US19039,19,039,Clarke County,9282,8640,642
0500000US19051,19,051,Davis County,8885,8774,111
0500000US19093,19,093,Ida County,6916,6823,93
0500000US19107,19,107,Keokuk County,10200,10092,108
0500000US19135,19,135,Monroe County,7863,7849,14
0500000US19179,19,179,Wapello County,35315,32607,2708
0500000US19167,19,167,Sioux County,34825,32729,2096
0500000US19025,19,025,Calhoun County,9780,9692,88
0500000US19031,19,031,Cedar County,18445,18285,160
0500000US19033,19,033,Cerro Gordo County,42984,41855,1129
0500000US19073,19,073,Greene County,9003,8842,161
0500000US19083,19,083,Hardin County,17127,16671,456
0500000US19117,19,117,Lucas County,8597,8334,263
0500000US19189,19,189,Winnebago County,10571,10356,215
0500000US19147,19,147,Palo Alto County,9055,8758,297
0500000US19007,19,007,Appanoose County,12510,12390,120
0500000US19095,19,095,Iowa County,16207,16055,152
0500000US19099,19,099,Jasper County,36891,36352,539
0500000US19191,19,191,Winneshiek County,20401,19962,439
0500000US19157,19,157,Poweshiek County,18605,18031,574
0500000US19127,19,127,Marshall County,40271,35079,5192
0500000US19015,19,015,Boone County,26399,26055,344
0500000US19017,19,017,Bremer County,24782,24311,471
0500000US19089,19,089,Howard County,9264,9244,20
0500000US19063,19,063,Emmet County,9551,9112,439
0500000US19081,19,081,Hancock County,10888,10734,154
0500000US19121,19,121,Madison County,15890,15697,193
0500000US19125,19,125,Marion County,33207,32601,606
0500000US19197,19,197,Wright County,12804,12162,642
0500000US39097,39,097,Madison County,43988,43249,739
0500000US39119,39,119,Muskingum County,86076,85181,895
0500000US27037,27,037,Dakota County,418201,378358,39843
0500000US27083,27,083,Lyon County,25839,23972,1867
0500000US27129,27,129,Renville County,14721,14360,361
0500000US27031,27,031,Cook County,5311,4999,312
0500000US27093,27,093,Meeker County,23079,22613,466
0500000US27113,27,113,Pennington County,14184,13866,318
0500000US27167,27,167,Wilkin County,6343,6303,40
0500000US27027,27,027,Clay County,62801,60127,2674
0500000US27045,27,045,Fillmore County,20888,20572,316
0500000US27119,27,119,Polk County,31591,30554,1037
0500000US27135,27,135,Roseau County,15462,14873,589
0500000US27165,27,165,Watonwan County,10973,9593,1380
0500000US27011,27,011,Big Stone County,5016,4936,80
0500000US27021,27,021,Cass County,29022,28701,321
0500000US27049,27,049,Goodhue County,46217,44941,1276
0500000US27063,27,063,Jackson County,10047,9766,281
0500000US27105,27,105,Nobles County,21839,17595,4244
0500000US27141,27,141,Sherburne County,93231,90150,3081
0500000US27019,27,019,Carver County,100416,95415,5001
0500000US27061,27,061,Itasca County,45203,44728,475
0500000US27123,27,123,Ramsey County,541493,457114,84379
0500000US27169,27,169,Winona County,50847,49126,1721
0500000US28089,28,089,Madison County,103498,99420,4078
0500000US28091,28,091,Marion County,25202,24848,354
0500000US48449,48,449,Titus County,32730,26305,6425
0500000US48291,48,291,Liberty County,81862,75398,6464
0500000US48497,48,497,Wise County,64639,59969,4670
0500000US48249,48,249,Jim Wells County,41192,38723,2469
0500000US48127,48,127,Dimmit County,10663,9766,897
0500000US48157,48,157,Fort Bend County,739342,529458,209884
0500000US48235,48,235,Irion County,1524,1465,59
0500000US48097,48,097,Cooke County,39571,35968,3603
0500000US48115,48,115,Dawson County,12964,12143,821
0500000US48051,48,051,Burleson County,17863,16652,1211
0500000US48245,48,245,Jefferson County,255210,224437,30773
0500000US48359,48,359,Oldham County,2090,2038,52
0500000US48141,48,141,El Paso County,837654,629677,207977
0500000US48443,48,443,Terrell County,862,833,29
0500000US48463,48,463,Uvalde County,27009,23542,3467
0500000US48009,48,009,Archer County,8789,8561,228
0500000US48215,48,215,Hidalgo County,849389,618807,230582
0500000US48425,48,425,Somervell County,8743,8420,323
0500000US48207,48,207,Haskell County,5809,5095,714
0500000US48333,48,333,Mills County,4902,4576,326
0500000US48351,48,351,Newton County,14057,13837,220
0500000US49045,49,045,Tooele County,65185,62533,2652
0500000US49043,49,043,Summit County,40511,36592,3919
0500000US49031,49,031,Piute County,1904,1902,2
0500000US49001,49,001,Beaver County,6443,6045,398
0500000US49039,49,039,Sanpete County,29366,28056,1310
0500000US49049,49,049,Utah County,590440,547663,42777
0500000US50011,50,011,Franklin County,49025,47666,1359
0500000US50003,50,003,Bennington County,35920,34766,1154
0500000US50009,50,009,Essex County,6208,5988,220
0500000US51530,51,530,Buena Vista city,6399,6354,45
0500000US51730,51,730,Petersburg city,31827,30614,1213
0500000US51600,51,600,Fairfax city,23865,17193,6672
0500000US51683,51,683,Manassas city,41457,30673,10784
0500000US51800,51,800,Suffolk city,89160,85999,3161
0500000US51041,51,041,Chesterfield County,339447,310991,28456
0500000US51093,51,093,Isle of Wight County,36372,35239,1133
0500000US51620,51,620,Franklin city,8211,8123,88
0500000US51540,51,540,Charlottesville city,47042,41040,6002
0500000US51087,51,087,Henrico County,325642,283909,41733
0500000US51101,51,101,King William County,16497,16152,345
0500000US51109,51,109,Louisa County,35380,34187,1193
0500000US51147,51,147,Prince Edward County,22956,21946,1010
0500000US51159,51,159,Richmond County,8878,8505,373
0500000US51177,51,177,Spotsylvania County,131412,122002,9410
0500000US51043,51,043,Clarke County,14365,13841,524
0500000US51117,51,117,Mecklenburg County,30847,30334,513
0500000US51015,51,015,Augusta County,74701,73004,1697
0500000US51051,51,051,Dickenson County,14960,14896,64
0500000US51107,51,107,Loudoun County,385143,291661,93482
0500000US51161,51,161,Roanoke County,93583,88727,4856
0500000US51570,51,570,Colonial Heights city,17593,16251,1342
0500000US51021,51,021,Bland County,6447,6421,26
0500000US51029,51,029,Buckingham County,17004,16716,288
0500000US51580,51,580,Covington city,5582,5393,189
0500000US51810,51,810,Virginia Beach city,450135,408163,41972
0500000US51640,51,640,Galax city,6638,5979,659
0500000US51193,51,193,Westmoreland County,17638,16924,714
0500000US51155,51,155,Pulaski County,34234,33580,654
0500000US51590,51,590,Danville city,41512,40249,1263
0500000US51009,51,009,Amherst County,31882,31355,527
0500000US51017,51,017,Bath County,4393,4315,78
0500000US51700,51,700,Newport News city,180145,167635,12510
0500000US51680,51,680,Lynchburg city,80131,75427,4704
0500000US51690,51,690,Martinsville city,13101,12741,360
0500000US51057,51,057,Essex County,11036,10854,182
0500000US51790,51,790,Staunton city,24452,23488,964
0500000US51750,51,750,Radford city,17630,17184,446
0500000US51045,51,045,Craig County,5113,5099,14
0500000US51071,51,071,Giles County,16814,16602,212
0500000US51157,51,157,Rappahannock County,7332,7074,258
0500000US54085,54,085,Ritchie County,9932,9833,99
0500000US54043,54,043,Lincoln County,21078,21003,75
0500000US54079,54,079,Putnam County,56652,56038,614
0500000US54005,54,005,Boone County,22817,22737,80
0500000US54051,54,051,Marshall County,31645,31418,227
0500000US54093,54,093,Tucker County,7027,6990,37
0500000US54087,54,087,Roane County,14205,14106,99
0500000US54107,54,107,Wood County,85556,84651,905
0500000US54053,54,053,Mason County,26939,26762,177
0500000US54073,54,073,Pleasants County,7507,7503,4
0500000US54037,54,037,Jefferson County,56179,53377,2802
0500000US54045,54,045,Logan County,33801,33714,87
0500000US53031,53,031,Jefferson County,30856,29184,1672
0500000US53049,53,049,Pacific County,21281,19780,1501
0500000US53059,53,059,Skamania County,11620,11146,474
0500000US53009,53,009,Clallam County,74487,70374,4113
0500000US53039,53,039,Klickitat County,21396,19832,1564
0500000US53017,53,017,Douglas County,41371,34958,6413
0500000US53053,53,053,Pierce County,859840,775356,84484
0500000US53071,53,071,Walla Walla County,60236,54126,6110
0500000US53061,53,061,Snohomish County,786620,662908,123712
0500000US53067,53,067,Thurston County,274684,253373,21311
0500000US53011,53,011,Clark County,465384,416894,48490
0500000US53001,53,001,Adams County,19452,14500,4952
0500000US53057,53,057,Skagit County,123907,110985,12922
0500000US53043,53,043,Lincoln County,10435,10264,171
0500000US55119,55,119,Taylor County,20356,20040,316
0500000US55099,55,099,Price County,13490,13232,258
0500000US55079,55,079,Milwaukee County,954209,868088,86121
0500000US55033,55,033,Dunn County,44498,43218,1280
0500000US55045,55,045,Green County,36864,36042,822
0500000US55115,55,115,Shawano County,41009,40516,493
0500000US55078,55,078,Menominee County,4579,4551,28
0500000US55011,55,011,Buffalo County,13167,12953,214
0500000US55063,55,063,La Crosse County,117850,114411,3439
0500000US55035,55,035,Eau Claire County,102991,99110,3881
0500000US55095,55,095,Polk County,43349,42821,528
0500000US55133,55,133,Waukesha County,398879,378132,20747
0500000US55125,55,125,Vilas County,21593,21200,393
0500000US55057,55,057,Juneau County,26419,25896,523
0500000US55131,55,131,Washington County,134535,130812,3723
0500000US55025,55,025,Dane County,529843,484189,45654
0500000US55039,55,039,Fond du Lac County,102315,98834,3481
0500000US55091,55,091,Pepin County,7262,7163,99
0500000US55097,55,097,Portage County,70599,67693,2906
0500000US56023,56,023,Lincoln County,19011,18593,418
0500000US56021,56,021,Laramie County,97692,94555,3137
0500000US01093,01,093,Marion County,29965,29589,376
0500000US01073,01,073,Jefferson County,659892,633282,26610
0500000US01059,01,059,Franklin County,31542,28623,2919
0500000US01019,01,019,Cherokee County,25853,25648,205
0500000US01047,01,047,Dallas County,40029,39501,528
0500000US01087,01,087,Macon County,19054,18853,201
0500000US01117,01,117,Shelby County,211261,200101,11160
0500000US01003,01,003,Baldwin County,208107,200937,7170
0500000US01069,01,069,Houston County,104352,101985,2367
0500000US01125,01,125,Tuscaloosa County,206213,198660,7553
0500000US01027,01,027,Clay County,13378,13117,261
0500000US01109,01,109,Pike County,33403,31968,1435
0500000US01037,01,037,Coosa County,10855,10804,51
0500000US01065,01,065,Hale County,14887,14801,86
0500000US01053,01,053,Escambia County,37328,36963,365
0500000US01013,01,013,Butler County,20025,19750,275
0500000US01105,01,105,Perry County,9486,9343,143
0500000US01035,01,035,Conecuh County,12514,12425,89
0500000US01007,01,007,Bibb County,22527,22202,325
0500000US01017,01,017,Chambers County,33826,33356,470
0500000US01057,01,057,Fayette County,16585,16433,152
0500000US01009,01,009,Blount County,57645,55132,2513
0500000US01001,01,001,Autauga County,55200,54086,1114
0500000US01061,01,061,Geneva County,26491,26085,406
0500000US02261,02,261,Valdez-Cordova Census Area,9301,8712,589
0500000US02105,02,105,Hoonah-Angoon Census Area,2132,1993,139
0500000US02275,02,275,Wrangell City and Borough,2484,2358,126
0500000US04019,04,019,Pima County,1019722,887487,132235
0500000US04007,04,007,Gila County,53400,51392,2008
0500000US04003,04,003,Cochise County,126279,112382,13897
0500000US04001,04,001,Apache County,71522,70331,1191
0500000US04025,04,025,Yavapai County,224645,210589,14056
0500000US04017,04,017,Navajo County,108705,105541,3164
0500000US05119,05,119,Pulaski County,393463,371739,21724
0500000US05021,05,021,Clay County,15061,14946,115
0500000US05039,05,039,Dallas County,7432,7367,65
0500000US05121,05,121,Randolph County,17603,17265,338
0500000US05009,05,009,Boone County,37288,36928,360
0500000US05063,05,063,Independence County,37264,36127,1137
0500000US05053,05,053,Grant County,18086,17900,186
0500000US05045,05,045,Faulkner County,122416,118495,3921
0500000US05089,05,089,Marion County,16438,16238,200
0500000US05129,05,129,Searcy County,7923,7849,74
0500000US05033,05,033,Crawford County,62472,60140,2332
0500000US05059,05,059,Hot Spring County,33520,33073,447
0500000US05087,05,087,Madison County,16076,15510,566
0500000US05061,05,061,Howard County,13389,12613,776
0500000US05093,05,093,Mississippi County,42831,42103,728
0500000US05139,05,139,Union County,39732,38847,885
0500000US39055,39,055,Geauga County,93961,91511,2450
0500000US39085,39,085,Lake County,230052,217631,12421
0500000US39023,39,023,Clark County,135198,132194,3004
0500000US39075,39,075,Holmes County,43859,43641,218
0500000US39111,39,111,Monroe County,14090,14014,76
0500000US39165,39,165,Warren County,226564,211800,14764
0500000US39005,39,005,Ashland County,53477,52331,1146
0500000US40133,40,133,Seminole County,25071,24637,434
0500000US40011,40,011,Blaine County,9634,8895,739
0500000US40029,40,029,Coal County,5618,5580,38
0500000US40073,40,073,Kingfisher County,15618,14444,1174
0500000US40095,40,095,Marshall County,16376,15218,1158
0500000US40105,40,105,Nowata County,10383,10245,138
0500000US40131,40,131,Rogers County,90814,88671,2143
0500000US40003,40,003,Alfalfa County,5857,5645,212
0500000US40027,40,027,Cleveland County,276733,259455,17278
0500000US40005,40,005,Atoka County,13874,13667,207
0500000US40043,40,043,Dewey County,4918,4754,164
0500000US40083,40,083,Logan County,46044,44689,1355
0500000US40147,40,147,Washington County,52001,49563,2438
0500000US40061,40,061,Haskell County,12704,12520,184
0500000US40111,40,111,Okmulgee County,38889,38517,372
0500000US40067,40,067,Jefferson County,6223,6059,164
0500000US40049,40,049,Garvin County,27823,26907,916
0500000US40123,40,123,Pontotoc County,38358,37445,913
0500000US40063,40,063,Hughes County,13460,13294,166
0500000US40031,40,031,Comanche County,122561,116152,6409
0500000US40117,40,117,Pawnee County,16428,16278,150
0500000US41019,41,019,Douglas County,108323,105282,3041
0500000US41053,41,053,Polk County,81427,74892,6535
0500000US41017,41,017,Deschutes County,180640,172520,8120
0500000US41071,41,071,Yamhill County,103820,94882,8938
0500000US41035,41,035,Klamath County,66310,62731,3579
0500000US41003,41,003,Benton County,89780,80427,9353
0500000US41013,41,013,Crook County,22337,21724,613
0500000US41025,41,025,Harney County,7228,7099,129
0500000US41063,41,063,Wallowa County,6924,6761,163
0500000US41069,41,069,Wheeler County,1426,1375,51
0500000US41011,41,011,Coos County,63308,61075,2233
0500000US41027,41,027,Hood River County,23131,19408,3723
0500000US41051,41,051,Multnomah County,798647,686616,112031
0500000US42055,42,055,Franklin County,153751,148308,5443
0500000US42009,42,009,Bedford County,48611,48283,328
0500000US42111,42,111,Somerset County,74949,74256,693
0500000US42133,42,133,York County,444014,426531,17483
0500000US42015,42,015,Bradford County,61304,60419,885
0500000US42029,42,029,Chester County,517156,467492,49664
0500000US42063,42,063,Indiana County,85755,84337,1418
0500000US42125,42,125,Washington County,207547,203567,3980
0500000US42103,42,103,Pike County,55498,50755,4743
0500000US42077,42,077,Lehigh County,362613,321034,41579
0500000US42031,42,031,Clarion County,38827,38321,506
0500000US42033,42,033,Clearfield County,80216,77783,2433
0500000US42081,42,081,Lycoming County,114859,112718,2141
0500000US42123,42,123,Warren County,40035,39587,448
0500000US42047,42,047,Elk County,30608,30348,260
0500000US42085,42,085,Mercer County,112630,110832,1798
0500000US42113,42,113,Sullivan County,6177,6072,105
0500000US44003,44,003,Kent County,163861,153797,10064
0500000US44009,44,009,Washington County,126242,120243,5999
0500000US45005,45,005,Allendale County,9214,9129,85
0500000US45023,45,023,Chester County,32326,32027,299
0500000US45067,45,067,Marion County,31562,30886,676
0500000US45073,45,073,Oconee County,76696,73763,2933
0500000US45019,45,019,Charleston County,394708,375219,19489
0500000US45069,45,069,Marlboro County,27131,26483,648
0500000US45021,45,021,Cherokee County,56711,55549,1162
0500000US45053,45,053,Jasper County,27900,25437,2463
0500000US45061,45,061,Lee County,17606,17456,150
0500000US45083,45,083,Spartanburg County,302195,282981,19214
0500000US45013,45,013,Beaufort County,182658,167476,15182
0500000US45081,45,081,Saluda County,20299,18593,1706
0500000US46067,46,067,Hutchinson County,7315,7263,52
0500000US46017,46,017,Buffalo County,2053,2053,0
0500000US46041,46,041,Dewey County,5779,5767,12
0500000US46065,46,065,Hughes County,17617,17415,202
0500000US46111,46,111,Sanborn County,2388,2363,25
0500000US46059,46,059,Hand County,3301,3297,4
0500000US46135,46,135,Yankton County,22717,22346,371
0500000US46005,46,005,Beadle County,18374,15960,2414
0500000US46035,46,035,Davison County,19901,19646,255
0500000US46073,46,073,Jerauld County,2029,1971,58
0500000US46117,46,117,Stanley County,2997,2984,13
0500000US46107,46,107,Potter County,2326,2273,53
0500000US46023,46,023,Charles Mix County,9344,9308,36
0500000US46091,46,091,Marshall County,4895,4678,217
0500000US46101,46,101,Moody County,6506,6319,187
0500000US46121,46,121,Todd County,10146,9949,197
0500000US46085,46,085,Lyman County,3869,3843,26
0500000US46115,46,115,Spink County,6543,6492,51
0500000US46011,46,011,Brookings County,34239,32129,2110
0500000US46057,46,057,Hamlin County,6000,5792,208
0500000US47083,47,083,Houston County,8176,8085,91
0500000US47071,47,071,Hardin County,25771,25360,411
0500000US47069,47,069,Hardeman County,25562,25230,332
0500000US47139,47,139,Polk County,16782,16599,183
0500000US47185,47,185,White County,26580,26226,354
0500000US47171,47,171,Unicoi County,17780,17315,465
0500000US47183,47,183,Weakley County,33626,33053,573
0500000US47007,47,007,Bledsoe County,14602,14223,379
0500000US47031,47,031,Coffee County,54531,52969,1562
0500000US47073,47,073,Hawkins County,56402,55784,618
0500000US47111,47,111,Macon County,23487,22795,692
0500000US47147,47,147,Robertson County,69344,66437,2907
0500000US47021,47,021,Cheatham County,39929,38959,970
0500000US47055,47,055,Giles County,29167,28580,587
0500000US47113,47,113,Madison County,97682,94759,2923
0500000US47137,47,137,Pickett County,5088,5070,18
0500000US47181,47,181,Wayne County,16649,16511,138
0500000US47003,47,003,Bedford County,47558,44516,3042
0500000US47035,47,035,Cumberland County,58634,57355,1279
0500000US47025,47,025,Claiborne County,31613,31213,400
0500000US47085,47,085,Humphreys County,18318,18034,284
0500000US47141,47,141,Putnam County,76440,72506,3934
0500000US47161,47,161,Stewart County,13301,13033,268
0500000US47039,47,039,Decatur County,11683,11611,72
0500000US47109,47,109,McNairy County,25903,25693,210
0500000US47011,47,011,Bradley County,104557,98487,6070
0500000US48267,48,267,Kimble County,4408,4147,261
0500000US48467,48,467,Van Zandt County,54368,51987,2381
0500000US48317,48,317,Martin County,5614,5226,388
0500000US48501,48,501,Yoakum County,8571,6618,1953
0500000US48387,48,387,Red River County,12275,11995,280
0500000US48435,48,435,Sutton County,3865,3339,526
0500000US48459,48,459,Upshur County,40769,39339,1430
0500000US48481,48,481,Wharton County,41551,37169,4382
0500000US48033,48,033,Borden County,665,641,24
0500000US48315,48,315,Marion County,10083,9897,186
0500000US48181,48,181,Grayson County,128560,120445,8115
0500000US48363,48,363,Palo Pinto County,28317,26319,1998
0500000US48123,48,123,DeWitt County,20435,19499,936
0500000US48059,48,059,Callahan County,13770,13585,185
0500000US48183,48,183,Gregg County,123494,112315,11179
0500000US48303,48,303,Lubbock County,301454,283472,17982
0500000US48257,48,257,Kaufman County,118910,109077,9833
0500000US48153,48,153,Floyd County,5872,5349,523
0500000US48071,48,071,Chambers County,40292,36724,3568
0500000US48027,48,027,Bell County,342236,313851,28385
0500000US48233,48,233,Hutchinson County,21571,20572,999
0500000US48361,48,361,Orange County,84047,81515,2532
0500000US48495,48,495,Winkler County,7802,6673,1129
0500000US48053,48,053,Burnet County,45750,42783,2967
0500000US48113,48,113,Dallas County,2586552,1957849,628703
0500000US48311,48,311,McMullen County,662,647,15
0500000US48251,48,251,Johnson County,163475,155595,7880
0500000US48205,48,205,Hartley County,5767,5197,570
0500000US48293,48,293,Limestone County,23515,21106,2409
0500000US48367,48,367,Parker County,129802,123513,6289
0500000US48109,48,109,Culberson County,2241,1960,281
0500000US48169,48,169,Garza County,6288,4072,2216
0500000US48453,48,453,Travis County,1203166,990287,212879
0500000US48087,48,087,Collingsworth County,2996,2672,324
0500000US48279,48,279,Lamb County,13262,11888,1374
0500000US48301,48,301,Loving County,102,86,16
0500000US28117,28,117,Prentiss County,25360,25203,157
0500000US28059,28,059,Jackson County,142014,137067,4947
0500000US28143,28,143,Tunica County,10170,9914,256
0500000US28021,28,021,Claiborne County,9120,9022,98
0500000US28075,28,075,Lauderdale County,77323,75772,1551
0500000US28127,28,127,Simpson County,27073,26897,176
0500000US28007,28,007,Attala County,18581,18405,176
0500000US28027,28,027,Coahoma County,23802,23703,99
0500000US28147,28,147,Walthall County,14601,14524,77
0500000US28115,28,115,Pontotoc County,31315,30388,927
0500000US28003,28,003,Alcorn County,37180,36535,645
0500000US28033,28,033,DeSoto County,176132,169709,6423
0500000US29129,29,129,Mercer County,3664,3597,67
0500000US29047,29,047,Clay County,239164,227789,11375
0500000US29065,29,065,Dent County,15504,15354,150
0500000US29227,29,227,Worth County,2040,2015,25
0500000US29510,29,510,St. Louis city,311273,290228,21045
0500000US29023,29,023,Butler County,42733,42281,452
0500000US29087,29,087,Holt County,4456,4418,38
0500000US29139,29,139,Montgomery County,11545,11464,81
0500000US29207,29,207,Stoddard County,29512,29359,153
0500000US29221,29,221,Washington County,24931,24873,58
0500000US29063,29,063,DeKalb County,12564,12476,88
0500000US29107,29,107,Lafayette County,32589,32141,448
0500000US29197,29,197,Schuyler County,4502,4479,23
0500000US29029,29,029,Camden County,45096,44019,1077
0500000US29097,29,097,Jasper County,119238,114333,4905
0500000US29119,29,119,McDonald County,22827,21042,1785
0500000US29167,29,167,Polk County,31549,31320,229
0500000US29179,29,179,Reynolds County,6315,6278,37
0500000US29201,29,201,Scott County,38729,38228,501
0500000US29011,29,011,Barton County,11850,11736,114
0500000US29051,29,051,Cole County,76740,74422,2318
0500000US29073,29,073,Gasconade County,14746,14636,110
0500000US29121,29,121,Macon County,15254,15129,125
0500000US29155,29,155,Pemiscot County,17031,16951,80
0500000US29203,29,203,Shannon County,8246,8237,9
0500000US29067,29,067,Douglas County,13374,13266,108
0500000US29083,29,083,Henry County,21765,21421,344
0500000US29109,29,109,Lawrence County,38133,36976,1157
0500000US30015,30,015,Chouteau County,5789,5691,98
0500000US30053,30,053,Lincoln County,19358,18863,495
0500000US30103,30,103,Treasure County,777,770,7
0500000US30097,30,097,Sweet Grass County,3653,3621,32
0500000US30079,30,079,Prairie County,1342,1317,25
0500000US30035,30,035,Glacier County,13699,13501,198
0500000US30037,30,037,Golden Valley County,724,713,11
0500000US30095,30,095,Stillwater County,9410,9270,140
0500000US30039,30,039,Granite County,3269,3235,34
0500000US30057,30,057,Madison County,8218,7874,344
0500000US30091,30,091,Sheridan County,3574,3491,83
0500000US30003,30,003,Big Horn County,13376,13196,180
0500000US30049,30,049,Lewis and Clark County,67077,66129,948
0500000US30063,30,063,Missoula County,115983,112602,3381
0500000US30013,30,013,Cascade County,81746,80008,1738
0500000US30033,30,033,Garfield County,1141,1141,0
0500000US30077,30,077,Powell County,6861,6830,31
0500000US30031,30,031,Gallatin County,104729,101165,3564
0500000US30001,30,001,Beaverhead County,9393,9081,312
0500000US30065,30,065,Musselshell County,4807,4760,47
0500000US31161,31,161,Sheridan County,5234,5147,87
0500000US31129,31,129,Nuckolls County,4275,4186,89
0500000US31063,31,063,Frontier County,2609,2584,25
0500000US31055,31,055,Douglas County,554992,501832,53160
0500000US31029,31,029,Chase County,3734,3438,296
0500000US31005,31,005,Arthur County,418,416,2
0500000US31061,31,061,Franklin County,3006,2965,41
0500000US31095,31,095,Jefferson County,7188,7077,111
0500000US31115,31,115,Loup County,585,585,0
0500000US31137,31,137,Phelps County,9120,8996,124
0500000US31157,31,157,Scotts Bluff County,36255,34762,1493
0500000US31105,31,105,Kimball County,3667,3628,39
0500000US31121,31,121,Merrick County,7803,7592,211
0500000US31021,31,021,Burt County,6528,6428,100
0500000US31039,31,039,Cuming County,8991,8499,492
0500000US31075,31,075,Grant County,718,716,2
0500000US31085,31,085,Hayes County,943,891,52
0500000US31027,31,027,Cedar County,8523,8495,28
0500000US31097,31,097,Johnson County,5197,5006,191
0500000US31071,31,071,Garfield County,1975,1961,14
0500000US31133,31,133,Pawnee County,2676,2642,34
0500000US31183,31,183,Wheeler County,822,817,5
0500000US31185,31,185,York County,13799,13554,245
0500000US31037,31,037,Colfax County,10760,7418,3342
0500000US31113,31,113,Logan County,886,861,25
0500000US31143,31,143,Polk County,5255,5073,182
0500000US31017,31,017,Brown County,2988,2923,65
0500000US32015,32,015,Lander County,5746,5162,584
0500000US32011,32,011,Eureka County,1830,1808,22
0500000US34021,34,021,Mercer County,368762,287595,81167
0500000US34035,34,035,Somerset County,330176,247533,82643
0500000US34001,34,001,Atlantic County,268539,225144,43395
0500000US34023,34,023,Middlesex County,826698,556422,270276
0500000US34009,34,009,Cape May County,93705,89210,4495
0500000US34039,34,039,Union County,553066,387388,165678
0500000US34019,34,019,Hunterdon County,125051,113781,11270
0500000US35028,35,028,Los Alamos County,18356,16657,1699
0500000US35061,35,061,Valencia County,75956,70107,5849
0500000US35001,35,001,Bernalillo County,677692,608727,68965
0500000US35011,35,011,De Baca County,2060,2006,54
0500000US35023,35,023,Hidalgo County,4371,4061,310
0500000US35043,35,043,Sandoval County,140769,132796,7973
0500000US35009,35,009,Curry County,50199,45114,5085
0500000US35021,35,021,Harding County,459,453,6
0500000US35045,35,045,San Juan County,127455,123449,4006
0500000US35005,35,005,Chaves County,65459,57117,8342
0500000US35059,35,059,Union County,4175,3871,304
0500000US35041,35,041,Roosevelt County,19117,16977,2140
0500000US36005,36,005,Bronx County,1437872,928848,509024
0500000US36035,36,035,Fulton County,53743,52774,969
0500000US36083,36,083,Rensselaer County,159431,151660,7771
0500000US36043,36,043,Herkimer County,62505,60832,1673
0500000US36089,36,089,St. Lawrence County,109558,104910,4648
0500000US36113,36,113,Warren County,64480,62094,2386
0500000US36027,36,027,Dutchess County,293894,260140,33754
0500000US36055,36,055,Monroe County,744248,679926,64322
0500000US36111,36,111,Ulster County,179303,165232,14071
0500000US36051,36,051,Livingston County,63907,61690,2217
0500000US36039,36,039,Greene County,47617,44743,2874
0500000US36003,36,003,Allegany County,47025,45836,1189
0500000US36009,36,009,Cattaraugus County,77686,76210,1476
0500000US36093,36,093,Schenectady County,154883,138242,16641
0500000US36123,36,123,Yates County,25009,24637,372
0500000US37087,37,087,Haywood County,60433,58894,1539
0500000US37005,37,005,Alleghany County,10973,10439,534
0500000US37045,37,045,Cleveland County,97159,94831,2328
0500000US37077,37,077,Granville County,58874,56221,2653
0500000US37093,37,093,Hoke County,53239,50103,3136
0500000US37097,37,097,Iredell County,172525,161609,10916
0500000US37147,37,147,Pitt County,177372,169105,8267
0500000US37039,37,039,Cherokee County,27668,26950,718
0500000US37193,37,193,Wilkes County,68460,65664,2796
0500000US37003,37,003,Alexander County,37119,35809,1310
0500000US37031,37,031,Carteret County,68920,66631,2289
0500000US37139,37,139,Pasquotank County,39479,37930,1549
0500000US37173,37,173,Swain County,14254,13869,385
0500000US37007,37,007,Anson County,25306,24553,753
0500000US37069,37,069,Franklin County,64902,61315,3587
0500000US37113,37,113,Macon County,34410,32639,1771
0500000US37175,37,175,Transylvania County,33513,32254,1259
0500000US37047,37,047,Columbus County,56293,54453,1840
0500000US37123,37,123,Montgomery County,27338,24939,2399
0500000US37153,37,153,Richmond County,45189,43383,1806
0500000US37171,37,171,Surry County,72099,68280,3819
0500000US37021,37,021,Buncombe County,254474,239920,14554
0500000US37025,37,025,Cabarrus County,201448,185416,16032
0500000US37057,37,057,Davidson County,164664,156350,8314
0500000US37091,37,091,Hertford County,24153,23355,798
0500000US37141,37,141,Pender County,59020,56635,2385
0500000US37189,37,189,Watauga County,54117,52463,1654
0500000US37177,37,177,Tyrrell County,4119,4017,102
0500000US38097,38,097,Traill County,8019,7892,127
0500000US38021,38,021,Dickey County,4970,4848,122
0500000US38101,38,101,Ward County,69034,65775,3259
0500000US38049,38,049,McHenry County,5927,5853,74
0500000US38005,38,005,Benson County,6886,6850,36
0500000US38075,38,075,Renville County,2495,2413,82
0500000US38015,38,015,Burleigh County,93737,91741,1996
0500000US38065,38,065,Oliver County,1837,1829,8
0500000US38071,38,071,Ramsey County,11557,11350,207
0500000US38039,38,039,Griggs County,2266,2244,22
0500000US38083,38,083,Sheridan County,1405,1397,8
0500000US38103,38,103,Wells County,4055,4038,17
0500000US39099,39,099,Mahoning County,231064,225492,5572
0500000US39145,39,145,Scioto County,76377,75665,712
0500000US39105,39,105,Meigs County,23160,23126,34
0500000US39131,39,131,Pike County,28214,28151,63
0500000US39061,39,061,Hamilton County,812037,766653,45384
0500000US39087,39,087,Lawrence County,60622,60135,487
0500000US39157,39,157,Tuscarawas County,92526,90967,1559
0500000US39015,39,015,Brown County,43679,43432,247
0500000US39043,39,043,Erie County,75136,73560,1576
0500000US39089,39,089,Licking County,172293,168333,3960
0500000US39019,39,019,Carroll County,27578,27368,210
0500000US39025,39,025,Clermont County,203216,198626,4590
0500000US39071,39,071,Highland County,43007,42594,413
0500000US39133,39,133,Portage County,162644,156159,6485
0500000US39013,39,013,Belmont County,68472,67669,803
0500000US39127,39,127,Perry County,35985,35802,183
0500000US48395,48,395,Robertson County,16890,15861,1029
0500000US48441,48,441,Taylor County,136348,128218,8130
0500000US48455,48,455,Trinity County,14569,13890,679
0500000US48019,48,019,Bandera County,21763,20653,1110
0500000US48079,48,079,Cochran County,2904,2497,407
0500000US48091,48,091,Comal County,135097,126611,8486
0500000US48225,48,225,Houston County,22955,22257,698
0500000US48375,48,375,Potter County,120899,101456,19443
0500000US48415,48,415,Scurry County,17239,16151,1088
0500000US48433,48,433,Stonewall County,1385,1377,8
0500000US48049,48,049,Brown County,37834,35990,1844
0500000US48025,48,025,Bee County,32691,31567,1124
0500000US48103,48,103,Crane County,4839,4045,794
0500000US48307,48,307,McCulloch County,8098,7823,275
0500000US48287,48,287,Lee County,16952,15565,1387
0500000US48139,48,139,Ellis County,168838,154399,14439
0500000US48265,48,265,Kerr County,51365,47791,3574
0500000US48145,48,145,Falls County,17299,16316,983
0500000US19137,19,137,Montgomery County,10155,9998,157
0500000US19123,19,123,Mahaska County,22208,21720,488
0500000US19019,19,019,Buchanan County,21125,20927,198
0500000US19053,19,053,Decatur County,8044,7882,162
0500000US20085,20,085,Jackson County,13318,13121,197
0500000US20109,20,109,Logan County,2810,2754,56
0500000US20209,20,209,Wyandotte County,164345,137256,27089
0500000US20027,20,027,Clay County,8142,7980,162
0500000US20169,20,169,Saline County,54977,51693,3284
0500000US20197,20,197,Wabaunsee County,6888,6840,48
0500000US20123,20,123,Mitchell County,6222,6127,95
0500000US20005,20,005,Atchison County,16363,16168,195
0500000US20055,20,055,Finney County,36957,28955,8002
0500000US20103,20,103,Leavenworth County,80042,77787,2255
0500000US20187,20,187,Stanton County,2063,1802,261
0500000US20119,20,119,Meade County,4261,3805,456
0500000US20151,20,151,Pratt County,9582,9245,337
0500000US20003,20,003,Anderson County,7852,7769,83
0500000US20061,20,061,Geary County,34895,32365,2530
0500000US20057,20,057,Ford County,34484,25374,9110
0500000US20117,20,117,Marshall County,9798,9693,105
0500000US20023,20,023,Cheyenne County,2677,2577,100
0500000US20035,20,035,Cowley County,35591,34431,1160
0500000US20059,20,059,Franklin County,25563,25165,398
0500000US20089,20,089,Jewell County,2916,2867,49
0500000US20159,20,159,Rice County,9762,9374,388
0500000US20017,20,017,Chase County,2645,2621,24
0500000US20203,20,203,Wichita County,2143,1924,219
0500000US20137,20,137,Norton County,5486,5356,130
0500000US20009,20,009,Barton County,26791,25186,1605
0500000US20047,20,047,Edwards County,2925,2652,273
0500000US20165,20,165,Rush County,3102,3065,37
0500000US20115,20,115,Marion County,12032,11890,142
0500000US20143,20,143,Ottawa County,5902,5859,43
0500000US20007,20,007,Barber County,4733,4671,62
0500000US20041,20,041,Dickinson County,19004,18615,389
0500000US21223,21,223,Trimble County,8637,8526,111
0500000US21105,21,105,Hickman County,4568,4525,43
0500000US21179,21,179,Nelson County,45388,44808,580
0500000US21081,21,081,Grant County,24915,24662,253
0500000US21141,21,141,Logan County,26849,26554,295
0500000US21191,21,191,Pendleton County,14520,14392,128
0500000US21215,21,215,Spencer County,18246,18035,211
0500000US21011,21,011,Bath County,12268,12148,120
0500000US21021,21,021,Boyle County,29913,29212,701
0500000US21095,21,095,Harlan County,27134,26953,181
0500000US21137,21,137,Lincoln County,24458,24265,193
0500000US21171,21,171,Monroe County,10634,10416,218
0500000US21225,21,225,Union County,14802,14591,211
0500000US21035,21,035,Calloway County,38776,36812,1964
0500000US21059,21,059,Daviess County,99937,97020,2917
0500000US21101,21,101,Henderson County,46137,45511,626
0500000US21119,21,119,Knott County,15513,15418,95
0500000US21177,21,177,Muhlenberg County,31081,30588,493
0500000US21199,21,199,Pulaski County,64145,62745,1400
0500000US21001,21,001,Adair County,19241,19011,230
0500000US21057,21,057,Cumberland County,6713,6662,51
0500000US21129,21,129,Lee County,6751,6693,58
0500000US21135,21,135,Lewis County,13490,13400,90
0500000US21239,21,239,Woodford County,26097,24882,1215
0500000US21113,21,113,Jessamine County,52422,49733,2689
0500000US21133,21,133,Letcher County,22676,22575,101
0500000US21145,21,145,McCracken County,65284,64105,1179
0500000US21235,21,235,Whitley County,36089,35708,381
0500000US21071,21,071,Floyd County,36926,36768,158
0500000US21147,21,147,McCreary County,17635,17464,171
0500000US21169,21,169,Metcalfe County,10004,9865,139
0500000US21205,21,205,Rowan County,24499,23918,581
0500000US21049,21,049,Clark County,35872,35132,740
0500000US21041,21,041,Carroll County,10711,10394,317
0500000US21065,21,065,Estill County,14313,14304,9
0500000US21089,21,089,Greenup County,35765,35523,242
0500000US21043,21,043,Carter County,27290,27209,81
0500000US22057,22,057,Lafourche Parish,98214,95209,3005
0500000US22053,22,053,Jefferson Davis Parish,31467,31226,241
0500000US22125,22,125,West Feliciana Parish,15377,15109,268
0500000US22011,22,011,Beauregard Parish,36769,35839,930
0500000US22039,22,039,Evangeline Parish,33636,32621,1015
0500000US22061,22,061,Lincoln Parish,47356,45199,2157
0500000US22119,22,119,Webster Parish,39631,39278,353
0500000US22047,22,047,Iberville Parish,32956,32701,255
0500000US22067,22,067,Morehouse Parish,25992,25843,149
0500000US22109,22,109,Terrebonne Parish,112587,108888,3699
0500000US22027,22,027,Claiborne Parish,16153,15993,160
0500000US22009,22,009,Avoyelles Parish,40882,40534,348
0500000US22077,22,077,Pointe Coupee Parish,22158,21757,401
0500000US22115,22,115,Vernon Parish,51007,48914,2093
0500000US22085,22,085,Sabine Parish,24088,23784,304
0500000US22059,22,059,LaSalle Parish,14949,14648,301
0500000US23015,23,015,Lincoln County,34067,33038,1029
0500000US23021,23,021,Piscataquis County,16887,16563,324
0500000US23029,23,029,Washington County,31694,30387,1307
0500000US23023,23,023,Sagadahoc County,35277,33958,1319
0500000US23011,23,011,Kennebec County,121545,118618,2927
0500000US23009,23,009,Hancock County,54541,52826,1715
0500000US24039,24,039,Somerset County,25737,24159,1578
0500000US24001,24,001,Allegany County,71977,70466,1511
0500000US24033,24,033,Prince George's County,906202,702770,203432
0500000US24021,24,021,Frederick County,248472,222051,26421
0500000US24029,24,029,Kent County,19593,18759,834
0500000US25027,25,027,Worcester County,822280,724122,98158
0500000US26033,26,033,Chippewa County,37834,36836,998
0500000US26125,26,125,Oakland County,1250843,1092417,158426
0500000US26121,26,121,Muskegon County,173043,169887,3156
0500000US26087,26,087,Lapeer County,88202,85957,2245
0500000US26151,26,151,Sanilac County,41376,40595,781
0500000US26131,26,131,Ontonagon County,5968,5879,89
0500000US26001,26,001,Alcona County,10364,10221,143
0500000US26079,26,079,Kalkaska County,17463,17181,282
0500000US26129,26,129,Ogemaw County,20928,20660,268
0500000US26165,26,165,Wexford County,33111,32656,455
0500000US26043,26,043,Dickinson County,25570,25259,311
0500000US26065,26,065,Ingham County,289564,262186,27378
0500000US26109,26,109,Menominee County,23234,23007,227
0500000US26113,26,113,Missaukee County,15006,14768,238
0500000US26159,26,159,Van Buren County,75272,71688,3584
0500000US26015,26,015,Barry County,60057,59145,912
0500000US26019,26,019,Benzie County,17552,17267,285
0500000US26153,26,153,Schoolcraft County,8069,8004,65
0500000US26055,26,055,Grand Traverse County,91746,89321,2425
0500000US26049,26,049,Genesee County,409361,398866,10495
0500000US26093,26,093,Livingston County,188482,183135,5347
0500000US26101,26,101,Manistee County,24444,24008,436
0500000US26051,26,051,Gladwin County,25289,25061,228
0500000US05075,05,075,Lawrence County,16669,16522,147
0500000US05029,05,029,Conway County,20906,20432,474
0500000US05001,05,001,Arkansas County,18124,17989,135
0500000US05085,05,085,Lonoke County,72206,70658,1548
0500000US06047,06,047,Merced County,269075,199835,69240
0500000US06049,06,049,Modoc County,8938,8293,645
0500000US06027,06,027,Inyo County,18085,16427,1658
0500000US06099,06,099,Stanislaus County,539301,428370,110931
0500000US06103,06,103,Tehama County,63373,57814,5559
0500000US06069,06,069,San Benito County,59416,47363,12053
0500000US06017,06,017,El Dorado County,186661,168767,17894
0500000US06075,06,075,San Francisco County,870044,570385,299659
0500000US06107,06,107,Tulare County,460477,358413,102064
0500000US06057,06,057,Nevada County,99092,93595,5497
0500000US06039,06,039,Madera County,155013,123049,31964
0500000US06105,06,105,Trinity County,12862,12284,578
0500000US06071,06,071,San Bernardino County,2135413,1687217,448196
0500000US06061,06,061,Placer County,380077,338427,41650
0500000US06095,06,095,Solano County,438530,350738,87792
0500000US06011,06,011,Colusa County,21464,15567,5897
0500000US06031,06,031,Kings County,150075,122936,27139
0500000US06019,06,019,Fresno County,978130,769312,208818
0500000US06111,06,111,Ventura County,848112,661332,186780
0500000US08123,08,123,Weld County,295123,269370,25753
0500000US08027,08,027,Custer County,4640,4520,120
0500000US08035,08,035,Douglas County,328614,304673,23941
0500000US08067,08,067,La Plata County,55101,53532,1569
0500000US08105,08,105,Rio Grande County,11351,10805,546
0500000US08011,08,011,Bent County,5809,5536,273
0500000US08111,08,111,San Juan County,544,526,18
0500000US08075,08,075,Logan County,21689,20775,914
0500000US08119,08,119,Teller County,24113,23303,810
0500000US08039,08,039,Elbert County,25162,24508,654
0500000US08073,08,073,Lincoln County,5548,5281,267
0500000US08003,08,003,Alamosa County,16444,15039,1405
0500000US08043,08,043,Fremont County,47002,45655,1347
0500000US08085,08,085,Montrose County,41268,38518,2750
0500000US08109,08,109,Saguache County,6468,5770,698
0500000US08053,08,053,Hinsdale County,878,866,12
0500000US08049,08,049,Grand County,15066,13857,1209
0500000US08089,08,089,Otero County,18325,17282,1043
0500000US09005,09,005,Litchfield County,183031,168580,14451
0500000US09011,09,011,New London County,268881,245921,22960
0500000US09001,09,001,Fairfield County,944348,739339,205009
0500000US10001,10,001,Kent County,174822,164917,9905
0500000US12057,12,057,Hillsborough County,1378883,1144302,234581
0500000US12129,12,129,Wakulla County,31877,31205,672
0500000US12045,12,045,Gulf County,16055,15668,387
0500000US12097,12,097,Osceola County,338619,270885,67734
0500000US12131,12,131,Walton County,65858,62065,3793
0500000US12065,12,065,Jefferson County,14105,13556,549
0500000US12049,12,049,Hardee County,27228,24157,3071
0500000US12093,12,093,Okeechobee County,40572,35588,4984
0500000US12041,12,041,Gilchrist County,17615,17022,593
0500000US12001,12,001,Alachua County,263148,236174,26974
0500000US12015,12,015,Charlotte County,176954,158643,18311
0500000US12085,12,085,Martin County,157581,141638,15943
0500000US12115,12,115,Sarasota County,412144,361320,50824
0500000US12017,12,017,Citrus County,143087,134983,8104
0500000US12113,12,113,Santa Rosa County,170442,162293,8149
0500000US12011,12,011,Broward County,1909151,1266510,642641
0500000US12087,12,087,Monroe County,76325,61769,14556
0500000US13313,13,313,Whitfield County,103849,84590,19259
0500000US13285,13,285,Troup County,69774,67004,2770
0500000US13145,13,145,Harris County,33590,32821,769
0500000US13321,13,321,Worth County,20656,20388,268
0500000US13109,13,109,Evans County,10727,10248,479
0500000US13307,13,307,Webster County,2613,2513,100
0500000US13125,13,125,Glascock County,3009,3003,6
0500000US13051,13,051,Chatham County,287049,268978,18071
0500000US13173,13,173,Lanier County,10366,10213,153
0500000US13195,13,195,Madison County,28900,27744,1156
0500000US13147,13,147,Hart County,25631,24971,660
0500000US13191,13,191,McIntosh County,14120,13792,328
0500000US13237,13,237,Putnam County,21503,20705,798
0500000US13301,13,301,Warren County,5346,5268,78
0500000US13029,13,029,Bryan County,35885,34233,1652
0500000US13039,13,039,Camden County,52714,50332,2382
0500000US13099,13,099,Early County,10348,10159,189
0500000US13069,13,069,Coffee County,42961,40328,2633
0500000US13123,13,123,Gilmer County,29922,27862,2060
0500000US13317,13,317,Wilkes County,9884,9476,408
0500000US13129,13,129,Gordon County,56790,51557,5233
0500000US13057,13,057,Cherokee County,241910,220638,21272
0500000US13177,13,177,Lee County,29348,28278,1070
0500000US13133,13,133,Greene County,16976,16173,803
0500000US13075,13,075,Cook County,17184,16739,445
0500000US13121,13,121,Fulton County,1021902,891823,130079
0500000US13187,13,187,Lumpkin County,31951,30815,1136
0500000US13201,13,201,Miller County,5836,5827,9
0500000US13219,13,219,Oconee County,37017,34790,2227
0500000US13151,13,151,Henry County,221307,204324,16983
0500000US13183,13,183,Long County,18156,16989,1167
0500000US13257,13,257,Stephens County,25676,25137,539
0500000US13293,13,293,Upson County,26216,25816,400
0500000US13225,13,225,Peach County,26966,25461,1505
0500000US13229,13,229,Pierce County,19164,18661,503
0500000US13251,13,251,Screven County,13990,13749,241
0500000US13011,13,011,Banks County,18510,17600,910
0500000US13061,13,061,Clay County,3001,2948,53
0500000US13089,13,089,DeKalb County,743187,621355,121832
0500000US13157,13,157,Jackson County,65755,62172,3583
0500000US13181,13,181,Lincoln County,7799,7706,93
0500000US13235,13,235,Pulaski County,11295,11078,217
0500000US13281,13,281,Towns County,11417,11072,345
0500000US13287,13,287,Turner County,7962,7883,79
0500000US13001,13,001,Appling County,18454,17727,727
0500000US16077,16,077,Power County,7713,6540,1173
0500000US16071,16,071,Oneida County,4326,4191,135
0500000US16063,16,063,Lincoln County,5321,4550,771
0500000US16041,16,041,Franklin County,13279,12913,366
0500000US16053,16,053,Jerome County,23431,19779,3652
0500000US16067,16,067,Minidoka County,20615,17442,3173
0500000US16013,16,013,Blaine County,21994,18789,3205
0500000US16021,16,021,Boundary County,11549,11023,526
0500000US16047,16,047,Gooding County,15169,13192,1977
0500000US16007,16,007,Bear Lake County,5962,5753,209
0500000US16019,16,019,Bonneville County,112397,106119,6278
0500000US16035,16,035,Clearwater County,8640,8441,199
0500000US16059,16,059,Lemhi County,7798,7560,238
0500000US16017,16,017,Bonner County,42711,41742,969
0500000US16037,16,037,Custer County,4141,4089,52
0500000US16065,16,065,Madison County,38705,37149,1556
0500000US16081,16,081,Teton County,11080,10124,956
0500000US15003,15,003,Honolulu County,987638,794966,192672
0500000US17183,17,183,Vermilion County,78407,76715,1692
0500000US17023,17,023,Clark County,15836,15658,178
0500000US17049,17,049,Effingham County,34174,33474,700
0500000US17065,17,065,Hamilton County,8221,8090,131
0500000US17087,17,087,Johnson County,12602,12389,213
0500000US17105,17,105,Livingston County,36324,35578,746
0500000US17179,17,179,Tazewell County,133852,131221,2631
0500000US17187,17,187,Warren County,17338,16490,848
0500000US17119,17,119,Madison County,265670,259565,6105
0500000US17131,17,131,Mercer County,15693,15502,191
0500000US17003,17,003,Alexander County,6532,6489,43
0500000US17157,17,157,Randolph County,32546,32119,427
0500000US17115,17,115,Macon County,106512,104332,2180
0500000US17191,17,191,Wayne County,16487,16376,111
0500000US17055,17,055,Franklin County,39127,38772,355
0500000US17109,17,109,McDonough County,30875,29680,1195
0500000US17139,17,139,Moultrie County,14703,14538,165
0500000US17151,17,151,Pope County,4249,4212,37
0500000US17173,17,173,Shelby County,21832,21767,65
0500000US17019,17,019,Champaign County,209448,184360,25088
0500000US17053,17,053,Ford County,13398,13275,123
0500000US17093,17,093,Kendall County,124626,113035,11591
0500000US17121,17,121,Marion County,38084,37572,512
0500000US17125,17,125,Mason County,13778,13684,94
0500000US18149,18,149,Starke County,22941,22436,505
0500000US18055,18,055,Greene County,32295,32041,254
0500000US18177,18,177,Wayne County,66613,65017,1596
0500000US18037,18,037,Dubois County,42418,40674,1744
0500000US18059,18,059,Hancock County,73830,72207,1623
0500000US18115,18,115,Ohio County,5887,5838,49
0500000US18121,18,121,Parke County,16996,16769,227
0500000US18007,18,007,Benton County,8667,8522,145
0500000US18133,18,133,Putnam County,37559,36798,761
0500000US18175,18,175,Washington County,27827,27664,163
0500000US18065,18,065,Henry County,48483,48119,364
0500000US18095,18,095,Madison County,129505,127091,2414
0500000US18125,18,125,Pike County,12411,12267,144
0500000US18151,18,151,Steuben County,34474,33659,815
0500000US18179,18,179,Wells County,27947,27537,410
0500000US18035,18,035,Delaware County,115616,112985,2631
0500000US18077,18,077,Jefferson County,32237,31873,364
0500000US18103,18,103,Miami County,35901,35498,403
0500000US18111,18,111,Newton County,14018,13520,498
0500000US18141,18,141,St. Joseph County,269240,252049,17191
0500000US18155,18,155,Switzerland County,10628,10413,215
0500000US18015,18,015,Carroll County,19994,19409,585
0500000US18069,18,069,Huntington County,36378,35841,537
0500000US18181,18,181,White County,24217,23141,1076
0500000US18075,18,075,Jay County,20993,20780,213
0500000US18019,18,019,Clark County,115702,111568,4134
0500000US19101,19,101,Jefferson County,18077,16065,2012
0500000US19005,19,005,Allamakee County,13880,13141,739
0500000US19049,19,049,Dallas County,84002,77331,6671
0500000US19023,19,023,Butler County,14735,14572,163
0500000US19071,19,071,Fremont County,6968,6813,155
0500000US19173,19,173,Taylor County,6201,5961,240
0500000US19195,19,195,Worth County,7489,7423,66
0500000US19003,19,003,Adams County,3726,3696,30
0500000US19037,19,037,Chickasaw County,12099,11844,255
0500000US19059,19,059,Dickinson County,17056,16797,259
0500000US19103,19,103,Johnson County,147001,130000,17001
0500000US19171,19,171,Tama County,17136,16389,747
0500000US19069,19,069,Franklin County,10245,9970,275
0500000US19027,19,027,Carroll County,20344,20190,154
0500000US19067,19,067,Floyd County,15858,15483,375
0500000US19115,19,115,Louisa County,11223,10110,1113
0500000US19119,19,119,Lyon County,11769,11601,168
0500000US19165,19,165,Shelby County,11694,11500,194
0500000US19087,19,087,Henry County,19926,19185,741
0500000US19145,19,145,Page County,15363,14968,395
0500000US19155,19,155,Pottawattamie County,93503,89608,3895
0500000US19043,19,043,Clayton County,17672,17275,397
0500000US19021,19,021,Buena Vista County,20260,16512,3748
0500000US19077,19,077,Guthrie County,10674,10563,111
0500000US19091,19,091,Humboldt County,9566,9318,248
0500000US19183,19,183,Washington County,22143,21356,787
