geo_id,state_id,county_id,county_name,family_structure_hh_total,family_structure_hh_with_one_or_more_under_18,family_structure_hh_with_none_under_18
0500000US28151,28,151,Washington County,18299,5694,12605
0500000US28111,28,111,Perry County,4563,1652,2911
0500000US28019,28,019,Choctaw County,3164,748,2416
0500000US28057,28,057,Itawamba County,8706,3081,5625
0500000US28015,28,015,Carroll County,3658,917,2741
0500000US28043,28,043,Grenada County,8224,2642,5582
0500000US28063,28,063,Jefferson County,2530,664,1866
0500000US28041,28,041,Greene County,4172,1149,3023
0500000US28093,28,093,Marshall County,13074,3576,9498
0500000US28119,28,119,Quitman County,3055,821,2234
0500000US28011,28,011,Bolivar County,12159,3985,8174
0500000US28073,28,073,Lamar County,22213,8113,14100
0500000US28081,28,081,Lee County,32267,10808,21459
0500000US28113,28,113,Pike County,14676,4567,10109
0500000US28135,28,135,Tallahatchie County,4253,1436,2817
0500000US28129,28,129,Smith County,5872,1801,4071
0500000US28131,28,131,Stone County,6135,1970,4165
0500000US28149,28,149,Warren County,18766,5822,12944
0500000US28023,28,023,Clarke County,6258,1883,4375
0500000US28069,28,069,Kemper County,3710,1113,2597
0500000US28097,28,097,Montgomery County,4619,1457,3162
0500000US28105,28,105,Oktibbeha County,17687,4700,12987
0500000US28109,28,109,Pearl River County,20752,6833,13919
0500000US28079,28,079,Leake County,8168,2842,5326
0500000US28103,28,103,Noxubee County,4020,1271,2749
0500000US28099,28,099,Neshoba County,10699,4055,6644
0500000US28121,28,121,Rankin County,55595,20494,35101
0500000US28137,28,137,Tate County,10264,3694,6570
0500000US28077,28,077,Lawrence County,4793,1610,3183
0500000US28107,28,107,Panola County,12447,4122,8325
0500000US28161,28,161,Yalobusha County,5161,1256,3905
0500000US28017,28,017,Chickasaw County,6426,2187,4239
0500000US28029,28,029,Copiah County,9623,3239,6384
0500000US28039,28,039,George County,7362,2111,5251
0500000US28049,28,049,Hinds County,88705,28986,59719
0500000US28101,28,101,Newton County,8042,3005,5037
0500000US28145,28,145,Union County,9951,3020,6931
0500000US28125,28,125,Sharkey County,1755,533,1222
0500000US28139,28,139,Tippah County,7983,2549,5434
0500000US28035,28,035,Forrest County,28033,9102,18931
0500000US28045,28,045,Hancock County,19519,6278,13241
0500000US28071,28,071,Lafayette County,19317,5713,13604
0500000US28055,28,055,Issaquena County,484,105,379
0500000US28087,28,087,Lowndes County,22742,7230,15512
0500000US28083,28,083,Leflore County,10224,3612,6612
0500000US28157,28,157,Wilkinson County,2898,735,2163
0500000US28047,28,047,Harrison County,78863,25864,52999
0500000US28065,28,065,Jefferson Davis County,4839,1296,3543
0500000US28085,28,085,Lincoln County,12827,4263,8564
0500000US28123,28,123,Scott County,10435,3987,6448
0500000US28159,28,159,Winston County,7396,2095,5301
0500000US28163,28,163,Yazoo County,8689,3060,5629
0500000US28009,28,009,Benton County,3033,876,2157
0500000US28037,28,037,Franklin County,3004,934,2070
0500000US28061,28,061,Jasper County,6690,1986,4704
0500000US28067,28,067,Jones County,24774,8408,16366
0500000US28095,28,095,Monroe County,14043,4009,10034
0500000US28133,28,133,Sunflower County,8389,2834,5555
0500000US28155,28,155,Webster County,3787,1391,2396
0500000US28001,28,001,Adams County,11341,3120,8221
0500000US28025,28,025,Clay County,7755,2487,5268
0500000US28031,28,031,Covington County,6794,2257,4537
0500000US28053,28,053,Humphreys County,3171,974,2197
0500000US29123,29,123,Madison County,5002,1404,3598
0500000US29229,29,229,Wright County,7292,2339,4953
0500000US29217,29,217,Vernon County,8170,2403,5767
0500000US29195,29,195,Saline County,8562,2582,5980
0500000US29147,29,147,Nodaway County,8275,2073,6202
0500000US29041,29,041,Chariton County,2779,739,2040
0500000US29079,29,079,Grundy County,3985,1075,2910
0500000US29141,29,141,Morgan County,7755,1827,5928
0500000US29223,29,223,Wayne County,5448,1398,4050
0500000US29017,29,017,Bollinger County,4669,1324,3345
0500000US29031,29,031,Cape Girardeau County,29366,8004,21362
0500000US29205,29,205,Shelby County,2459,737,1722
0500000US29225,29,225,Webster County,13496,4746,8750
0500000US29005,29,005,Atchison County,2505,615,1890
0500000US29013,29,013,Bates County,6706,2142,4564
0500000US29015,29,015,Benton County,7947,1517,6430
0500000US29035,29,035,Carter County,2366,685,1681
0500000US29057,29,057,Dade County,3117,832,2285
0500000US29115,29,115,Linn County,5068,1516,3552
0500000US29091,29,091,Howell County,15922,4434,11488
0500000US29101,29,101,Johnson County,19939,6621,13318
0500000US29105,29,105,Laclede County,13866,4668,9198
0500000US29125,29,125,Maries County,3645,978,2667
0500000US29161,29,161,Phelps County,17601,5507,12094
0500000US29165,29,165,Platte County,38613,12945,25668
0500000US29187,29,187,St. Francois County,24910,7772,17138
0500000US29003,29,003,Andrew County,6807,2116,4691
0500000US29033,29,033,Carroll County,3552,1061,2491
0500000US29061,29,061,Daviess County,2991,888,2103
0500000US29103,29,103,Knox County,1533,402,1131
0500000US29127,29,127,Marion County,11500,3623,7877
0500000US29151,29,151,Osage County,5113,1518,3595
0500000US29181,29,181,Ripley County,5154,1533,3621
0500000US29219,29,219,Warren County,12232,4066,8166
0500000US29007,29,007,Audrain County,9328,2694,6634
0500000US29043,29,043,Christian County,31097,11415,19682
0500000US29077,29,077,Greene County,122026,32746,89280
0500000US29081,29,081,Harrison County,3556,969,2587
0500000US29185,29,185,St. Clair County,4126,950,3176
0500000US29001,29,001,Adair County,9513,2206,7307
0500000US29199,29,199,Scotland County,1820,533,1287
0500000US29211,29,211,Sullivan County,2174,667,1507
0500000US29045,29,045,Clark County,2942,909,2033
0500000US29099,29,099,Jefferson County,84393,28895,55498
0500000US29111,29,111,Lewis County,3766,1124,2642
0500000US29143,29,143,New Madrid County,7312,2370,4942
0500000US29157,29,157,Perry County,7605,2552,5053
0500000US29173,29,173,Ralls County,4004,1102,2902
0500000US29177,29,177,Ray County,8785,2744,6041
0500000US29189,29,189,St. Louis County,403547,119115,284432
0500000US29209,29,209,Stone County,12841,2566,10275
0500000US29009,29,009,Barry County,13211,3903,9308
0500000US29019,29,019,Boone County,69957,19562,50395
0500000US29039,29,039,Cedar County,5785,1597,4188
0500000US29055,29,055,Crawford County,9473,2697,6776
0500000US29093,29,093,Iron County,4156,1222,2934
0500000US29117,29,117,Livingston County,5882,1671,4211
0500000US29135,29,135,Moniteau County,5346,1813,3533
0500000US29149,29,149,Oregon County,4307,1028,3279
0500000US29159,29,159,Pettis County,15921,5238,10683
0500000US29186,29,186,Ste. Genevieve County,7134,2189,4945
0500000US29175,29,175,Randolph County,8347,2410,5937
0500000US29069,29,069,Dunklin County,12427,3769,8658
0500000US29071,29,071,Franklin County,40780,13451,27329
0500000US29089,29,089,Howard County,3559,1037,2522
0500000US29095,29,095,Jackson County,282653,81524,201129
0500000US29131,29,131,Miller County,9804,3058,6746
0500000US29169,29,169,Pulaski County,15026,5291,9735
0500000US29171,29,171,Putnam County,1803,451,1352
0500000US29213,29,213,Taney County,22366,6443,15923
0500000US29215,29,215,Texas County,9579,2924,6655
0500000US29021,29,021,Buchanan County,33432,9842,23590
0500000US29025,29,025,Caldwell County,3682,1081,2601
0500000US29027,29,027,Callaway County,16038,4967,11071
0500000US29037,29,037,Cass County,39444,13542,25902
0500000US29049,29,049,Clinton County,8157,3035,5122
0500000US29053,29,053,Cooper County,6428,1825,4603
0500000US29059,29,059,Dallas County,6253,1893,4360
0500000US29075,29,075,Gentry County,2601,770,1831
0500000US29085,29,085,Hickory County,4020,738,3282
0500000US29113,29,113,Lincoln County,18738,6952,11786
0500000US29133,29,133,Mississippi County,5040,1732,3308
0500000US29137,29,137,Monroe County,3632,891,2741
0500000US29145,29,145,Newton County,22268,7197,15071
0500000US29153,29,153,Ozark County,4144,918,3226
0500000US29163,29,163,Pike County,6650,2156,4494
0500000US29183,29,183,St. Charles County,144643,49965,94678
0500000US30017,30,017,Custer County,4889,1422,3467
0500000US30041,30,041,Hill County,6274,2090,4184
0500000US30075,30,075,Powder River County,769,161,608
0500000US30067,30,067,Park County,7691,1768,5923
0500000US30085,30,085,Roosevelt County,3156,1127,2029
0500000US30005,30,005,Blaine County,2320,840,1480
0500000US30051,30,051,Liberty County,886,179,707
0500000US30083,30,083,Richland County,4493,1253,3240
0500000US30099,30,099,Teton County,2475,686,1789
0500000US30101,30,101,Toole County,1898,516,1382
0500000US30025,30,025,Fallon County,1302,315,987
0500000US30019,30,019,Daniels County,856,218,638
0500000US30045,30,045,Judith Basin County,923,177,746
0500000US30093,30,093,Silver Bow County,15158,3772,11386
0500000US30023,30,023,Deer Lodge County,3855,823,3032
0500000US30043,30,043,Jefferson County,4444,1194,3250
0500000US30055,30,055,McCone County,704,118,586
0500000US30107,30,107,Wheatland County,821,225,596
0500000US30087,30,087,Rosebud County,3147,913,2234
0500000US30011,30,011,Carter County,625,126,499
0500000US30021,30,021,Dawson County,3972,1113,2859
0500000US30007,30,007,Broadwater County,2420,525,1895
0500000US30047,30,047,Lake County,11849,3492,8357
0500000US30073,30,073,Pondera County,2114,594,1520
0500000US30111,30,111,Yellowstone County,65025,19300,45725
0500000US30081,30,081,Ravalli County,17108,4172,12936
0500000US30105,30,105,Valley County,3436,880,2556
0500000US30027,30,027,Fergus County,4975,1221,3754
0500000US30061,30,061,Mineral County,1699,379,1320
0500000US30069,30,069,Petroleum County,187,38,149
0500000US30089,30,089,Sanders County,4953,1081,3872
0500000US30109,30,109,Wibaux County,497,171,326
0500000US30059,30,059,Meagher County,749,156,593
0500000US30009,30,009,Carbon County,4531,979,3552
0500000US30029,30,029,Flathead County,38252,10124,28128
0500000US30071,30,071,Phillips County,1770,349,1421
0500000US31001,31,001,Adams County,12710,3775,8935
0500000US31109,31,109,Lancaster County,122646,35959,86687
0500000US31011,31,011,Boone County,2280,576,1704
0500000US31149,31,149,Rock County,626,107,519
0500000US31007,31,007,Banner County,279,80,199
0500000US31163,31,163,Sherman County,1358,319,1039
0500000US31147,31,147,Richardson County,3772,1007,2765
0500000US31093,31,093,Howard County,2684,828,1856
0500000US31089,31,089,Holt County,4435,1234,3201
0500000US31065,31,065,Furnas County,2142,560,1582
0500000US31073,31,073,Gosper County,877,186,691
0500000US31151,31,151,Saline County,5073,1788,3285
0500000US31153,31,153,Sarpy County,65045,26135,38910
0500000US31173,31,173,Thurston County,2175,1009,1166
0500000US31177,31,177,Washington County,8125,2447,5678
0500000US31015,31,015,Boyd County,903,196,707
0500000US31031,31,031,Cherry County,2566,649,1917
0500000US31053,31,053,Dodge County,15289,4730,10559
0500000US31059,31,059,Fillmore County,2510,638,1872
0500000US31069,31,069,Garden County,871,203,668
0500000US31091,31,091,Hooker County,319,50,269
0500000US31123,31,123,Morrill County,1982,605,1377
0500000US31127,31,127,Nemaha County,2877,852,2025
0500000US31159,31,159,Seward County,6596,2001,4595
0500000US31171,31,171,Thomas County,292,82,210
0500000US31043,31,043,Dakota County,7456,3091,4365
0500000US31181,31,181,Webster County,1519,430,1089
0500000US31003,31,003,Antelope County,2675,685,1990
0500000US31023,31,023,Butler County,3377,1029,2348
0500000US31035,31,035,Clay County,2574,702,1872
0500000US31041,31,041,Custer County,4846,1529,3317
0500000US31067,31,067,Gage County,9160,2322,6838
0500000US31081,31,081,Hamilton County,3699,1218,2481
0500000US31099,31,099,Kearney County,2682,689,1993
0500000US31101,31,101,Keith County,3844,906,2938
0500000US31119,31,119,Madison County,14254,4401,9853
0500000US31135,31,135,Perkins County,1225,355,870
0500000US31155,31,155,Saunders County,8326,2561,5765
0500000US31179,31,179,Wayne County,3657,989,2668
0500000US31103,31,103,Keya Paha County,326,81,245
0500000US31107,31,107,Knox County,3674,978,2696
0500000US31111,31,111,Lincoln County,14985,4527,10458
0500000US31139,31,139,Pierce County,3026,911,2115
0500000US31165,31,165,Sioux County,579,121,458
0500000US31025,31,025,Cass County,10005,3379,6626
0500000US31051,31,051,Dixon County,2311,686,1625
0500000US31057,31,057,Dundy County,865,239,626
0500000US31077,31,077,Greeley County,1034,300,734
0500000US31079,31,079,Hall County,22870,8366,14504
0500000US31131,31,131,Otoe County,6452,1946,4506
0500000US31145,31,145,Red Willow County,4459,1097,3362
0500000US31045,31,045,Dawes County,3623,1067,2556
0500000US31033,31,033,Cheyenne County,4434,1119,3315
0500000US31047,31,047,Dawson County,8997,3421,5576
0500000US31117,31,117,McPherson County,203,52,151
0500000US31125,31,125,Nance County,1546,437,1109
0500000US31167,31,167,Stanton County,2410,826,1584
0500000US31175,31,175,Valley County,1840,504,1336
0500000US31083,31,083,Harlan County,1521,357,1164
0500000US31009,31,009,Blaine County,218,49,169
0500000US31019,31,019,Buffalo County,19165,5982,13183
0500000US31049,31,049,Deuel County,824,210,614
0500000US31087,31,087,Hitchcock County,1209,277,932
0500000US31141,31,141,Platte County,13000,3880,9120
0500000US31169,31,169,Thayer County,2283,545,1738
0500000US31013,31,013,Box Butte County,4801,1415,3386
0500000US32001,32,001,Churchill County,9819,2681,7138
0500000US32005,32,005,Douglas County,20579,4600,15979
0500000US32027,32,027,Pershing County,1933,692,1241
0500000US32009,32,009,Esmeralda County,454,89,365
0500000US32013,32,013,Humboldt County,6271,2239,4032
0500000US32021,32,021,Mineral County,1938,400,1538
0500000US32033,32,033,White Pine County,3529,1017,2512
0500000US32007,32,007,Elko County,17688,6727,10961
0500000US32017,32,017,Lincoln County,2041,477,1564
0500000US32023,32,023,Nye County,18668,3333,15335
0500000US32029,32,029,Storey County,1598,357,1241
0500000US32031,32,031,Washoe County,177632,52483,125149
0500000US32003,32,003,Clark County,767954,242620,525334
0500000US32510,32,510,Carson City,22461,6555,15906
0500000US32019,32,019,Lyon County,20528,5920,14608
0500000US33005,33,005,Cheshire County,30319,7547,22772
0500000US33013,33,013,Merrimack County,57843,16668,41175
0500000US33009,33,009,Grafton County,34752,8182,26570
0500000US33015,33,015,Rockingham County,120147,35549,84598
0500000US33001,33,001,Belknap County,24739,5975,18764
0500000US33019,33,019,Sullivan County,17740,4518,13222
0500000US33011,33,011,Hillsborough County,159200,48101,111099
0500000US33017,33,017,Strafford County,48548,13543,35005
0500000US33007,33,007,Coos County,13720,3161,10559
0500000US33003,33,003,Carroll County,21070,4417,16653
0500000US34025,34,025,Monmouth County,233874,72160,161714
0500000US34037,34,037,Sussex County,53361,16187,37174
0500000US34011,34,011,Cumberland County,50608,17979,32629
0500000US34013,34,013,Essex County,282502,99164,183338
0500000US34029,34,029,Ocean County,225270,61783,163487
0500000US34015,34,015,Gloucester County,104587,34801,69786
0500000US34033,34,033,Salem County,23908,7051,16857
0500000US34031,34,031,Passaic County,163670,59697,103973
0500000US34007,34,007,Camden County,187158,61210,125948
0500000US34003,34,003,Bergen County,338249,112764,225485
0500000US34041,34,041,Warren County,41350,12163,29187
0500000US34017,34,017,Hudson County,255429,80320,175109
0500000US34005,34,005,Burlington County,165496,52667,112829
0500000US34027,34,027,Morris County,180896,59494,121402
0500000US35039,35,039,Rio Arriba County,12398,3010,9388
0500000US35047,35,047,San Miguel County,11292,2871,8421
0500000US35057,35,057,Torrance County,5664,1464,4200
0500000US35035,35,035,Otero County,23391,6727,16664
0500000US35006,35,006,Cibola County,8939,3464,5475
0500000US35019,35,019,Guadalupe County,1404,250,1154
0500000US35003,35,003,Catron County,1381,181,1200
0500000US35029,35,029,Luna County,9025,2401,6624
0500000US35031,35,031,McKinley County,20295,7811,12484
0500000US35055,35,055,Taos County,12127,2555,9572
0500000US35017,35,017,Grant County,12003,2819,9184
0500000US35007,35,007,Colfax County,5678,1276,4402
0500000US35015,35,015,Eddy County,21264,7638,13626
0500000US35033,35,033,Mora County,1535,227,1308
0500000US35037,35,037,Quay County,3060,589,2471
0500000US35027,35,027,Lincoln County,7815,1544,6271
0500000US35025,35,025,Lea County,22114,9306,12808
0500000US35049,35,049,Santa Fe County,61972,14664,47308
0500000US35051,35,051,Sierra County,5377,977,4400
0500000US35053,35,053,Socorro County,4550,995,3555
0500000US35013,35,013,Do�a Ana County,77453,26820,50633
0500000US36095,36,095,Schoharie County,12559,3211,9348
0500000US36067,36,067,Onondaga County,185624,53891,131733
0500000US36019,36,019,Clinton County,31395,8675,22720
0500000US36099,36,099,Seneca County,13522,3522,10000
0500000US36079,36,079,Putnam County,34847,11066,23781
0500000US36033,36,033,Franklin County,19088,5440,13648
0500000US36069,36,069,Ontario County,44286,12136,32150
0500000US36081,36,081,Queens County,779234,243595,535639
0500000US36101,36,101,Steuben County,40183,11407,28776
0500000US36041,36,041,Hamilton County,1124,178,946
0500000US36115,36,115,Washington County,24009,6939,17070
0500000US36013,36,013,Chautauqua County,52572,13698,38874
0500000US36047,36,047,Kings County,950856,294605,656251
0500000US36061,36,061,New York County,758133,135941,622192
0500000US36107,36,107,Tioga County,20045,5606,14439
0500000US36011,36,011,Cayuga County,31251,9004,22247
0500000US36073,36,073,Orleans County,16333,4910,11423
0500000US36091,36,091,Saratoga County,93876,26772,67104
0500000US36087,36,087,Rockland County,100005,37642,62363
0500000US36021,36,021,Columbia County,25243,6049,19194
0500000US36049,36,049,Lewis County,10242,3112,7130
0500000US36063,36,063,Niagara County,88211,23158,65053
0500000US36119,36,119,Westchester County,347332,117266,230066
0500000US36025,36,025,Delaware County,19030,4438,14592
0500000US36031,36,031,Essex County,15425,4046,11379
0500000US36057,36,057,Montgomery County,19665,5707,13958
0500000US36059,36,059,Nassau County,445517,158180,287337
0500000US36085,36,085,Richmond County,166152,58700,107452
0500000US36097,36,097,Schuyler County,7304,1718,5586
0500000US36109,36,109,Tompkins County,39326,9180,30146
0500000US36017,36,017,Chenango County,20616,5349,15267
0500000US36023,36,023,Cortland County,17685,4902,12783
0500000US36045,36,045,Jefferson County,43267,14543,28724
0500000US36065,36,065,Oneida County,90014,26327,63687
0500000US36103,36,103,Suffolk County,487981,164688,323293
0500000US36121,36,121,Wyoming County,15815,4406,11409
0500000US36015,36,015,Chemung County,34373,9739,24634
0500000US36075,36,075,Oswego County,46032,14410,31622
0500000US36077,36,077,Otsego County,23556,5854,17702
0500000US36117,36,117,Wayne County,36504,10308,26196
0500000US36001,36,001,Albany County,126008,30847,95161
0500000US36007,36,007,Broome County,78594,19904,58690
0500000US36029,36,029,Erie County,387847,102626,285221
0500000US36053,36,053,Madison County,26026,6791,19235
0500000US36105,36,105,Sullivan County,27890,8426,19464
0500000US36037,36,037,Genesee County,23681,6553,17128
0500000US36071,36,071,Orange County,126776,44947,81829
0500000US37079,37,079,Greene County,7259,2417,4842
0500000US37121,37,121,Mitchell County,6361,1545,4816
0500000US37041,37,041,Chowan County,5984,1711,4273
0500000US37027,37,027,Caldwell County,32594,9939,22655
0500000US37035,37,035,Catawba County,61099,18725,42374
0500000US37049,37,049,Craven County,40871,12535,28336
0500000US37065,37,065,Edgecombe County,21371,6930,14441
0500000US37085,37,085,Harnett County,45086,16772,28314
0500000US37089,37,089,Henderson County,48281,11627,36654
0500000US37095,37,095,Hyde County,1769,699,1070
0500000US37119,37,119,Mecklenburg County,403546,129994,273552
0500000US37131,37,131,Northampton County,8628,2216,6412
0500000US37159,37,159,Rowan County,52301,16008,36293
0500000US37181,37,181,Vance County,16854,5485,11369
0500000US37053,37,053,Currituck County,10148,3299,6849
0500000US37179,37,179,Union County,75165,33341,41824
0500000US37067,37,067,Forsyth County,146685,43928,102757
0500000US37127,37,127,Nash County,36720,11317,25403
0500000US37017,37,017,Bladen County,13968,4106,9862
0500000US37055,37,055,Dare County,15441,3818,11623
0500000US37185,37,185,Warren County,7780,1632,6148
0500000US37195,37,195,Wilson County,32128,10072,22056
0500000US37015,37,015,Bertie County,7976,1889,6087
0500000US37073,37,073,Gates County,4477,1226,3251
0500000US37075,37,075,Graham County,3288,703,2585
0500000US37117,37,117,Martin County,9471,2434,7037
0500000US37115,37,115,Madison County,8452,2141,6311
0500000US37137,37,137,Pamlico County,5352,980,4372
0500000US37143,37,143,Perquimans County,5919,1366,4553
0500000US37149,37,149,Polk County,9047,1826,7221
0500000US37151,37,151,Randolph County,56041,17860,38181
0500000US37157,37,157,Rockingham County,37201,10967,26234
0500000US37169,37,169,Stokes County,19302,5410,13892
0500000US37187,37,187,Washington County,5073,1318,3755
0500000US37029,37,029,Camden County,3836,1313,2523
0500000US37043,37,043,Clay County,5062,1019,4043
0500000US37051,37,051,Cumberland County,124418,41270,83148
0500000US37071,37,071,Gaston County,81494,25620,55874
0500000US37081,37,081,Guilford County,202731,63387,139344
0500000US37099,37,099,Jackson County,16642,3657,12985
0500000US37125,37,125,Moore County,38965,10097,28868
0500000US37155,37,155,Robeson County,45969,15419,30550
0500000US37167,37,167,Stanly County,23717,7509,16208
0500000US37183,37,183,Wake County,390498,141830,248668
0500000US37199,37,199,Yancey County,7402,1855,5547
0500000US37037,37,037,Chatham County,28527,7658,20869
0500000US37111,37,111,McDowell County,17961,5303,12658
0500000US37101,37,101,Johnston County,67154,26781,40373
0500000US37103,37,103,Jones County,4137,1113,3024
0500000US37145,37,145,Person County,15744,4363,11381
0500000US37019,37,019,Brunswick County,54226,10545,43681
0500000US37009,37,009,Ashe County,11805,3039,8766
0500000US37013,37,013,Beaufort County,19325,5056,14269
0500000US37107,37,107,Lenoir County,23121,6940,16181
0500000US37109,37,109,Lincoln County,32022,10859,21163
0500000US37133,37,133,Onslow County,64065,25058,39007
0500000US37135,37,135,Orange County,52529,15513,37016
0500000US37161,37,161,Rutherford County,26345,6889,19456
0500000US37163,37,163,Sampson County,23537,7769,15768
0500000US37197,37,197,Yadkin County,15448,4522,10926
0500000US37011,37,011,Avery County,6587,1303,5284
0500000US37023,37,023,Burke County,34672,10088,24584
0500000US37033,37,033,Caswell County,9110,2572,6538
0500000US37059,37,059,Davie County,15999,4991,11008
0500000US37061,37,061,Duplin County,21781,6893,14888
0500000US37063,37,063,Durham County,123444,35500,87944
0500000US37105,37,105,Lee County,21744,6879,14865
0500000US37129,37,129,New Hanover County,93636,22995,70641
0500000US37191,37,191,Wayne County,48153,16086,32067
0500000US37165,37,165,Scotland County,13113,4310,8803
0500000US37083,37,083,Halifax County,21116,6132,14984
0500000US37001,37,001,Alamance County,64059,19896,44163
0500000US38013,38,013,Burke County,877,239,638
0500000US38061,38,061,Mountrail County,3235,998,2237
0500000US38105,38,105,Williams County,13695,4308,9387
0500000US38007,38,007,Billings County,385,82,303
0500000US38043,38,043,Kidder County,1055,277,778
0500000US38019,38,019,Cavalier County,1737,345,1392
0500000US38037,38,037,Grant County,1094,215,879
0500000US38067,38,067,Pembina County,3180,771,2409
0500000US38091,38,091,Steele County,891,167,724
0500000US38041,38,041,Hettinger County,1079,236,843
0500000US38045,38,045,LaMoure County,1813,406,1407
0500000US38059,38,059,Morton County,13536,3781,9755
0500000US38017,38,017,Cass County,74205,20798,53407
0500000US38025,38,025,Dunn County,1648,462,1186
0500000US38029,38,029,Emmons County,1556,322,1234
0500000US38051,38,051,McIntosh County,1317,268,1049
0500000US38063,38,063,Nelson County,1479,287,1192
0500000US38077,38,077,Richland County,6760,1789,4971
0500000US38079,38,079,Rolette County,4638,1970,2668
0500000US38099,38,099,Walsh County,4841,1301,3540
0500000US38001,38,001,Adams County,1046,270,776
0500000US38009,38,009,Bottineau County,3065,759,2306
0500000US38003,38,003,Barnes County,5085,1103,3982
0500000US38027,38,027,Eddy County,1052,293,759
0500000US38035,38,035,Grand Forks County,30215,7805,22410
0500000US38053,38,053,McKenzie County,3899,1245,2654
0500000US38057,38,057,Mercer County,3702,984,2718
0500000US38055,38,055,McLean County,4333,1061,3272
0500000US38069,38,069,Pierce County,1937,445,1492
0500000US38073,38,073,Ransom County,2367,601,1766
0500000US38085,38,085,Sioux County,1110,562,548
0500000US38011,38,011,Bowman County,1398,397,1001
0500000US38033,38,033,Golden Valley County,856,154,702
0500000US38047,38,047,Logan County,883,173,710
0500000US38095,38,095,Towner County,1036,240,796
0500000US38093,38,093,Stutsman County,9055,2239,6816
0500000US38023,38,023,Divide County,1119,230,889
0500000US38031,38,031,Foster County,1440,308,1132
0500000US38081,38,081,Sargent County,1834,430,1404
0500000US38087,38,087,Slope County,329,74,255
0500000US38089,38,089,Stark County,12150,3464,8686
0500000US39053,39,053,Gallia County,11662,3374,8288
0500000US39077,39,077,Huron County,22860,7080,15780
0500000US39009,39,009,Athens County,22620,5033,17587
0500000US39001,39,001,Adams County,10835,3421,7414
0500000US39103,39,103,Medina County,68121,21439,46682
0500000US39159,39,159,Union County,19546,7481,12065
0500000US39021,39,021,Champaign County,15209,4610,10599
0500000US39125,39,125,Paulding County,7770,2319,5451
0500000US39057,39,057,Greene County,65406,19501,45905
0500000US39049,39,049,Franklin County,504702,154464,350238
0500000US39101,39,101,Marion County,24616,7074,17542
0500000US39115,39,115,Morgan County,6147,1665,4482
0500000US39169,39,169,Wayne County,43385,13331,30054
0500000US39175,39,175,Wyandot County,9076,2715,6361
0500000US39017,39,017,Butler County,138226,46192,92034
0500000US39067,39,067,Harrison County,6200,1748,4452
0500000US39083,39,083,Knox County,23340,7421,15919
0500000US39139,39,139,Richland County,47998,13282,34716
0500000US39163,39,163,Vinton County,5111,1679,3432
0500000US39063,39,063,Hancock County,31887,9472,22415
0500000US39045,39,045,Fairfield County,55748,19988,35760
0500000US39039,39,039,Defiance County,15213,4718,10495
0500000US39069,39,069,Henry County,11065,3446,7619
0500000US39081,39,081,Jefferson County,27363,6762,20601
0500000US39137,39,137,Putnam County,13236,4220,9016
0500000US39027,39,027,Clinton County,16370,5177,11193
0500000US39047,39,047,Fayette County,11736,3723,8013
0500000US39129,39,129,Pickaway County,19728,6862,12866
0500000US39091,39,091,Logan County,18654,5845,12809
0500000US39153,39,153,Summit County,224385,61481,162904
0500000US39143,39,143,Sandusky County,23562,7082,16480
0500000US39149,39,149,Shelby County,18643,6170,12473
0500000US27033,27,033,Cottonwood County,4850,1402,3448
0500000US27139,27,139,Scott County,48510,20288,28222
0500000US27039,27,039,Dodge County,7711,2812,4899
0500000US27157,27,157,Wabasha County,8841,2486,6355
0500000US27117,27,117,Pipestone County,4007,1179,2828
0500000US27035,27,035,Crow Wing County,26684,6979,19705
0500000US27107,27,107,Norman County,2776,706,2070
0500000US27171,27,171,Wright County,47246,18506,28740
0500000US27103,27,103,Nicollet County,12738,3927,8811
0500000US27041,27,041,Douglas County,16395,4193,12202
0500000US27051,27,051,Grant County,2600,700,1900
0500000US27069,27,069,Kittson County,1891,462,1429
0500000US27079,27,079,Le Sueur County,10874,3452,7422
0500000US27087,27,087,Mahnomen County,1938,605,1333
0500000US27025,27,025,Chisago County,20102,6748,13354
0500000US27127,27,127,Redwood County,6240,1672,4568
0500000US27173,27,173,Yellow Medicine County,4165,1242,2923
0500000US27153,27,153,Todd County,9841,2684,7157
0500000US27007,27,007,Beltrami County,17271,5373,11898
0500000US27013,27,013,Blue Earth County,25783,7041,18742
0500000US27055,27,055,Houston County,8181,2267,5914
0500000US27073,27,073,Lac qui Parle County,3103,752,2351
0500000US27077,27,077,Lake of the Woods County,1585,293,1292
0500000US27111,27,111,Otter Tail County,24226,6251,17975
0500000US27161,27,161,Waseca County,7427,2332,5095
0500000US27137,27,137,St. Louis County,85644,20645,64999
0500000US27003,27,003,Anoka County,126848,44144,82704
0500000US27145,27,145,Stearns County,58891,18273,40618
0500000US27081,27,081,Lincoln County,2470,646,1824
0500000US27089,27,089,Marshall County,3964,1018,2946
0500000US27095,27,095,Mille Lacs County,10136,3245,6891
0500000US27163,27,163,Washington County,93184,33196,59988
0500000US27017,27,017,Carlton County,13418,4225,9193
0500000US27065,27,065,Kanabec County,6449,1733,4716
0500000US27071,27,071,Koochiching County,5566,1172,4394
0500000US27097,27,097,Morrison County,13488,4034,9454
0500000US27131,27,131,Rice County,23045,7223,15822
0500000US27147,27,147,Steele County,14498,4472,10026
0500000US27125,27,125,Red Lake County,1691,471,1220
0500000US27001,27,001,Aitkin County,7713,1554,6159
0500000US27043,27,043,Faribault County,6115,1545,4570
0500000US27101,27,101,Murray County,3702,868,2834
0500000US27067,27,067,Kandiyohi County,16699,5135,11564
0500000US27075,27,075,Lake County,5183,1142,4041
0500000US27133,27,133,Rock County,3978,1329,2649
0500000US27143,27,143,Sibley County,6038,1810,4228
0500000US27155,27,155,Traverse County,1584,442,1142
0500000US27005,27,005,Becker County,13487,3873,9614
0500000US27053,27,053,Hennepin County,503476,141646,361830
0500000US27015,27,015,Brown County,10731,2971,7760
0500000US27023,27,023,Chippewa County,5098,1368,3730
0500000US27029,27,029,Clearwater County,3458,945,2513
0500000US27057,27,057,Hubbard County,8705,2211,6494
0500000US27059,27,059,Isanti County,14702,4635,10067
0500000US27091,27,091,Martin County,8653,2121,6532
0500000US27099,27,099,Mower County,15502,4863,10639
0500000US27115,27,115,Pine County,10690,2666,8024
0500000US27109,27,109,Olmsted County,60770,20342,40428
0500000US27159,27,159,Wadena County,5677,1693,3984
0500000US27009,27,009,Benton County,16217,5102,11115
0500000US27047,27,047,Freeborn County,12970,3469,9501
0500000US27085,27,085,McLeod County,14884,4461,10423
0500000US27121,27,121,Pope County,4972,1172,3800
0500000US27149,27,149,Stevens County,3629,894,2735
0500000US27151,27,151,Swift County,4227,1201,3026
0500000US28051,28,051,Holmes County,6269,2292,3977
0500000US28005,28,005,Amite County,5003,1321,3682
0500000US28013,28,013,Calhoun County,5797,1852,3945
0500000US28141,28,141,Tishomingo County,7635,2033,5602
0500000US28153,28,153,Wayne County,7734,2665,5069
0500000US48015,48,015,Austin County,11041,3607,7434
0500000US48261,48,261,Kenedy County,209,67,142
0500000US48355,48,355,Nueces County,128926,44225,84701
0500000US48089,48,089,Colorado County,7511,2102,5409
0500000US48409,48,409,San Patricio County,23121,9077,14044
0500000US48379,48,379,Rains County,4331,1222,3109
0500000US48381,48,381,Randall County,49187,16550,32637
0500000US48385,48,385,Real County,1227,220,1007
0500000US48411,48,411,San Saba County,2104,607,1497
0500000US48413,48,413,Schleicher County,1105,333,772
0500000US48431,48,431,Sterling County,462,148,314
0500000US48507,48,507,Zavala County,3509,1361,2148
0500000US48057,48,057,Calhoun County,7604,2687,4917
0500000US48065,48,065,Carson County,2247,792,1455
0500000US48155,48,155,Foard County,557,138,419
0500000US48161,48,161,Freestone County,6865,2153,4712
0500000US48175,48,175,Goliad County,2681,713,1968
0500000US48193,48,193,Hamilton County,3108,831,2277
0500000US48197,48,197,Hardeman County,1519,431,1088
0500000US48335,48,335,Mitchell County,2441,732,1709
0500000US48045,48,045,Briscoe County,632,188,444
0500000US48285,48,285,Lavaca County,7756,2480,5276
0500000US48445,48,445,Terry County,4041,1523,2518
0500000US48243,48,243,Jeff Davis County,1050,142,908
0500000US48247,48,247,Jim Hogg County,1710,615,1095
0500000US48339,48,339,Montgomery County,192823,75263,117560
0500000US48111,48,111,Dallam County,2404,857,1547
0500000US48479,48,479,Webb County,73659,38549,35110
0500000US48011,48,011,Armstrong County,708,250,458
0500000US48069,48,069,Castro County,2532,896,1636
0500000US48273,48,273,Kleberg County,10946,3517,7429
0500000US48489,48,489,Willacy County,5810,2356,3454
0500000US48107,48,107,Crosby County,2044,705,1339
0500000US48151,48,151,Fisher County,1649,451,1198
0500000US48131,48,131,Duval County,3511,1359,2152
0500000US48031,48,031,Blanco County,4297,1095,3202
0500000US48241,48,241,Jasper County,12583,3596,8987
0500000US48271,48,271,Kinney County,1170,175,995
0500000US48117,48,117,Deaf Smith County,6139,2386,3753
0500000US48167,48,167,Galveston County,119181,41759,77422
0500000US48283,48,283,La Salle County,2216,767,1449
0500000US48393,48,393,Roberts County,311,106,205
0500000US48457,48,457,Tyler County,7020,1925,5095
0500000US48483,48,483,Wheeler County,2254,831,1423
0500000US48037,48,037,Bowie County,33731,10985,22746
0500000US48043,48,043,Brewster County,3942,1050,2892
0500000US48263,48,263,Kent County,318,76,242
0500000US48423,48,423,Smith County,77195,24898,52297
0500000US48105,48,105,Crockett County,1388,526,862
0500000US48199,48,199,Hardin County,20385,6971,13414
0500000US48227,48,227,Howard County,11036,3873,7163
0500000US48289,48,289,Leon County,6249,1593,4656
0500000US48337,48,337,Montague County,7995,2461,5534
0500000US48365,48,365,Panola County,8827,2944,5883
0500000US49027,49,027,Millard County,4306,1806,2500
0500000US49053,49,053,Washington County,54702,18806,35896
0500000US49025,49,025,Kane County,2634,533,2101
0500000US49019,49,019,Grand County,4006,1319,2687
0500000US49033,49,033,Rich County,620,190,430
0500000US49051,49,051,Wasatch County,9567,4181,5386
0500000US49003,49,003,Box Elder County,17302,7448,9854
0500000US49021,49,021,Iron County,16204,5949,10255
0500000US49041,49,041,Sevier County,7261,2689,4572
0500000US49057,49,057,Weber County,82417,32660,49757
0500000US49013,49,013,Duchesne County,6644,3000,3644
0500000US49037,49,037,San Juan County,3992,1584,2408
0500000US49035,49,035,Salt Lake County,369429,141723,227706
0500000US49047,49,047,Uintah County,10625,4427,6198
0500000US49009,49,009,Daggett County,145,32,113
0500000US49011,49,011,Davis County,102865,48068,54797
0500000US49055,49,055,Wayne County,1021,282,739
0500000US49007,49,007,Carbon County,7844,2529,5315
0500000US49015,49,015,Emery County,3589,1310,2279
0500000US49029,49,029,Morgan County,3306,1666,1640
0500000US49005,49,005,Cache County,37645,15340,22305
0500000US49017,49,017,Garfield County,1741,464,1277
0500000US49023,49,023,Juab County,3390,1595,1795
0500000US50021,50,021,Rutland County,25145,5131,20014
0500000US50019,50,019,Orleans County,11679,3091,8588
0500000US50013,50,013,Grand Isle County,2967,697,2270
0500000US50017,50,017,Orange County,12286,3304,8982
0500000US50007,50,007,Chittenden County,65400,16858,48542
0500000US50015,50,015,Lamoille County,10607,2900,7707
0500000US50027,50,027,Windsor County,24310,6064,18246
0500000US50005,50,005,Caledonia County,12214,3069,9145
0500000US50025,50,025,Windham County,19118,4681,14437
0500000US50001,50,001,Addison County,14733,3910,10823
0500000US50023,50,023,Washington County,24865,6654,18211
0500000US51185,51,185,Tazewell County,17042,4462,12580
0500000US51610,51,610,Falls Church city,5262,1870,3392
0500000US51685,51,685,Manassas Park city,4706,2059,2647
0500000US51735,51,735,Poquoson city,4615,1589,3026
0500000US51183,51,183,Sussex County,3814,1112,2702
0500000US51820,51,820,Waynesboro city,9144,2605,6539
0500000US51770,51,770,Roanoke city,42037,11323,30714
0500000US51775,51,775,Salem city,9881,2756,7125
0500000US51710,51,710,Norfolk city,88155,26646,61509
0500000US51037,51,037,Charlotte County,4543,974,3569
0500000US51059,51,059,Fairfax County,394447,144313,250134
0500000US51081,51,081,Greensville County,3688,1003,2685
0500000US51095,51,095,James City County,28766,7756,21010
0500000US51167,51,167,Russell County,10965,2553,8412
0500000US51173,51,173,Smyth County,12881,3899,8982
0500000US51678,51,678,Lexington city,1984,393,1591
0500000US51031,51,031,Campbell County,22957,6531,16426
0500000US51089,51,089,Henry County,21598,5186,16412
0500000US51099,51,099,King George County,9103,3530,5573
0500000US51103,51,103,Lancaster County,5142,823,4319
0500000US51105,51,105,Lee County,9149,2534,6615
0500000US51115,51,115,Mathews County,3908,739,3169
0500000US51119,51,119,Middlesex County,4454,812,3642
0500000US51149,51,149,Prince George County,11415,3892,7523
0500000US51165,51,165,Rockingham County,30946,9278,21668
0500000US51169,51,169,Scott County,8767,2110,6657
0500000US51181,51,181,Surry County,2760,738,2022
0500000US51011,51,011,Appomattox County,6095,2058,4037
0500000US51067,51,067,Franklin County,23104,6060,17044
0500000US51097,51,097,King and Queen County,2826,680,2146
0500000US51121,51,121,Montgomery County,35483,8379,27104
0500000US51127,51,127,New Kent County,7754,2522,5232
0500000US51049,51,049,Cumberland County,3963,1080,2883
0500000US51075,51,075,Goochland County,8426,2288,6138
0500000US51083,51,083,Halifax County,14025,3639,10386
0500000US51113,51,113,Madison County,5078,1292,3786
0500000US51153,51,153,Prince William County,140473,62914,77559
0500000US51175,51,175,Southampton County,6522,2219,4303
0500000US51091,51,091,Highland County,1123,195,928
0500000US51025,51,025,Brunswick County,6048,1522,4526
0500000US51033,51,033,Caroline County,10911,3710,7201
0500000US51073,51,073,Gloucester County,14759,3874,10885
0500000US51131,51,131,Northampton County,5151,1219,3932
0500000US51141,51,141,Patrick County,7685,1912,5773
0500000US51145,51,145,Powhatan County,10178,3207,6971
0500000US51163,51,163,Rockbridge County,8979,2421,6558
0500000US51171,51,171,Shenandoah County,17315,4722,12593
0500000US51061,51,061,Fauquier County,24333,8509,15824
0500000US51036,51,036,Charles City County,2856,557,2299
0500000US51047,51,047,Culpeper County,16903,6459,10444
0500000US51053,51,053,Dinwiddie County,10391,3106,7285
0500000US51079,51,079,Greene County,7357,2295,5062
0500000US51085,51,085,Hanover County,38599,12883,25716
0500000US51111,51,111,Lunenburg County,4331,1091,3240
0500000US51137,51,137,Orange County,13453,4513,8940
0500000US51595,51,595,Emporia city,2119,699,1420
0500000US51197,51,197,Wythe County,11955,3091,8864
0500000US51550,51,550,Chesapeake city,84230,31818,52412
0500000US51660,51,660,Harrisonburg city,16768,4754,12014
0500000US51003,51,003,Albemarle County,40612,11476,29136
0500000US51019,51,019,Bedford County,31206,8545,22661
0500000US51023,51,023,Botetourt County,13161,3778,9383
0500000US51195,51,195,Wise County,15126,4605,10521
0500000US51520,51,520,Bristol city,7402,1941,5461
0500000US51740,51,740,Portsmouth city,36471,10900,25571
0500000US51830,51,830,Williamsburg city,4670,890,3780
0500000US51005,51,005,Alleghany County,6741,1708,5033
0500000US51035,51,035,Carroll County,12375,3027,9348
0500000US51191,51,191,Washington County,22331,5830,16501
0500000US51133,51,133,Northumberland County,5686,1271,4415
0500000US51139,51,139,Page County,9338,2377,6961
0500000US51187,51,187,Warren County,14379,4585,9794
0500000US51510,51,510,Alexandria city,69979,15659,54320
0500000US51630,51,630,Fredericksburg city,10582,2809,7773
0500000US51650,51,650,Hampton city,53700,15128,38572
0500000US51013,51,013,Arlington County,104716,23638,81078
0500000US51670,51,670,Hopewell city,9193,2982,6211
0500000US51027,51,027,Buchanan County,8871,2112,6759
0500000US51069,51,069,Frederick County,30973,10282,20691
0500000US51179,51,179,Stafford County,46328,20388,25940
0500000US51199,51,199,York County,24617,9409,15208
0500000US51760,51,760,Richmond city,89846,19205,70641
0500000US51125,51,125,Nelson County,6445,1773,4672
0500000US51143,51,143,Pittsylvania County,26330,7656,18674
0500000US51720,51,720,Norton city,1819,617,1202
0500000US51065,51,065,Fluvanna County,9842,3172,6670
0500000US51007,51,007,Amelia County,4789,1334,3455
0500000US51840,51,840,Winchester city,10554,3178,7376
0500000US51001,51,001,Accomack County,13401,3430,9971
0500000US51063,51,063,Floyd County,6480,1816,4664
0500000US51077,51,077,Grayson County,6542,1419,5123
0500000US51135,51,135,Nottoway County,5542,1890,3652
0500000US54033,54,033,Harrison County,27436,8127,19309
0500000US54069,54,069,Ohio County,17351,4121,13230
0500000US54013,54,013,Calhoun County,2864,799,2065
0500000US54065,54,065,Morgan County,7166,1717,5449
0500000US54081,54,081,Raleigh County,31119,9674,21445
0500000US54007,54,007,Braxton County,5491,1519,3972
0500000US54001,54,001,Barbour County,6416,1701,4715
0500000US54047,54,047,McDowell County,7711,2193,5518
0500000US54099,54,099,Wayne County,15799,4038,11761
0500000US54109,54,109,Wyoming County,8823,2642,6181
0500000US54035,54,035,Jackson County,11178,2974,8204
0500000US54055,54,055,Mercer County,24882,7052,17830
0500000US54097,54,097,Upshur County,9378,2536,6842
0500000US54101,54,101,Webster County,3811,1131,2680
0500000US54003,54,003,Berkeley County,43237,14706,28531
0500000US54019,54,019,Fayette County,17795,4826,12969
0500000US54023,54,023,Grant County,4556,974,3582
0500000US54027,54,027,Hampshire County,9663,2157,7506
0500000US54089,54,089,Summers County,5489,1479,4010
0500000US54009,54,009,Brooke County,9957,2422,7535
0500000US54017,54,017,Doddridge County,2647,464,2183
0500000US54025,54,025,Greenbrier County,15285,3739,11546
0500000US54031,54,031,Hardy County,5521,1572,3949
0500000US54049,54,049,Marion County,22942,6365,16577
0500000US54057,54,057,Mineral County,11184,2731,8453
0500000US54059,54,059,Mingo County,10772,3443,7329
0500000US54029,54,029,Hancock County,12697,3097,9600
0500000US54041,54,041,Lewis County,6577,1900,4677
0500000US54067,54,067,Nicholas County,10472,2674,7798
0500000US54075,54,075,Pocahontas County,3579,721,2858
0500000US54095,54,095,Tyler County,3298,720,2578
0500000US54083,54,083,Randolph County,11254,2766,8488
0500000US54091,54,091,Taylor County,6661,1774,4887
0500000US54105,54,105,Wirt County,2499,682,1817
0500000US54015,54,015,Clay County,3261,900,2361
0500000US54021,54,021,Gilmer County,2670,554,2116
0500000US54061,54,061,Monongalia County,38856,9110,29746
0500000US54063,54,063,Monroe County,5744,1417,4327
0500000US54103,54,103,Wetzel County,5891,1345,4546
0500000US54011,54,011,Cabell County,39628,9988,29640
0500000US54039,54,039,Kanawha County,79437,21589,57848
0500000US54071,54,071,Pendleton County,3154,714,2440
0500000US54077,54,077,Preston County,12383,3327,9056
0500000US53035,53,035,Kitsap County,101662,30552,71110
0500000US53033,53,033,King County,865627,250695,614932
0500000US53051,53,051,Pend Oreille County,5782,1638,4144
0500000US53055,53,055,San Juan County,8025,1466,6559
0500000US53075,53,075,Whitman County,17910,3774,14136
0500000US53077,53,077,Yakima County,82300,33519,48781
0500000US53015,53,015,Cowlitz County,41397,12519,28878
0500000US53019,53,019,Ferry County,3097,790,2307
0500000US53041,53,041,Lewis County,30262,8627,21635
0500000US53027,53,027,Grays Harbor County,28263,7611,20652
0500000US53029,53,029,Island County,34364,8843,25521
0500000US53069,53,069,Wahkiakum County,1844,420,1424
0500000US53021,53,021,Franklin County,26316,12697,13619
0500000US53025,53,025,Grant County,30651,11642,19009
0500000US53073,53,073,Whatcom County,85008,22461,62547
0500000US53047,53,047,Okanogan County,17527,5469,12058
0500000US53037,53,037,Kittitas County,18003,4166,13837
0500000US53005,53,005,Benton County,70983,23697,47286
0500000US53013,53,013,Columbia County,1758,339,1419
0500000US53003,53,003,Asotin County,9171,2348,6823
0500000US53023,53,023,Garfield County,997,262,735
0500000US53045,53,045,Mason County,23535,5924,17611
0500000US53065,53,065,Stevens County,17433,4439,12994
0500000US53063,53,063,Spokane County,198489,60112,138377
0500000US53007,53,007,Chelan County,28038,7951,20087
0500000US55105,55,105,Rock County,64538,19949,44589
0500000US55137,55,137,Waushara County,9869,2219,7650
0500000US55001,55,001,Adams County,8619,1580,7039
0500000US55007,55,007,Bayfield County,6963,1485,5478
0500000US55065,55,065,Lafayette County,6679,1969,4710
0500000US55081,55,081,Monroe County,17772,5663,12109
0500000US55093,55,093,Pierce County,15367,4529,10838
0500000US55141,55,141,Wood County,32245,8041,24204
0500000US55003,55,003,Ashland County,6546,1654,4892
0500000US55015,55,015,Calumet County,19567,6809,12758
0500000US55037,55,037,Florence County,2010,397,1613
0500000US55055,55,055,Jefferson County,32866,9998,22868
0500000US55059,55,059,Kenosha County,63423,20535,42888
0500000US55051,55,051,Iron County,3003,607,2396
0500000US55019,55,019,Clark County,12800,4180,8620
0500000US55109,55,109,St. Croix County,33674,11986,21688
0500000US55083,55,083,Oconto County,15940,4279,11661
0500000US55069,55,069,Lincoln County,12547,2992,9555
0500000US55135,55,135,Waupaca County,22024,5927,16097
0500000US55005,55,005,Barron County,19108,5261,13847
0500000US55113,55,113,Sawyer County,7634,1889,5745
0500000US55047,55,047,Green Lake County,7935,2032,5903
0500000US55077,55,077,Marquette County,6516,1429,5087
0500000US55075,55,075,Marinette County,18631,4259,14372
0500000US55101,55,101,Racine County,76384,24949,51435
0500000US55139,55,139,Winnebago County,70173,19105,51068
0500000US55041,55,041,Forest County,4029,998,3031
0500000US55043,55,043,Grant County,19401,5160,14241
0500000US55107,55,107,Rusk County,6382,1597,4785
0500000US55117,55,117,Sheboygan County,47303,13840,33463
0500000US55067,55,067,Langlade County,8594,2028,6566
0500000US55087,55,087,Outagamie County,72947,23091,49856
0500000US55123,55,123,Vernon County,12080,3427,8653
0500000US55021,55,021,Columbia County,23790,7242,16548
0500000US55061,55,061,Kewaunee County,8238,2328,5910
0500000US55009,55,009,Brown County,104133,33062,71071
0500000US55073,55,073,Marathon County,55377,15676,39701
0500000US55085,55,085,Oneida County,15403,2915,12488
0500000US55121,55,121,Trempealeau County,11936,3477,8459
0500000US55129,55,129,Washburn County,7062,1583,5479
0500000US55027,55,027,Dodge County,34605,9857,24748
0500000US55127,55,127,Walworth County,40372,11746,28626
0500000US55023,55,023,Crawford County,6618,1611,5007
0500000US55071,55,071,Manitowoc County,34463,9153,25310
0500000US55111,55,111,Sauk County,26178,7651,18527
0500000US55013,55,013,Burnett County,7303,1682,5621
0500000US55017,55,017,Chippewa County,25485,7630,17855
0500000US55029,55,029,Door County,13196,3027,10169
0500000US55031,55,031,Douglas County,18920,4932,13988
0500000US55053,55,053,Jackson County,8083,2384,5699
0500000US55049,55,049,Iowa County,9835,2940,6895
0500000US55089,55,089,Ozaukee County,35625,10570,25055
0500000US55103,55,103,Richland County,7626,2034,5592
0500000US56005,56,005,Campbell County,17488,6298,11190
0500000US56019,56,019,Johnson County,3828,963,2865
0500000US56025,56,025,Natrona County,32851,9722,23129
0500000US56009,56,009,Converse County,5429,1594,3835
0500000US56027,56,027,Niobrara County,978,260,718
0500000US56039,56,039,Teton County,9158,2365,6793
0500000US56037,56,037,Sweetwater County,15871,5986,9885
0500000US56031,56,031,Platte County,3936,958,2978
0500000US56033,56,033,Sheridan County,13159,3418,9741
0500000US56003,56,003,Big Horn County,4494,1284,3210
0500000US56011,56,011,Crook County,2924,744,2180
0500000US56029,56,029,Park County,11977,3321,8656
0500000US56001,56,001,Albany County,16027,3311,12716
0500000US56007,56,007,Carbon County,6341,1921,4420
0500000US56015,56,015,Goshen County,5209,1542,3667
0500000US56041,56,041,Uinta County,7735,2884,4851
0500000US56043,56,043,Washakie County,3422,958,2464
0500000US56017,56,017,Hot Springs County,2209,441,1768
0500000US56013,56,013,Fremont County,15003,4880,10123
0500000US56035,56,035,Sublette County,3275,807,2468
0500000US56045,56,045,Weston County,3062,782,2280
0500000US01099,01,099,Monroe County,8149,1972,6177
0500000US01079,01,079,Lawrence County,12811,3940,8871
0500000US01081,01,081,Lee County,59373,19311,40062
0500000US01107,01,107,Pickens County,7530,2140,5390
0500000US01119,01,119,Sumter County,5047,1098,3949
0500000US01023,01,023,Choctaw County,5350,1473,3877
0500000US01091,01,091,Marengo County,7768,1816,5952
0500000US01113,01,113,Russell County,22740,7306,15434
0500000US01039,01,039,Covington County,15008,4364,10644
0500000US01041,01,041,Crenshaw County,5025,1481,3544
0500000US01077,01,077,Lauderdale County,38514,10863,27651
0500000US01085,01,085,Lowndes County,4180,1293,2887
0500000US01083,01,083,Limestone County,32126,10425,21701
0500000US01115,01,115,St. Clair County,32172,10184,21988
0500000US01133,01,133,Winston County,9403,2573,6830
0500000US01043,01,043,Cullman County,30730,9278,21452
0500000US01051,01,051,Elmore County,29143,9566,19577
0500000US01071,01,071,Jackson County,20626,6110,14516
0500000US01121,01,121,Talladega County,31407,9475,21932
0500000US01129,01,129,Washington County,6007,1698,4309
0500000US01031,01,031,Coffee County,19789,6585,13204
0500000US01103,01,103,Morgan County,45646,14172,31474
0500000US01021,01,021,Chilton County,16751,5537,11214
0500000US01033,01,033,Colbert County,21799,6048,15751
0500000US01045,01,045,Dale County,18670,5572,13098
0500000US01055,01,055,Etowah County,38777,11516,27261
0500000US01049,01,049,DeKalb County,26132,9066,17066
0500000US01075,01,075,Lamar County,5974,1640,4334
0500000US01111,01,111,Randolph County,8643,2395,6248
0500000US01097,01,097,Mobile County,155831,48203,107628
0500000US01127,01,127,Walker County,25036,7438,17598
0500000US01029,01,029,Cleburne County,5726,1688,4038
0500000US01063,01,063,Greene County,2955,594,2361
0500000US01005,01,005,Barbour County,9186,2908,6278
0500000US01011,01,011,Bullock County,3609,1292,2317
0500000US01015,01,015,Calhoun County,45033,14099,30934
0500000US01025,01,025,Clarke County,9358,2376,6982
0500000US01101,01,101,Montgomery County,89835,28284,61551
0500000US01095,01,095,Marshall County,34896,11305,23591
0500000US01067,01,067,Henry County,6669,1801,4868
0500000US01089,01,089,Madison County,145256,44029,101227
0500000US01123,01,123,Tallapoosa County,16448,4551,11897
0500000US01131,01,131,Wilcox County,3804,826,2978
0500000US02068,02,068,Denali Borough,639,111,528
0500000US02122,02,122,Kenai Peninsula Borough,21741,6146,15595
0500000US02016,02,016,Aleutians West Census Area,1176,443,733
0500000US02060,02,060,Bristol Bay Borough,333,101,232
0500000US02150,02,150,Kodiak Island Borough,4373,1664,2709
0500000US02188,02,188,Northwest Arctic Borough,1860,1091,769
0500000US02050,02,050,Bethel Census Area,4558,2472,2086
0500000US02185,02,185,North Slope Borough,1966,1008,958
0500000US02220,02,220,Sitka City and Borough,3561,1021,2540
0500000US02090,02,090,Fairbanks North Star Borough,36513,12633,23880
0500000US02130,02,130,Ketchikan Gateway Borough,5327,1696,3631
0500000US02170,02,170,Matanuska-Susitna Borough,30879,11131,19748
0500000US02180,02,180,Nome Census Area,2875,1602,1273
0500000US02070,02,070,Dillingham Census Area,1420,683,737
0500000US02100,02,100,Haines Borough,1026,269,757
0500000US02282,02,282,Yakutat City and Borough,232,71,161
0500000US02110,02,110,Juneau City and Borough,12521,3774,8747
0500000US02164,02,164,Lake and Peninsula Borough,425,160,265
0500000US02240,02,240,Southeast Fairbanks Census Area,2163,719,1444
0500000US02290,02,290,Yukon-Koyukuk Census Area,1906,675,1231
0500000US02020,02,020,Anchorage Municipality,106524,37197,69327
0500000US02013,02,013,Aleutians East Borough,860,301,559
0500000US02230,02,230,Skagway Municipality,400,94,306
0500000US02198,02,198,Prince of Wales-Hyder Census Area,2356,730,1626
0500000US02195,02,195,Petersburg Borough,1170,308,862
0500000US02158,02,158,Kusilvak Census Area,1692,1186,506
0500000US04013,04,013,Maricopa County,1520767,497651,1023116
0500000US04009,04,009,Graham County,10782,4201,6581
0500000US04023,04,023,Santa Cruz County,15430,6113,9317
0500000US04012,04,012,La Paz County,8912,1637,7275
0500000US04015,04,015,Mohave County,85485,18411,67074
0500000US04005,04,005,Coconino County,47276,13139,34137
0500000US04027,04,027,Yuma County,72463,28416,44047
0500000US04011,04,011,Greenlee County,3225,1219,2006
0500000US04021,04,021,Pinal County,137286,42588,94698
0500000US05123,05,123,St. Francis County,9319,2652,6667
0500000US05145,05,145,White County,29263,10072,19191
0500000US05099,05,099,Nevada County,3303,998,2305
0500000US05037,05,037,Cross County,6694,2333,4361
0500000US05043,05,043,Drew County,7018,2015,5003
0500000US05027,05,027,Columbia County,8962,2820,6142
0500000US05125,05,125,Saline County,43604,14809,28795
0500000US05141,05,141,Van Buren County,6852,1705,5147
0500000US05065,05,065,Izard County,5049,1154,3895
0500000US05079,05,079,Lincoln County,3795,1241,2554
0500000US05083,05,083,Logan County,8464,2983,5481
0500000US05035,05,035,Crittenden County,18756,6459,12297
0500000US05047,05,047,Franklin County,6800,1983,4817
0500000US05109,05,109,Pike County,4299,1336,2963
0500000US05069,05,069,Jefferson County,26977,7420,19557
0500000US05097,05,097,Montgomery County,3761,868,2893
0500000US05127,05,127,Scott County,3855,1032,2823
0500000US05131,05,131,Sebastian County,50670,16129,34541
0500000US05007,05,007,Benton County,94333,36335,57998
0500000US05017,05,017,Chicot County,4308,1387,2921
0500000US05071,05,071,Johnson County,9800,3224,6576
0500000US05077,05,077,Lee County,3352,847,2505
0500000US05041,05,041,Desha County,5111,1731,3380
0500000US05049,05,049,Fulton County,5000,1279,3721
0500000US05051,05,051,Garland County,39894,10341,29553
0500000US05115,05,115,Pope County,22628,7072,15556
0500000US05117,05,117,Prairie County,3826,1009,2817
0500000US39161,39,161,Van Wert County,11419,3541,7878
0500000US39167,39,167,Washington County,25139,6728,18411
0500000US39171,39,171,Williams County,15246,4425,10821
0500000US39011,39,011,Auglaize County,18723,5988,12735
0500000US39029,39,029,Columbiana County,41854,11923,29931
0500000US39037,39,037,Darke County,20838,6327,14511
0500000US39123,39,123,Ottawa County,17691,4423,13268
0500000US39051,39,051,Fulton County,16425,5482,10943
0500000US39065,39,065,Hardin County,11495,3490,8005
0500000US39079,39,079,Jackson County,12892,4434,8458
0500000US39095,39,095,Lucas County,179065,53822,125243
0500000US39117,39,117,Morrow County,12650,4177,8473
0500000US39121,39,121,Noble County,4967,835,4132
0500000US39135,39,135,Preble County,16090,5121,10969
0500000US39147,39,147,Seneca County,21652,6346,15306
0500000US39151,39,151,Stark County,152649,43899,108750
0500000US39003,39,003,Allen County,40537,12602,27935
0500000US39031,39,031,Coshocton County,14461,4173,10288
0500000US39033,39,033,Crawford County,17755,4945,12810
0500000US39041,39,041,Delaware County,68649,28463,40186
0500000US39059,39,059,Guernsey County,16098,4452,11646
0500000US39073,39,073,Hocking County,11120,3380,7740
0500000US39107,39,107,Mercer County,16104,4864,11240
0500000US39141,39,141,Ross County,28747,9224,19523
0500000US39035,39,035,Cuyahoga County,538531,140177,398354
0500000US39093,39,093,Lorain County,119536,36226,83310
0500000US39109,39,109,Miami County,41081,11640,29441
0500000US39113,39,113,Montgomery County,223894,65199,158695
0500000US39155,39,155,Trumbull County,86163,22658,63505
0500000US39173,39,173,Wood County,50443,14359,36084
0500000US39007,39,007,Ashtabula County,37652,10402,27250
0500000US40001,40,001,Adair County,7742,2679,5063
0500000US40137,40,137,Stephens County,16955,5218,11737
0500000US40025,40,025,Cimarron County,974,272,702
0500000US40019,40,019,Carter County,18336,5822,12514
0500000US40053,40,053,Grant County,1825,477,1348
0500000US40055,40,055,Greer County,2041,726,1315
0500000US40087,40,087,McClain County,14159,5366,8793
0500000US40091,40,091,McIntosh County,8413,2307,6106
0500000US40099,40,099,Murray County,5354,1566,3788
0500000US40103,40,103,Noble County,4607,1531,3076
0500000US40115,40,115,Ottawa County,11965,3966,7999
0500000US40135,40,135,Sequoyah County,15376,5273,10103
0500000US40145,40,145,Wagoner County,28748,10315,18433
0500000US40151,40,151,Woods County,3351,1066,2285
0500000US40015,40,015,Caddo County,10199,3409,6790
0500000US40101,40,101,Muskogee County,26078,8848,17230
0500000US40107,40,107,Okfuskee County,3962,1275,2687
0500000US40013,40,013,Bryan County,17157,5340,11817
0500000US40059,40,059,Harper County,1297,374,923
0500000US40071,40,071,Kay County,17703,5204,12499
0500000US40035,40,035,Craig County,5433,1706,3727
0500000US40143,40,143,Tulsa County,251176,82125,169051
0500000US40017,40,017,Canadian County,44633,17066,27567
0500000US40057,40,057,Harmon County,1183,436,747
0500000US40077,40,077,Latimer County,4042,1263,2779
0500000US40113,40,113,Osage County,18165,5335,12830
0500000US40139,40,139,Texas County,6725,2326,4399
0500000US40127,40,127,Pushmataha County,4463,1260,3203
0500000US40047,40,047,Garfield County,23824,7630,16194
0500000US40069,40,069,Johnston County,4300,1296,3004
0500000US40121,40,121,Pittsburg County,17745,5628,12117
0500000US40129,40,129,Roger Mills County,1352,345,1007
0500000US40153,40,153,Woodward County,7255,2611,4644
0500000US40021,40,021,Cherokee County,16507,4946,11561
0500000US40041,40,041,Delaware County,16574,4323,12251
0500000US40045,40,045,Ellis County,1607,406,1201
0500000US40051,40,051,Grady County,19836,6948,12888
0500000US40119,40,119,Payne County,30485,7571,22914
0500000US40125,40,125,Pottawatomie County,26003,8778,17225
0500000US40037,40,037,Creek County,26642,8812,17830
0500000US40141,40,141,Tillman County,2954,922,2032
0500000US40149,40,149,Washita County,4363,1433,2930
0500000US40033,40,033,Cotton County,2212,751,1461
0500000US40075,40,075,Kiowa County,3772,1086,2686
0500000US40079,40,079,Le Flore County,18367,6230,12137
0500000US40089,40,089,McCurtain County,12791,4512,8279
0500000US40093,40,093,Major County,3050,919,2131
0500000US40097,40,097,Mayes County,15838,5416,10422
0500000US40109,40,109,Oklahoma County,299232,96332,202900
0500000US40039,40,039,Custer County,10505,3725,6780
0500000US40007,40,007,Beaver County,2027,670,1357
0500000US40085,40,085,Love County,3193,1001,2192
0500000US40009,40,009,Beckham County,7562,2678,4884
0500000US40023,40,023,Choctaw County,5991,1790,4201
0500000US40065,40,065,Jackson County,9868,3229,6639
0500000US40081,40,081,Lincoln County,12821,3892,8929
0500000US41047,41,047,Marion County,116861,39027,77834
0500000US41029,41,029,Jackson County,87417,24161,63256
0500000US41023,41,023,Grant County,3294,628,2666
0500000US41031,41,031,Jefferson County,7892,2191,5701
0500000US41005,41,005,Clackamas County,155456,48538,106918
0500000US41043,41,043,Linn County,47030,14063,32967
0500000US41057,41,057,Tillamook County,10816,2527,8289
0500000US41001,41,001,Baker County,6927,1708,5219
0500000US41033,41,033,Josephine County,35978,8770,27208
0500000US41059,41,059,Umatilla County,26886,9518,17368
0500000US41041,41,041,Lincoln County,21110,4073,17037
0500000US41009,41,009,Columbia County,19296,5732,13564
0500000US41055,41,055,Sherman County,736,141,595
0500000US41065,41,065,Wasco County,10266,2970,7296
0500000US41039,41,039,Lane County,150780,38090,112690
0500000US41045,41,045,Malheur County,10138,3334,6804
0500000US41067,41,067,Washington County,216507,73982,142525
0500000US41049,41,049,Morrow County,3959,1523,2436
0500000US41007,41,007,Clatsop County,15910,3885,12025
0500000US41015,41,015,Curry County,10440,1691,8749
0500000US41021,41,021,Gilliam County,848,215,633
0500000US41037,41,037,Lake County,3494,824,2670
0500000US41061,41,061,Union County,10481,3146,7335
0500000US42045,42,045,Delaware County,206405,67227,139178
0500000US42119,42,119,Union County,14739,4236,10503
0500000US42127,42,127,Wayne County,18739,4735,14004
0500000US42043,42,043,Dauphin County,111684,32726,78958
0500000US42053,42,053,Forest County,1631,160,1471
0500000US42089,42,089,Monroe County,56770,17282,39488
0500000US42101,42,101,Philadelphia County,594778,161687,433091
0500000US42129,42,129,Westmoreland County,151665,37673,113992
0500000US42013,42,013,Blair County,51625,14049,37576
0500000US42021,42,021,Cambria County,56793,14328,42465
0500000US42011,42,011,Berks County,154467,49069,105398
0500000US42061,42,061,Huntingdon County,16808,4909,11899
0500000US42073,42,073,Lawrence County,36907,10126,26781
0500000US42087,42,087,Mifflin County,19094,5239,13855
0500000US42041,42,041,Cumberland County,98877,27057,71820
0500000US42003,42,003,Allegheny County,537960,128980,408980
0500000US42109,42,109,Snyder County,14716,4378,10338
0500000US42115,42,115,Susquehanna County,17347,4349,12998
0500000US42039,42,039,Crawford County,35012,9658,25354
0500000US42049,42,049,Erie County,110050,32166,77884
0500000US42057,42,057,Fulton County,5950,1610,4340
0500000US42067,42,067,Juniata County,9404,2751,6653
0500000US42107,42,107,Schuylkill County,58733,15976,42757
0500000US42131,42,131,Wyoming County,10784,2948,7836
0500000US42001,42,001,Adams County,39221,11457,27764
0500000US42005,42,005,Armstrong County,27990,7422,20568
0500000US42035,42,035,Clinton County,14744,3909,10835
0500000US42025,42,025,Carbon County,25739,6801,18938
0500000US42027,42,027,Centre County,57908,13467,44441
0500000US42097,42,097,Northumberland County,39132,10251,28881
0500000US42095,42,095,Northampton County,114123,33641,80482
0500000US42023,42,023,Cameron County,2232,478,1754
0500000US42121,42,121,Venango County,21915,5834,16081
0500000US42007,42,007,Beaver County,70817,18407,52410
0500000US42017,42,017,Bucks County,237383,72577,164806
0500000US42069,42,069,Lackawanna County,86628,22330,64298
0500000US42083,42,083,McKean County,17169,4613,12556
0500000US42051,42,051,Fayette County,54511,14307,40204
0500000US42091,42,091,Montgomery County,313949,100669,213280
0500000US42059,42,059,Greene County,14211,3877,10334
0500000US42075,42,075,Lebanon County,53281,16137,37144
0500000US42079,42,079,Luzerne County,128054,34746,93308
0500000US42093,42,093,Montour County,7482,1948,5534
0500000US42037,42,037,Columbia County,26582,6629,19953
0500000US42019,42,019,Butler County,76240,21615,54625
0500000US42065,42,065,Jefferson County,18465,5051,13414
0500000US42071,42,071,Lancaster County,199889,60955,138934
0500000US42099,42,099,Perry County,18091,5413,12678
0500000US42105,42,105,Potter County,6523,1559,4964
0500000US42117,42,117,Tioga County,16178,4116,12062
0500000US44007,44,007,Providence County,238171,72291,165880
0500000US44001,44,001,Bristol County,19553,5488,14065
0500000US44005,44,005,Newport County,35217,8547,26670
0500000US45003,45,003,Aiken County,66710,19840,46870
0500000US45071,45,071,Newberry County,14939,4496,10443
0500000US45037,45,037,Edgefield County,9063,2775,6288
0500000US45027,45,027,Clarendon County,13327,3544,9783
0500000US45029,45,029,Colleton County,15145,4478,10667
0500000US45085,45,085,Sumter County,41137,12872,28265
0500000US45063,45,063,Lexington County,111265,36244,75021
0500000US45011,45,011,Barnwell County,8326,2192,6134
0500000US45015,45,015,Berkeley County,74931,26308,48623
0500000US45031,45,031,Darlington County,26592,8179,18413
0500000US45043,45,043,Georgetown County,25111,6238,18873
0500000US45091,45,091,York County,98155,34832,63323
0500000US45007,45,007,Anderson County,76632,23949,52683
0500000US45025,45,025,Chesterfield County,17977,5687,12290
0500000US45047,45,047,Greenwood County,27207,8101,19106
0500000US45051,45,051,Horry County,128586,31376,97210
0500000US45055,45,055,Kershaw County,24833,7178,17655
0500000US45075,45,075,Orangeburg County,32966,8530,24436
0500000US45001,45,001,Abbeville County,9455,2409,7046
0500000US45009,45,009,Bamberg County,5422,1577,3845
0500000US45017,45,017,Calhoun County,6121,1501,4620
0500000US45033,45,033,Dillon County,10968,3703,7265
0500000US45079,45,079,Richland County,150309,46857,103452
0500000US45039,45,039,Fairfield County,8979,1828,7151
0500000US45049,45,049,Hampton County,6924,1693,5231
0500000US45045,45,045,Greenville County,189334,60119,129215
0500000US45057,45,057,Lancaster County,32632,9593,23039
0500000US45035,45,035,Dorchester County,54549,18774,35775
0500000US45041,45,041,Florence County,52051,17765,34286
0500000US45059,45,059,Laurens County,25373,7423,17950
0500000US45065,45,065,McCormick County,3967,680,3287
0500000US45077,45,077,Pickens County,47375,13041,34334
0500000US45087,45,087,Union County,11544,3684,7860
0500000US45089,45,089,Williamsburg County,12411,3744,8667
0500000US46003,46,003,Aurora County,1161,311,850
0500000US46051,46,051,Grant County,3212,876,2336
0500000US46123,46,123,Tripp County,2406,625,1781
0500000US46071,46,071,Jackson County,884,378,506
0500000US46099,46,099,Minnehaha County,75049,24009,51040
0500000US46033,46,033,Custer County,3941,873,3068
0500000US46069,46,069,Hyde County,598,128,470
0500000US46025,46,025,Clark County,1536,384,1152
0500000US46049,46,049,Faulk County,902,216,686
0500000US46077,46,077,Kingsbury County,2296,536,1760
0500000US46129,46,129,Walworth County,2296,568,1728
0500000US46027,46,027,Clay County,5223,1262,3961
0500000US46037,46,037,Day County,2599,682,1917
0500000US46043,46,043,Douglas County,1250,357,893
0500000US46063,46,063,Harding County,548,146,402
0500000US46089,46,089,McPherson County,1012,184,828
0500000US46109,46,109,Roberts County,3824,1269,2555
0500000US46119,46,119,Sully County,567,154,413
0500000US46083,46,083,Lincoln County,19294,7600,11694
0500000US46079,46,079,Lake County,4675,1106,3569
0500000US46081,46,081,Lawrence County,11022,2486,8536
0500000US46029,46,029,Codington County,11974,3515,8459
0500000US46019,46,019,Butte County,4178,1299,2879
0500000US46031,46,031,Corson County,1186,510,676
0500000US46045,46,045,Edmunds County,1563,401,1162
0500000US46021,46,021,Campbell County,658,113,545
0500000US46007,46,007,Bennett County,985,409,576
0500000US46055,46,055,Haakon County,909,291,618
0500000US46075,46,075,Jones County,403,57,346
0500000US46093,46,093,Meade County,10912,3502,7410
0500000US46125,46,125,Turner County,3470,1003,2467
0500000US46013,46,013,Brown County,16184,4747,11437
0500000US46061,46,061,Hanson County,1069,343,726
0500000US46087,46,087,McCook County,2209,652,1557
0500000US46095,46,095,Mellette County,668,214,454
0500000US46105,46,105,Perkins County,1285,317,968
0500000US46103,46,103,Pennington County,43598,12554,31044
0500000US46127,46,127,Union County,6463,1928,4535
0500000US46097,46,097,Miner County,973,272,701
0500000US46137,46,137,Ziebach County,744,360,384
0500000US46039,46,039,Deuel County,1799,488,1311
0500000US46009,46,009,Bon Homme County,2536,605,1931
0500000US46015,46,015,Brule County,2221,696,1525
0500000US46047,46,047,Fall River County,3119,672,2447
0500000US46053,46,053,Gregory County,1845,475,1370
0500000US46102,46,102,Oglala Lakota County,2820,1739,1081
0500000US47119,47,119,Maury County,33572,11252,22320
0500000US47173,47,173,Union County,7126,2509,4617
0500000US47125,47,125,Montgomery County,70303,28917,41386
0500000US47043,47,043,Dickson County,18978,5670,13308
0500000US47129,47,129,Morgan County,7517,2548,4969
0500000US47061,47,061,Grundy County,4838,1566,3272
0500000US47123,47,123,Monroe County,17694,5431,12263
0500000US47079,47,079,Henry County,13406,3769,9637
0500000US47029,47,029,Cocke County,14181,3803,10378
0500000US47033,47,033,Crockett County,5335,1696,3639
0500000US47041,47,041,DeKalb County,7487,2312,5175
0500000US47095,47,095,Lake County,2203,713,1490
0500000US47093,47,093,Knox County,183318,52525,130793
0500000US47101,47,101,Lewis County,4758,1350,3408
0500000US47107,47,107,McMinn County,20427,6130,14297
0500000US47117,47,117,Marshall County,12335,4249,8086
0500000US47131,47,131,Obion County,12715,3835,8880
0500000US47143,47,143,Rhea County,12342,3603,8739
0500000US47151,47,151,Scott County,8703,2970,5733
0500000US47167,47,167,Tipton County,21325,8230,13095
0500000US47001,47,001,Anderson County,30483,8670,21813
0500000US47045,47,045,Dyer County,15180,5148,10032
0500000US47049,47,049,Fentress County,7403,2178,5225
0500000US47053,47,053,Gibson County,19223,6291,12932
0500000US47065,47,065,Hamilton County,140890,36620,104270
0500000US47105,47,105,Loudon County,20215,5153,15062
0500000US47149,47,149,Rutherford County,109468,40346,69122
0500000US47159,47,159,Smith County,7584,2454,5130
0500000US47189,47,189,Wilson County,48841,18190,30651
0500000US47163,47,163,Sullivan County,66239,17530,48709
0500000US47177,47,177,Warren County,15655,5094,10561
0500000US47179,47,179,Washington County,53190,14175,39015
0500000US47005,47,005,Benton County,6786,1467,5319
0500000US47013,47,013,Campbell County,16172,5176,10996
0500000US47015,47,015,Cannon County,5513,1701,3812
0500000US47047,47,047,Fayette County,15410,4284,11126
0500000US47067,47,067,Hancock County,2809,835,1974
0500000US47091,47,091,Johnson County,6858,1750,5108
0500000US47103,47,103,Lincoln County,13636,4105,9531
0500000US47127,47,127,Moore County,2602,773,1829
0500000US47051,47,051,Franklin County,16431,4825,11606
0500000US47009,47,009,Blount County,50159,14792,35367
0500000US47019,47,019,Carter County,23594,6265,17329
0500000US47057,47,057,Grainger County,8948,2639,6309
0500000US47097,47,097,Lauderdale County,9754,3543,6211
0500000US47099,47,099,Lawrence County,16131,5325,10806
0500000US47115,47,115,Marion County,11582,3768,7814
0500000US47133,47,133,Overton County,8974,2576,6398
0500000US47165,47,165,Sumner County,65645,22882,42763
0500000US47169,47,169,Trousdale County,3054,951,2103
0500000US47187,47,187,Williamson County,75344,32224,43120
0500000US47027,47,027,Clay County,3173,940,2233
0500000US47059,47,059,Greene County,27244,7282,19962
0500000US47157,47,157,Shelby County,350260,110284,239976
0500000US47175,47,175,Van Buren County,2163,542,1621
0500000US47077,47,077,Henderson County,10671,3225,7446
0500000US47081,47,081,Hickman County,8667,2386,6281
0500000US47089,47,089,Jefferson County,19910,5732,14178
0500000US47153,47,153,Sequatchie County,5441,1695,3746
0500000US47155,47,155,Sevier County,36945,10948,25997
0500000US47017,47,017,Carroll County,11062,3255,7807
0500000US47023,47,023,Chester County,5958,1982,3976
0500000US47037,47,037,Davidson County,277903,76997,200906
0500000US47087,47,087,Jackson County,4543,1090,3453
0500000US47135,47,135,Perry County,3317,977,2340
0500000US47145,47,145,Roane County,20963,5329,15634
0500000US47121,47,121,Meigs County,4790,1429,3361
0500000US47063,47,063,Hamblen County,24411,7575,16836
0500000US47075,47,075,Haywood County,7100,2049,5051
0500000US48143,48,143,Erath County,13961,4063,9898
0500000US48039,48,039,Brazoria County,118762,48937,69825
0500000US48345,48,345,Motley County,465,145,320
0500000US48129,48,129,Donley County,1290,297,993
0500000US48013,48,013,Atascosa County,15387,5800,9587
0500000US48083,48,083,Coleman County,3460,1006,2454
0500000US48353,48,353,Nolan County,5469,1686,3783
0500000US48229,48,229,Hudspeth County,900,193,707
0500000US48325,48,325,Medina County,15470,5307,10163
0500000US48475,48,475,Ward County,3956,1277,2679
0500000US48213,48,213,Henderson County,30885,9227,21658
0500000US48203,48,203,Harrison County,23217,8129,15088
0500000US48327,48,327,Menard County,992,222,770
0500000US48277,48,277,Lamar County,19313,5985,13328
0500000US48149,48,149,Fayette County,9067,2409,6658
0500000US48491,48,491,Williamson County,174754,69148,105606
0500000US48373,48,373,Polk County,17803,5277,12526
0500000US48391,48,391,Refugio County,2577,823,1754
0500000US48055,48,055,Caldwell County,13225,4861,8364
0500000US48487,48,487,Wilbarger County,5263,1569,3694
0500000US48383,48,383,Reagan County,1147,484,663
0500000US48189,48,189,Hale County,11146,4325,6821
0500000US48419,48,419,Shelby County,9292,3490,5802
0500000US48399,48,399,Runnels County,3749,1158,2591
0500000US48407,48,407,San Jacinto County,9487,2709,6778
0500000US48451,48,451,Tom Green County,43131,13215,29916
0500000US48469,48,469,Victoria County,32544,11200,21344
0500000US48473,48,473,Waller County,14807,5243,9564
0500000US48485,48,485,Wichita County,47951,15009,32942
0500000US48493,48,493,Wilson County,15820,5886,9934
0500000US48219,48,219,Hockley County,7946,3121,4825
0500000US48323,48,323,Maverick County,16307,8109,8198
0500000US48329,48,329,Midland County,55980,21626,34354
0500000US48297,48,297,Live Oak County,3675,924,2751
0500000US48299,48,299,Llano County,8491,1608,6883
0500000US48147,48,147,Fannin County,12231,3539,8692
0500000US48255,48,255,Karnes County,4246,1239,3007
0500000US48041,48,041,Brazos County,79053,23172,55881
0500000US48067,48,067,Cass County,11789,3451,8338
0500000US48165,48,165,Gaines County,5737,2776,2961
0500000US48179,48,179,Gray County,8000,2394,5606
0500000US48313,48,313,Madison County,4201,1450,2751
0500000US48237,48,237,Jack County,3160,1054,2106
0500000US48259,48,259,Kendall County,14159,4732,9427
0500000US48035,48,035,Bosque County,7088,2078,5010
0500000US48029,48,029,Bexar County,632574,227482,405092
0500000US48017,48,017,Bailey County,2111,826,1285
0500000US48023,48,023,Baylor County,1474,411,1063
0500000US48061,48,061,Cameron County,123185,57528,65657
0500000US48121,48,121,Denton County,283250,110565,172685
0500000US48477,48,477,Washington County,12381,3273,9108
0500000US48343,48,343,Morris County,5048,1560,3488
0500000US48429,48,429,Stephens County,3268,1101,2167
0500000US48201,48,201,Harris County,1583486,604600,978886
0500000US48003,48,003,Andrews County,5508,2396,3112
0500000US48171,48,171,Gillespie County,10717,2415,8302
0500000US48177,48,177,Gonzales County,7214,2606,4608
0500000US48305,48,305,Lynn County,2133,736,1397
0500000US48503,48,503,Young County,7105,2324,4781
0500000US48505,48,505,Zapata County,4405,2080,2325
0500000US48221,48,221,Hood County,21969,5958,16011
0500000US48223,48,223,Hopkins County,13405,4811,8594
0500000US48357,48,357,Ochiltree County,3443,1527,1916
0500000US48269,48,269,King County,91,21,70
0500000US48275,48,275,Knox County,1330,386,944
0500000US48309,48,309,McLennan County,89034,30275,58759
0500000US48073,48,073,Cherokee County,17940,6120,11820
0500000US48095,48,095,Concho County,873,192,681
0500000US48119,48,119,Delta County,2015,611,1404
0500000US48137,48,137,Edwards County,686,98,588
0500000US48133,48,133,Eastland County,6460,1224,5236
0500000US48253,48,253,Jones County,5593,1688,3905
0500000US48389,48,389,Reeves County,3713,1328,2385
0500000US48403,48,403,Sabine County,4099,784,3315
0500000US48421,48,421,Sherman County,1055,362,693
0500000US48437,48,437,Swisher County,2514,1014,1500
0500000US48231,48,231,Hunt County,32369,10457,21912
0500000US48063,48,063,Camp County,4692,1605,3087
0500000US48195,48,195,Hansford County,1855,767,1088
0500000US48187,48,187,Guadalupe County,53107,21000,32107
0500000US48077,48,077,Clay County,4045,1122,2923
0500000US48217,48,217,Hill County,12769,4023,8746
0500000US48347,48,347,Nacogdoches County,23904,7704,16200
0500000US48369,48,369,Parmer County,3318,1216,2102
0500000US48377,48,377,Presidio County,2627,665,1962
0500000US48465,48,465,Val Verde County,15429,6666,8763
0500000US48135,48,135,Ector County,51954,20958,30996
0500000US48173,48,173,Glasscock County,432,151,281
0500000US48185,48,185,Grimes County,8793,2696,6097
0500000US48085,48,085,Collin County,331336,140650,190686
0500000US48005,48,005,Angelina County,30783,12252,18531
0500000US48101,48,101,Cottle County,686,199,487
0500000US48209,48,209,Hays County,70881,23847,47034
0500000US48295,48,295,Lipscomb County,1256,425,831
0500000US48321,48,321,Matagorda County,13636,3993,9643
0500000US48371,48,371,Pecos County,4557,1537,3020
0500000US48397,48,397,Rockwall County,31649,13544,18105
0500000US48401,48,401,Rusk County,17960,6494,11466
0500000US48447,48,447,Throckmorton County,703,168,535
0500000US48471,48,471,Walker County,21636,5797,15839
0500000US48499,48,499,Wood County,16531,4015,12516
0500000US48007,48,007,Aransas County,9432,1996,7436
0500000US48075,48,075,Childress County,2235,686,1549
0500000US48081,48,081,Coke County,1617,389,1228
0500000US48099,48,099,Coryell County,22314,9307,13007
0500000US48211,48,211,Hemphill County,1323,592,731
0500000US48341,48,341,Moore County,6626,2659,3967
0500000US48349,48,349,Navarro County,17397,6384,11013
0500000US48405,48,405,San Augustine County,3356,908,2448
0500000US48417,48,417,Shackelford County,1234,334,900
0500000US48427,48,427,Starr County,16238,7910,8328
0500000US48461,48,461,Upton County,1305,417,888
0500000US48021,48,021,Bastrop County,25345,9030,16315
0500000US48191,48,191,Hall County,1301,376,925
0500000US48159,48,159,Franklin County,3806,1099,2707
0500000US48163,48,163,Frio County,4624,1864,2760
0500000US48281,48,281,Lampasas County,7738,2468,5270
0500000US48319,48,319,Mason County,1667,388,1279
0500000US48125,48,125,Dickens County,842,237,605
0500000US48439,48,439,Tarrant County,698995,269193,429802
0500000US48001,48,001,Anderson County,16459,5286,11173
0500000US48239,48,239,Jackson County,5237,1626,3611
0500000US48331,48,331,Milam County,9381,2934,6447
0500000US48093,48,093,Comanche County,5260,1479,3781
0500000US48047,48,047,Brooks County,2052,886,1166
0500000US19029,19,029,Cass County,5964,1517,4447
0500000US19035,19,035,Cherokee County,5337,1143,4194
0500000US19047,19,047,Crawford County,6435,2165,4270
0500000US19057,19,057,Des Moines County,16840,4875,11965
0500000US19065,19,065,Fayette County,8315,2274,6041
0500000US19085,19,085,Harrison County,6076,1714,4362
0500000US19109,19,109,Kossuth County,6666,1644,5022
0500000US19129,19,129,Mills County,5587,1742,3845
0500000US19133,19,133,Monona County,4053,1019,3034
0500000US19139,19,139,Muscatine County,16536,4973,11563
0500000US19143,19,143,Osceola County,2611,693,1918
0500000US19153,19,153,Polk County,183753,60714,123039
0500000US19187,19,187,Webster County,15208,4220,10988
0500000US19169,19,169,Story County,37219,8937,28282
0500000US19193,19,193,Woodbury County,38975,13364,25611
0500000US19013,19,013,Black Hawk County,52976,14831,38145
0500000US19075,19,075,Grundy County,5137,1586,3551
0500000US19097,19,097,Jackson County,8236,2399,5837
0500000US19105,19,105,Jones County,8204,2259,5945
0500000US19111,19,111,Lee County,14177,4165,10012
0500000US19131,19,131,Mitchell County,4397,1125,3272
0500000US19181,19,181,Warren County,18959,6627,12332
0500000US19161,19,161,Sac County,4367,1154,3213
0500000US19149,19,149,Plymouth County,10115,3269,6846
0500000US19041,19,041,Clay County,7343,2121,5222
0500000US19045,19,045,Clinton County,19689,5430,14259
0500000US20183,20,183,Smith County,1681,415,1266
0500000US20067,20,067,Grant County,2592,934,1658
0500000US20095,20,095,Kingman County,3091,865,2226
0500000US20131,20,131,Nemaha County,4020,1227,2793
0500000US20149,20,149,Pottawatomie County,8695,3279,5416
0500000US20021,20,021,Cherokee County,8037,2654,5383
0500000US20015,20,015,Butler County,24473,8706,15767
0500000US20105,20,105,Lincoln County,1264,310,954
0500000US20191,20,191,Sumner County,9321,2910,6411
0500000US20195,20,195,Trego County,1380,317,1063
0500000US20205,20,205,Wilson County,3795,1126,2669
0500000US20207,20,207,Woodson County,1476,357,1119
0500000US20135,20,135,Ness County,1313,334,979
0500000US20141,20,141,Osborne County,1691,427,1264
0500000US20011,20,011,Bourbon County,5722,1853,3869
0500000US20075,20,075,Hamilton County,852,278,574
0500000US20097,20,097,Kiowa County,981,232,749
0500000US20177,20,177,Shawnee County,72017,20934,51083
0500000US20181,20,181,Sherman County,2649,912,1737
0500000US20193,20,193,Thomas County,3301,941,2360
0500000US20125,20,125,Montgomery County,13538,3852,9686
0500000US20127,20,127,Morris County,2247,632,1615
0500000US20153,20,153,Rawlins County,1168,284,884
0500000US20163,20,163,Rooks County,2100,607,1493
0500000US20025,20,025,Clark County,893,268,625
0500000US20053,20,053,Ellsworth County,2462,579,1883
0500000US20077,20,077,Harper County,2274,699,1575
0500000US20167,20,167,Russell County,2979,649,2330
0500000US20111,20,111,Lyon County,13584,3804,9780
0500000US20145,20,145,Pawnee County,2502,586,1916
0500000US20001,20,001,Allen County,5289,1488,3801
0500000US20033,20,033,Comanche County,744,168,576
0500000US20049,20,049,Elk County,1117,248,869
0500000US20063,20,063,Gove County,1211,329,882
0500000US20079,20,079,Harvey County,13383,4260,9123
0500000US20083,20,083,Hodgeman County,761,213,548
0500000US20093,20,093,Kearny County,1261,514,747
0500000US20185,20,185,Stafford County,1811,534,1277
0500000US20113,20,113,McPherson County,12298,3570,8728
0500000US20139,20,139,Osage County,6554,1853,4701
0500000US20071,20,071,Greeley County,494,141,353
0500000US20031,20,031,Coffey County,3548,1062,2486
0500000US20037,20,037,Crawford County,15053,4223,10830
0500000US20051,20,051,Ellis County,11581,2864,8717
0500000US20073,20,073,Greenwood County,2758,770,1988
0500000US20099,20,099,Labette County,8033,2550,5483
0500000US20107,20,107,Linn County,4348,1203,3145
0500000US20173,20,173,Sedgwick County,195779,63456,132323
0500000US20175,20,175,Seward County,7315,3288,4027
0500000US20157,20,157,Republic County,2248,462,1786
0500000US20065,20,065,Graham County,1216,276,940
0500000US20091,20,091,Johnson County,226242,78199,148043
0500000US20045,20,045,Douglas County,46294,11704,34590
0500000US20179,20,179,Sheridan County,1134,301,833
0500000US20121,20,121,Miami County,12727,4246,8481
0500000US20069,20,069,Gray County,2179,744,1435
0500000US20199,20,199,Wallace County,633,170,463
0500000US20189,20,189,Stevens County,1911,780,1131
0500000US20201,20,201,Washington County,2344,567,1777
0500000US20019,20,019,Chautauqua County,1450,376,1074
0500000US20129,20,129,Morton County,1117,348,769
0500000US20155,20,155,Reno County,25052,7110,17942
0500000US20029,20,029,Cloud County,3858,1128,2730
0500000US20043,20,043,Doniphan County,3024,771,2253
0500000US20081,20,081,Haskell County,1329,483,846
0500000US20101,20,101,Lane County,787,264,523
0500000US20171,20,171,Scott County,2025,664,1361
0500000US20133,20,133,Neosho County,6681,2113,4568
0500000US20013,20,013,Brown County,3904,1126,2778
0500000US20147,20,147,Phillips County,2363,651,1712
0500000US20161,20,161,Riley County,26648,7143,19505
0500000US20039,20,039,Decatur County,1486,305,1181
0500000US20087,20,087,Jefferson County,7600,2369,5231
0500000US21031,21,031,Butler County,4996,1631,3365
0500000US21061,21,061,Edmonson County,4886,1482,3404
0500000US21097,21,097,Harrison County,7149,2160,4989
0500000US21023,21,023,Bracken County,3377,1049,2328
0500000US21143,21,143,Lyon County,3258,604,2654
0500000US21063,21,063,Elliott County,2576,1020,1556
0500000US21111,21,111,Jefferson County,310318,88221,222097
0500000US21123,21,123,Larue County,5654,1736,3918
0500000US21161,21,161,Mason County,6711,1864,4847
0500000US21167,21,167,Mercer County,8571,2232,6339
0500000US21201,21,201,Robertson County,902,213,689
0500000US21207,21,207,Russell County,7027,2121,4906
0500000US21229,21,229,Washington County,4667,1426,3241
0500000US21007,21,007,Ballard County,3085,866,2219
0500000US21009,21,009,Barren County,16965,5534,11431
0500000US21087,21,087,Green County,4466,1254,3212
0500000US21091,21,091,Hancock County,3301,1212,2089
0500000US21159,21,159,Martin County,4112,1459,2653
0500000US21093,21,093,Hardin County,41111,13768,27343
0500000US21149,21,149,McLean County,3818,1246,2572
0500000US21183,21,183,Ohio County,9076,2972,6104
0500000US21197,21,197,Powell County,4831,1693,3138
0500000US21233,21,233,Webster County,4975,1472,3503
0500000US21033,21,033,Caldwell County,5176,1450,3726
0500000US21045,21,045,Casey County,6330,1780,4550
0500000US21047,21,047,Christian County,25682,10222,15460
0500000US21085,21,085,Grayson County,9771,3165,6606
0500000US21103,21,103,Henry County,5999,2038,3961
0500000US21107,21,107,Hopkins County,18560,5701,12859
0500000US21109,21,109,Jackson County,5455,1862,3593
0500000US21125,21,125,Laurel County,22735,7394,15341
0500000US21157,21,157,Marshall County,13390,3818,9572
0500000US21163,21,163,Meade County,10638,4055,6583
0500000US21173,21,173,Montgomery County,10472,3816,6656
0500000US21181,21,181,Nicholas County,2694,908,1786
0500000US21185,21,185,Oldham County,20733,9210,11523
0500000US21187,21,187,Owen County,3921,1162,2759
0500000US21203,21,203,Rockcastle County,6525,2221,4304
0500000US21209,21,209,Scott County,20206,7825,12381
0500000US21227,21,227,Warren County,47142,15566,31576
0500000US21003,21,003,Allen County,7697,2452,5245
0500000US21017,21,017,Bourbon County,8128,2616,5512
0500000US21019,21,019,Boyd County,18798,5575,13223
0500000US21029,21,029,Bullitt County,29374,9905,19469
0500000US21055,21,055,Crittenden County,3645,1091,2554
0500000US21067,21,067,Fayette County,128806,36884,91922
0500000US21075,21,075,Fulton County,2524,791,1733
0500000US21115,21,115,Johnson County,8737,2675,6062
0500000US21165,21,165,Menifee County,2593,716,1877
0500000US21175,21,175,Morgan County,4958,1618,3340
0500000US21193,21,193,Perry County,11172,3776,7396
0500000US21237,21,237,Wolfe County,2817,818,1999
0500000US21051,21,051,Clay County,7625,2731,4894
0500000US21013,21,013,Bell County,10940,3420,7520
0500000US21025,21,025,Breathitt County,5322,1640,3682
0500000US21083,21,083,Graves County,14484,4193,10291
0500000US21099,21,099,Hart County,7311,2183,5128
0500000US21231,21,231,Wayne County,8019,2252,5767
0500000US21155,21,155,Marion County,7453,2216,5237
0500000US21221,21,221,Trigg County,5970,1572,4398
0500000US21015,21,015,Boone County,46404,17642,28762
0500000US21131,21,131,Leslie County,4223,1227,2996
0500000US21121,21,121,Knox County,12270,4291,7979
0500000US21127,21,127,Lawrence County,5956,1759,4197
0500000US21139,21,139,Livingston County,3967,1020,2947
0500000US21195,21,195,Pike County,25768,8155,17613
0500000US21211,21,211,Shelby County,16569,5705,10864
0500000US21005,21,005,Anderson County,8627,2971,5656
0500000US21027,21,027,Breckinridge County,7675,2252,5423
0500000US21073,21,073,Franklin County,20875,5761,15114
0500000US21117,21,117,Kenton County,63529,20024,43505
0500000US21151,21,151,Madison County,33229,9648,23581
0500000US21153,21,153,Magoffin County,5084,1411,3673
0500000US21189,21,189,Owsley County,1664,572,1092
0500000US21213,21,213,Simpson County,6914,2262,4652
0500000US21217,21,217,Taylor County,9596,3255,6341
0500000US21219,21,219,Todd County,4663,1657,3006
0500000US21039,21,039,Carlisle County,2020,569,1451
0500000US21053,21,053,Clinton County,3835,1172,2663
0500000US21077,21,077,Gallatin County,3073,1013,2060
0500000US21079,21,079,Garrard County,6823,2416,4407
0500000US21069,21,069,Fleming County,5888,1984,3904
0500000US21037,21,037,Campbell County,36308,10590,25718
0500000US22113,22,113,Vermilion Parish,21632,7594,14038
0500000US22089,22,089,St. Charles Parish,18762,7236,11526
0500000US22029,22,029,Concordia Parish,7371,2348,5023
0500000US22107,22,107,Tensas Parish,1825,409,1416
0500000US22093,22,093,St. James Parish,7906,2673,5233
0500000US22043,22,043,Grant Parish,6989,1616,5373
0500000US22051,22,051,Jefferson Parish,168895,49684,119211
0500000US22013,22,013,Bienville Parish,5892,1776,4116
0500000US22015,22,015,Bossier Parish,48947,17030,31917
0500000US22023,22,023,Cameron Parish,2718,902,1816
0500000US22037,22,037,East Feliciana Parish,6759,2043,4716
0500000US22095,22,095,St. John the Baptist Parish,15418,5331,10087
0500000US22075,22,075,Plaquemines Parish,8817,3604,5213
0500000US22073,22,073,Ouachita Parish,56686,18695,37991
0500000US22079,22,079,Rapides Parish,48000,16902,31098
0500000US22117,22,117,Washington Parish,17337,5574,11763
0500000US22097,22,097,St. Landry Parish,30094,10122,19972
0500000US22105,22,105,Tangipahoa Parish,47527,15059,32468
0500000US22001,22,001,Acadia Parish,22564,8188,14376
0500000US22101,22,101,St. Mary Parish,19740,5091,14649
0500000US22123,22,123,West Carroll Parish,4041,1240,2801
0500000US22103,22,103,St. Tammany Parish,91975,31152,60823
0500000US22111,22,111,Union Parish,7724,2023,5701
0500000US22021,22,021,Caldwell Parish,3667,1180,2487
0500000US22017,22,017,Caddo Parish,96360,28812,67548
0500000US22035,22,035,East Carroll Parish,2153,649,1504
0500000US22005,22,005,Ascension Parish,42649,16823,25826
0500000US22055,22,055,Lafayette Parish,90606,29360,61246
0500000US22045,22,045,Iberia Parish,26063,9038,17025
0500000US22087,22,087,St. Bernard Parish,15029,5803,9226
0500000US22091,22,091,St. Helena Parish,3871,1313,2558
0500000US22121,22,121,West Baton Rouge Parish,9599,3432,6167
0500000US22031,22,031,De Soto Parish,10523,3605,6918
0500000US22081,22,081,Red River Parish,3334,996,2338
0500000US22063,22,063,Livingston Parish,48859,19968,28891
0500000US22069,22,069,Natchitoches Parish,14630,2957,11673
0500000US22071,22,071,Orleans Parish,154036,34027,120009
0500000US22025,22,025,Catahoula Parish,3595,1106,2489
0500000US22019,22,019,Calcasieu Parish,77295,25369,51926
0500000US22041,22,041,Franklin Parish,7629,2546,5083
0500000US22007,22,007,Assumption Parish,8802,2494,6308
0500000US22049,22,049,Jackson Parish,5976,1883,4093
0500000US22083,22,083,Richland Parish,7391,2499,4892
0500000US22099,22,099,St. Martin Parish,19556,7071,12485
0500000US22127,22,127,Winn Parish,5437,1575,3862
0500000US22033,22,033,East Baton Rouge Parish,165939,46256,119683
0500000US22003,22,003,Allen Parish,7920,2595,5325
0500000US22065,22,065,Madison Parish,3943,1419,2524
0500000US23017,23,017,Oxford County,20814,4916,15898
0500000US23027,23,027,Waldo County,17067,4616,12451
0500000US23019,23,019,Penobscot County,61578,15825,45753
0500000US23001,23,001,Androscoggin County,45491,12814,32677
0500000US23003,23,003,Aroostook County,29645,6897,22748
0500000US23005,23,005,Cumberland County,119717,31501,88216
0500000US23013,23,013,Knox County,17156,3849,13307
0500000US23031,23,031,York County,84648,21767,62881
0500000US23007,23,007,Franklin County,11817,2879,8938
0500000US23025,23,025,Somerset County,21533,5549,15984
0500000US24047,24,047,Worcester County,21672,4563,17109
0500000US24510,24,510,Baltimore city,238436,60784,177652
0500000US24041,24,041,Talbot County,16627,4354,12273
0500000US24025,24,025,Harford County,93286,30955,62331
0500000US24027,24,027,Howard County,112966,42888,70078
0500000US24003,24,003,Anne Arundel County,207599,68730,138869
0500000US24005,24,005,Baltimore County,312913,97141,215772
0500000US24009,24,009,Calvert County,31726,11655,20071
0500000US24023,24,023,Garrett County,12073,3343,8730
0500000US24031,24,031,Montgomery County,370227,131157,239070
0500000US24013,24,013,Carroll County,60450,20192,40258
0500000US24035,24,035,Queen Anne's County,18148,5585,12563
0500000US24037,24,037,St. Mary's County,40332,14469,25863
0500000US24017,24,017,Charles County,55903,21694,34209
0500000US24019,24,019,Dorchester County,13264,3795,9469
0500000US24043,24,043,Washington County,55864,17790,38074
0500000US24045,24,045,Wicomico County,37637,11941,25696
0500000US24015,24,015,Cecil County,36930,11717,25213
0500000US24011,24,011,Caroline County,12081,4378,7703
0500000US25025,25,025,Suffolk County,307870,72935,234935
0500000US25001,25,001,Barnstable County,94292,18717,75575
0500000US25007,25,007,Dukes County,6367,1486,4881
0500000US25017,25,017,Middlesex County,600032,182973,417059
0500000US25003,25,003,Berkshire County,55167,12704,42463
0500000US25005,25,005,Bristol County,216618,66621,149997
0500000US25013,25,013,Hampden County,179043,55240,123803
0500000US25023,25,023,Plymouth County,186306,60736,125570
0500000US25009,25,009,Essex County,292659,92485,200174
0500000US25011,25,011,Franklin County,30328,7315,23013
0500000US25021,25,021,Norfolk County,263551,83041,180510
0500000US25015,25,015,Hampshire County,58665,14421,44244
0500000US25019,25,019,Nantucket County,3722,998,2724
0500000US26115,26,115,Monroe County,59279,17416,41863
0500000US26005,26,005,Allegan County,43000,13889,29111
0500000US26059,26,059,Hillsdale County,17904,4942,12962
0500000US26003,26,003,Alger County,3094,567,2527
0500000US26127,26,127,Oceana County,10157,3074,7083
0500000US26089,26,089,Leelanau County,9152,1959,7193
0500000US26035,26,035,Clare County,12406,2953,9453
0500000US26083,26,083,Keweenaw County,1081,222,859
0500000US26073,26,073,Isabella County,24889,6623,18266
0500000US26139,26,139,Ottawa County,101223,35152,66071
0500000US26157,26,157,Tuscola County,21759,6103,15656
0500000US26007,26,007,Alpena County,12717,3094,9623
0500000US26067,26,067,Ionia County,22858,7747,15111
0500000US26111,26,111,Midland County,34017,10036,23981
0500000US26021,26,021,Berrien County,63908,18049,45859
0500000US26135,26,135,Oscoda County,3824,802,3022
0500000US26039,26,039,Crawford County,6047,1389,4658
0500000US26037,26,037,Clinton County,29421,8839,20582
0500000US26057,26,057,Gratiot County,15177,4634,10543
0500000US26063,26,063,Huron County,13918,3176,10742
0500000US26091,26,091,Lenawee County,38222,10976,27246
0500000US26105,26,105,Mason County,12115,3180,8935
0500000US26117,26,117,Montcalm County,23761,7302,16459
0500000US26149,26,149,St. Joseph County,24022,7386,16636
0500000US26147,26,147,St. Clair County,64805,18491,46314
0500000US26161,26,161,Washtenaw County,140210,36756,103454
0500000US26011,26,011,Arenac County,6684,1568,5116
0500000US26027,26,027,Cass County,20855,6304,14551
0500000US26071,26,071,Iron County,5327,860,4467
0500000US26143,26,143,Roscommon County,10899,1851,9048
0500000US26163,26,163,Wayne County,676587,204837,471750
0500000US26023,26,023,Branch County,16506,4950,11556
0500000US26075,26,075,Jackson County,61696,17936,43760
0500000US26097,26,097,Mackinac County,5284,1128,4156
0500000US26009,26,009,Antrim County,9805,2348,7457
0500000US26061,26,061,Houghton County,13340,3092,10248
0500000US26069,26,069,Iosco County,11631,2306,9325
0500000US26085,26,085,Lake County,4517,760,3757
0500000US26119,26,119,Montmorency County,4195,800,3395
0500000US26141,26,141,Presque Isle County,5808,1125,4683
0500000US26077,26,077,Kalamazoo County,102809,28979,73830
0500000US26107,26,107,Mecosta County,15858,3944,11914
0500000US26103,26,103,Marquette County,26203,6235,19968
0500000US26123,26,123,Newaygo County,19007,5709,13298
0500000US26133,26,133,Osceola County,9100,2540,6560
0500000US26137,26,137,Otsego County,9886,2729,7157
0500000US26025,26,025,Calhoun County,53659,15630,38029
0500000US26031,26,031,Cheboygan County,11201,2657,8544
0500000US26095,26,095,Luce County,2190,516,1674
0500000US26081,26,081,Kent County,239236,79775,159461
0500000US26099,26,099,Macomb County,343592,100937,242655
0500000US26145,26,145,Saginaw County,78648,22673,55975
0500000US26155,26,155,Shiawassee County,27741,8195,19546
0500000US26013,26,013,Baraga County,3036,716,2320
0500000US26017,26,017,Bay County,43891,11864,32027
0500000US26029,26,029,Charlevoix County,11379,2737,8642
0500000US26045,26,045,Eaton County,44390,12643,31747
0500000US26041,26,041,Delta County,15949,4131,11818
0500000US26053,26,053,Gogebic County,6619,1255,5364
0500000US26047,26,047,Emmet County,14510,3662,10848
0500000US05147,05,147,Woodruff County,2890,770,2120
0500000US05023,05,023,Cleburne County,10731,2796,7935
0500000US05025,05,025,Cleveland County,3292,1037,2255
0500000US05067,05,067,Jackson County,6095,1698,4397
0500000US05057,05,057,Hempstead County,7971,2808,5163
0500000US05135,05,135,Sharp County,7354,1879,5475
0500000US05137,05,137,Stone County,4954,1325,3629
0500000US05143,05,143,Washington County,85891,28558,57333
0500000US05005,05,005,Baxter County,18370,4023,14347
0500000US05003,05,003,Ashley County,7915,2413,5502
0500000US05031,05,031,Craighead County,40800,14367,26433
0500000US05055,05,055,Greene County,16879,5956,10923
0500000US05073,05,073,Lafayette County,2859,682,2177
0500000US05105,05,105,Perry County,3708,1027,2681
0500000US05107,05,107,Phillips County,7498,2336,5162
0500000US05111,05,111,Poinsett County,9437,3237,6200
0500000US05133,05,133,Sevier County,5854,2327,3527
0500000US05149,05,149,Yell County,7491,2653,4838
0500000US05013,05,013,Calhoun County,1936,457,1479
0500000US05019,05,019,Clark County,8505,2397,6108
0500000US05011,05,011,Bradley County,4537,1373,3164
0500000US05095,05,095,Monroe County,3326,746,2580
0500000US05113,05,113,Polk County,8204,2275,5929
0500000US05103,05,103,Ouachita County,10055,2929,7126
0500000US05101,05,101,Newton County,2899,619,2280
0500000US05081,05,081,Little River County,5440,1552,3888
0500000US05015,05,015,Carroll County,11161,2936,8225
0500000US05091,05,091,Miller County,16748,5415,11333
0500000US06033,06,033,Lake County,25966,6757,19209
0500000US06043,06,043,Mariposa County,7700,1922,5778
0500000US06115,06,115,Yuba County,26179,10190,15989
0500000US06013,06,013,Contra Costa County,392277,141689,250588
0500000US06035,06,035,Lassen County,9493,2417,7076
0500000US06083,06,083,Santa Barbara County,144962,48250,96712
0500000US06097,06,097,Sonoma County,189339,53942,135397
0500000US06025,06,025,Imperial County,44057,18654,25403
0500000US06051,06,051,Mono County,4847,898,3949
0500000US06001,06,001,Alameda County,572870,194897,377973
0500000US06067,06,067,Sacramento County,536029,183652,352377
0500000US06055,06,055,Napa County,49032,15866,33166
0500000US06053,06,053,Monterey County,126052,49770,76282
0500000US06091,06,091,Sierra County,1241,159,1082
0500000US06073,06,073,San Diego County,1118980,374289,744691
0500000US06113,06,113,Yolo County,73510,24120,49390
0500000US06023,06,023,Humboldt County,54267,13695,40572
0500000US06003,06,003,Alpine County,299,56,243
0500000US06045,06,045,Mendocino County,34090,9576,24514
0500000US06087,06,087,Santa Cruz County,95756,28141,67615
0500000US06037,06,037,Los Angeles County,3306109,1109456,2196653
0500000US06065,06,065,Riverside County,718349,274850,443499
0500000US06085,06,085,Santa Clara County,635525,233992,401533
0500000US06041,06,041,Marin County,105258,30323,74935
0500000US06093,06,093,Siskiyou County,19257,4612,14645
0500000US06089,06,089,Shasta County,70473,19384,51089
0500000US06015,06,015,Del Norte County,9799,2914,6885
0500000US06021,06,021,Glenn County,10017,3626,6391
0500000US06007,06,007,Butte County,86797,23182,63615
0500000US06063,06,063,Plumas County,8047,1685,6362
0500000US06079,06,079,San Luis Obispo County,105317,26643,78674
0500000US06029,06,029,Kern County,267913,118202,149711
0500000US06059,06,059,Orange County,1032373,362611,669762
0500000US06009,06,009,Calaveras County,17417,3647,13770
0500000US06101,06,101,Sutter County,32360,13032,19328
0500000US06081,06,081,San Mateo County,261969,86444,175525
0500000US06109,06,109,Tuolumne County,22427,5043,17384
0500000US06077,06,077,San Joaquin County,226727,95158,131569
0500000US06005,06,005,Amador County,14090,3413,10677
0500000US08095,08,095,Phillips County,1668,491,1177
0500000US08007,08,007,Archuleta County,5670,1110,4560
0500000US08031,08,031,Denver County,294358,73839,220519
0500000US08061,08,061,Kiowa County,593,165,428
0500000US08055,08,055,Huerfano County,3282,645,2637
0500000US08009,08,009,Baca County,1642,412,1230
0500000US08015,08,015,Chaffee County,7958,1751,6207
0500000US08047,08,047,Gilpin County,2653,425,2228
0500000US08063,08,063,Kit Carson County,2977,963,2014
0500000US08045,08,045,Garfield County,21138,7310,13828
0500000US08051,08,051,Gunnison County,6643,1568,5075
0500000US08059,08,059,Jefferson County,230153,63731,166422
0500000US08079,08,079,Mineral County,375,38,337
0500000US08091,08,091,Ouray County,2194,389,1805
0500000US08103,08,103,Rio Blanco County,2403,804,1599
0500000US08115,08,115,Sedgwick County,1017,240,777
0500000US08021,08,021,Conejos County,3068,945,2123
0500000US08023,08,023,Costilla County,1687,395,1292
0500000US08001,08,001,Adams County,164353,65659,98694
0500000US08037,08,037,Eagle County,17750,5711,12039
0500000US08065,08,065,Lake County,3353,709,2644
0500000US08081,08,081,Moffat County,5210,1645,3565
0500000US08097,08,097,Pitkin County,7018,1385,5633
0500000US08017,08,017,Cheyenne County,742,244,498
0500000US08025,08,025,Crowley County,1194,353,841
0500000US08033,08,033,Dolores County,740,143,597
0500000US08057,08,057,Jackson County,575,97,478
0500000US08069,08,069,Larimer County,133527,36361,97166
0500000US08083,08,083,Montezuma County,10615,2870,7745
0500000US08113,08,113,San Miguel County,3441,853,2588
0500000US08013,08,013,Boulder County,125894,35033,90861
0500000US08071,08,071,Las Animas County,6477,1672,4805
0500000US08125,08,125,Yuma County,4051,1213,2838
0500000US08107,08,107,Routt County,9552,2524,7028
0500000US08117,08,117,Summit County,9707,2296,7411
0500000US08019,08,019,Clear Creek County,4640,1023,3617
0500000US08029,08,029,Delta County,11882,2821,9061
0500000US08101,08,101,Pueblo County,63762,19421,44341
0500000US08087,08,087,Morgan County,10785,4115,6670
0500000US08093,08,093,Park County,7119,1358,5761
0500000US08077,08,077,Mesa County,61033,17704,43329
0500000US08099,08,099,Prowers County,4963,1675,3288
0500000US08041,08,041,El Paso County,253379,87385,165994
0500000US08121,08,121,Washington County,2030,568,1462
0500000US08005,08,005,Arapahoe County,237559,81044,156515
0500000US08014,08,014,Broomfield County,26721,8763,17958
0500000US09009,09,009,New Haven County,329857,89770,240087
0500000US09003,09,003,Hartford County,349064,104823,244241
0500000US09015,09,015,Windham County,44449,12873,31576
0500000US09007,09,007,Middlesex County,66892,17216,49676
0500000US09013,09,013,Tolland County,55232,15204,40028
0500000US10003,10,003,New Castle County,203855,60321,143534
0500000US10005,10,005,Sussex County,89365,21843,67522
0500000US11001,11,001,District of Columbia,281322,58763,222559
0500000US12091,12,091,Okaloosa County,77403,22723,54680
0500000US12123,12,123,Taylor County,7356,2212,5144
0500000US12133,12,133,Washington County,8484,2734,5750
0500000US12031,12,031,Duval County,354387,105182,249205
0500000US12007,12,007,Bradford County,8993,2519,6474
0500000US12009,12,009,Brevard County,228888,53099,175789
0500000US12019,12,019,Clay County,73398,27841,45557
0500000US12067,12,067,Lafayette County,2095,778,1317
0500000US12069,12,069,Lake County,130190,32052,98138
0500000US12089,12,089,Nassau County,31241,9326,21915
0500000US12103,12,103,Pinellas County,407720,83651,324069
0500000US12105,12,105,Polk County,231260,68497,162763
0500000US12111,12,111,St. Lucie County,112872,31080,81792
0500000US12043,12,043,Glades County,4433,1052,3381
0500000US12051,12,051,Hendry County,12027,4959,7068
0500000US12061,12,061,Indian River County,57403,9927,47476
0500000US12063,12,063,Jackson County,16894,5020,11874
0500000US12099,12,099,Palm Beach County,548216,141162,407054
0500000US12109,12,109,St. Johns County,86268,27082,59186
0500000US12117,12,117,Seminole County,167304,49071,118233
0500000US12086,12,086,Miami-Dade County,870051,285191,584860
0500000US12005,12,005,Bay County,70199,19991,50208
0500000US12035,12,035,Flagler County,40629,8805,31824
0500000US12037,12,037,Franklin County,4297,956,3341
0500000US12047,12,047,Hamilton County,4485,1535,2950
0500000US12077,12,077,Liberty County,2381,719,1662
0500000US12119,12,119,Sumter County,54636,3634,51002
0500000US12039,12,039,Gadsden County,17080,4976,12104
0500000US12059,12,059,Holmes County,7016,2147,4869
0500000US12071,12,071,Lee County,271861,60710,211151
0500000US12083,12,083,Marion County,136514,29458,107056
0500000US12021,12,021,Collier County,140942,31125,109817
0500000US12095,12,095,Orange County,458613,153701,304912
0500000US12101,12,101,Pasco County,199227,55075,144152
0500000US12055,12,055,Highlands County,41026,8134,32892
0500000US12121,12,121,Suwannee County,15083,4390,10693
0500000US12027,12,027,DeSoto County,11996,3963,8033
0500000US12013,12,013,Calhoun County,4556,1361,3195
0500000US12023,12,023,Columbia County,24985,6639,18346
0500000US12029,12,029,Dixie County,6520,1535,4985
0500000US12107,12,107,Putnam County,28264,6236,22028
0500000US12125,12,125,Union County,3892,1413,2479
0500000US12081,12,081,Manatee County,143652,32929,110723
0500000US12075,12,075,Levy County,16433,3990,12443
0500000US12003,12,003,Baker County,8625,3835,4790
0500000US12127,12,127,Volusia County,212985,47245,165740
0500000US12073,12,073,Leon County,112918,28928,83990
0500000US12079,12,079,Madison County,6682,1707,4975
0500000US12033,12,033,Escambia County,118740,25101,93639
0500000US12053,12,053,Hernando County,73541,17751,55790
0500000US13037,13,037,Calhoun County,1853,609,1244
0500000US13193,13,193,Macon County,4673,1135,3538
0500000US13021,13,021,Bibb County,58010,17013,40997
0500000US13197,13,197,Marion County,3331,857,2474
0500000US13249,13,249,Schley County,1877,722,1155
0500000US13023,13,023,Bleckley County,4168,1271,2897
0500000US13093,13,093,Dooly County,4861,1396,3465
0500000US13119,13,119,Franklin County,8305,2802,5503
0500000US13103,13,103,Effingham County,20489,7967,12522
0500000US13171,13,171,Lamar County,6368,1507,4861
0500000US13107,13,107,Emanuel County,8392,2707,5685
0500000US13239,13,239,Quitman County,934,234,700
0500000US13159,13,159,Jasper County,5087,1772,3315
0500000US13167,13,167,Johnson County,3361,911,2450
0500000US13179,13,179,Liberty County,23232,9357,13875
0500000US13205,13,205,Mitchell County,7889,2454,5435
0500000US13253,13,253,Seminole County,3325,859,2466
0500000US13277,13,277,Tift County,15058,5273,9785
0500000US13289,13,289,Twiggs County,3031,854,2177
0500000US13233,13,233,Polk County,15011,5233,9778
0500000US13263,13,263,Talbot County,2766,573,2193
0500000US13269,13,269,Taylor County,3437,1097,2340
0500000US13273,13,273,Terrell County,3247,1240,2007
0500000US13275,13,275,Thomas County,17352,5629,11723
0500000US13279,13,279,Toombs County,10403,3675,6728
0500000US13319,13,319,Wilkinson County,3237,818,2419
0500000US13017,13,017,Ben Hill County,6569,2109,4460
0500000US13033,13,033,Burke County,8184,2943,5241
0500000US13047,13,047,Catoosa County,24636,7917,16719
0500000US13053,13,053,Chattahoochee County,2550,1306,1244
0500000US13055,13,055,Chattooga County,9098,2911,6187
0500000US13073,13,073,Columbia County,46840,17977,28863
0500000US13087,13,087,Decatur County,10153,3464,6689
0500000US13115,13,115,Floyd County,35633,11608,24025
0500000US13117,13,117,Forsyth County,73675,34263,39412
0500000US13137,13,137,Habersham County,15195,4536,10659
0500000US13185,13,185,Lowndes County,40472,12898,27574
0500000US13199,13,199,Meriwether County,8151,2173,5978
0500000US13207,13,207,Monroe County,9803,2645,7158
0500000US13261,13,261,Sumter County,11758,3650,8108
0500000US13265,13,265,Taliaferro County,612,128,484
0500000US13007,13,007,Baker County,1385,311,1074
0500000US13035,13,035,Butts County,8157,2602,5555
0500000US13043,13,043,Candler County,3965,1335,2630
0500000US13045,13,045,Carroll County,41150,15016,26134
0500000US13079,13,079,Crawford County,4637,1382,3255
0500000US13081,13,081,Crisp County,8329,2774,5555
0500000US13077,13,077,Coweta County,51308,19214,32094
0500000US13067,13,067,Cobb County,277222,97175,180047
0500000US13083,13,083,Dade County,6070,1971,4099
0500000US13297,13,297,Walton County,31133,12088,19045
0500000US13027,13,027,Brooks County,6350,1735,4615
0500000US13091,13,091,Dodge County,7694,2478,5216
0500000US13105,13,105,Elbert County,7491,1944,5547
0500000US13113,13,113,Fayette County,39753,13973,25780
0500000US13165,13,165,Jenkins County,3409,965,2444
0500000US13217,13,217,Newton County,36626,14171,22455
0500000US13227,13,227,Pickens County,11841,3456,8385
0500000US13071,13,071,Colquitt County,15374,5490,9884
0500000US13085,13,085,Dawson County,8711,2329,6382
0500000US13063,13,063,Clayton County,92845,35512,57333
0500000US13139,13,139,Hall County,63931,23984,39947
0500000US13141,13,141,Hancock County,2991,446,2545
0500000US13189,13,189,McDuffie County,8103,2766,5337
0500000US13211,13,211,Morgan County,6656,2031,4625
0500000US13149,13,149,Heard County,4489,1594,2895
0500000US13095,13,095,Dougherty County,34780,11069,23711
0500000US13111,13,111,Fannin County,10461,2410,8051
0500000US13153,13,153,Houston County,56146,20935,35211
0500000US13175,13,175,Laurens County,17183,5364,11819
0500000US13255,13,255,Spalding County,24137,7628,16509
0500000US13271,13,271,Telfair County,4931,1382,3549
0500000US13291,13,291,Union County,9070,1816,7254
0500000US13303,13,303,Washington County,7359,2539,4820
0500000US13311,13,311,White County,11588,3153,8435
0500000US13223,13,223,Paulding County,52389,22501,29888
0500000US13231,13,231,Pike County,6106,2059,4047
0500000US13245,13,245,Richmond County,72165,21129,51036
0500000US13267,13,267,Tattnall County,8237,2980,5257
0500000US13019,13,019,Berrien County,7322,2327,4995
0500000US13295,13,295,Walker County,25709,7939,17770
0500000US13135,13,135,Gwinnett County,288724,122999,165725
0500000US13013,13,013,Barrow County,25319,10340,14979
0500000US13049,13,049,Charlton County,3559,1008,2551
0500000US13065,13,065,Clinch County,2502,773,1729
0500000US13015,13,015,Bartow County,37351,14227,23124
0500000US13097,13,097,Douglas County,48968,19206,29762
0500000US13131,13,131,Grady County,9037,2960,6077
0500000US13161,13,161,Jeff Davis County,5270,2183,3087
0500000US13209,13,209,Montgomery County,3039,993,2046
0500000US13221,13,221,Oglethorpe County,5621,1728,3893
0500000US13243,13,243,Randolph County,2616,693,1923
0500000US13247,13,247,Rockdale County,30521,11415,19106
0500000US13299,13,299,Ware County,13901,4293,9608
0500000US13305,13,305,Wayne County,10353,3427,6926
0500000US13309,13,309,Wheeler County,1937,489,1448
0500000US13315,13,315,Wilcox County,2606,687,1919
0500000US13009,13,009,Baldwin County,16122,3959,12163
0500000US13031,13,031,Bulloch County,26955,8710,18245
0500000US13059,13,059,Clarke County,47224,10953,36271
0500000US13101,13,101,Echols County,1559,485,1074
0500000US13127,13,127,Glynn County,33777,10017,23760
0500000US13143,13,143,Haralson County,11128,3976,7152
0500000US13163,13,163,Jefferson County,5609,1666,3943
0500000US13169,13,169,Jones County,10510,3554,6956
0500000US13213,13,213,Murray County,14081,5718,8363
0500000US13215,13,215,Muscogee County,72924,23464,49460
0500000US13241,13,241,Rabun County,6563,1405,5158
0500000US13259,13,259,Stewart County,1826,409,1417
0500000US13283,13,283,Treutlen County,2641,794,1847
0500000US13155,13,155,Irwin County,3291,842,2449
0500000US13003,13,003,Atkinson County,2785,1049,1736
0500000US13005,13,005,Bacon County,3966,1298,2668
0500000US13025,13,025,Brantley County,6564,2233,4331
0500000US16087,16,087,Washington County,4018,1172,2846
0500000US16031,16,031,Cassia County,7904,3325,4579
0500000US16045,16,045,Gem County,6583,1667,4916
0500000US16085,16,085,Valley County,3461,748,2713
0500000US16003,16,003,Adams County,1675,346,1329
0500000US16069,16,069,Nez Perce County,16302,4694,11608
0500000US16055,16,055,Kootenai County,60497,18609,41888
0500000US16061,16,061,Lewis County,1632,364,1268
0500000US16083,16,083,Twin Falls County,30697,10784,19913
0500000US16073,16,073,Owyhee County,4250,1383,2867
0500000US16015,16,015,Boise County,3110,670,2440
0500000US16023,16,023,Butte County,1050,247,803
0500000US16029,16,029,Caribou County,2618,1018,1600
0500000US16001,16,001,Ada County,168741,50813,117928
0500000US16005,16,005,Bannock County,30841,10246,20595
0500000US16011,16,011,Bingham County,14772,5720,9052
0500000US16025,16,025,Camas County,357,77,280
0500000US16027,16,027,Canyon County,70847,27290,43557
0500000US16051,16,051,Jefferson County,8647,3894,4753
0500000US16057,16,057,Latah County,15530,3497,12033
0500000US16075,16,075,Payette County,8768,2962,5806
0500000US16009,16,009,Benewah County,3346,918,2428
0500000US16033,16,033,Clark County,305,147,158
0500000US16039,16,039,Elmore County,10285,3429,6856
0500000US16043,16,043,Fremont County,4309,1635,2674
0500000US16079,16,079,Shoshone County,5540,1148,4392
0500000US16049,16,049,Idaho County,6466,1453,5013
0500000US15001,15,001,Hawaii County,68412,19411,49001
0500000US15009,15,009,Maui County,54274,18049,36225
0500000US15007,15,007,Kauai County,22524,6929,15595
0500000US15005,15,005,Kalawao County,47,0,47
0500000US17083,17,083,Jersey County,8665,2549,6116
0500000US17155,17,155,Putnam County,2395,612,1783
0500000US17039,17,039,De Witt County,6663,2018,4645
0500000US17051,17,051,Fayette County,7616,2262,5354
0500000US17103,17,103,Lee County,13699,3806,9893
0500000US17107,17,107,Logan County,10872,3097,7775
0500000US17117,17,117,Macoupin County,18772,5505,13267
0500000US17159,17,159,Richland County,6482,1781,4701
0500000US17165,17,165,Saline County,10002,3110,6892
0500000US17189,17,189,Washington County,5975,1620,4355
0500000US17135,17,135,Montgomery County,11339,2742,8597
0500000US17195,17,195,Whiteside County,23346,6371,16975
0500000US17001,17,001,Adams County,27300,7621,19679
0500000US17027,17,027,Clinton County,14190,4298,9892
0500000US17037,17,037,DeKalb County,37703,11620,26083
0500000US17047,17,047,Edwards County,2776,821,1955
0500000US17079,17,079,Jasper County,3656,1062,2594
0500000US17081,17,081,Jefferson County,15223,4458,10765
0500000US17197,17,197,Will County,227848,89521,138327
0500000US17199,17,199,Williamson County,27089,7750,19339
0500000US17041,17,041,Douglas County,7618,2438,5180
0500000US17057,17,057,Fulton County,14090,3956,10134
0500000US17061,17,061,Greene County,5005,1356,3649
0500000US17069,17,069,Hardin County,1438,300,1138
0500000US17073,17,073,Henry County,20023,5833,14190
0500000US17095,17,095,Knox County,20830,5151,15679
0500000US17097,17,097,Lake County,244672,92070,152602
0500000US17127,17,127,Massac County,6011,1786,4225
0500000US17171,17,171,Scott County,1959,548,1411
0500000US17017,17,017,Cass County,5024,1598,3426
0500000US17099,17,099,LaSalle County,44644,12712,31932
0500000US17067,17,067,Hancock County,7420,1909,5511
0500000US17063,17,063,Grundy County,19398,7131,12267
0500000US17091,17,091,Kankakee County,40050,12299,27751
0500000US17043,17,043,DuPage County,341823,112553,229270
0500000US17167,17,167,Sangamon County,83661,23682,59979
0500000US17129,17,129,Menard County,5198,1668,3530
0500000US17031,17,031,Cook County,1963070,576305,1386765
0500000US17141,17,141,Ogle County,20901,6375,14526
0500000US17137,17,137,Morgan County,13864,3590,10274
0500000US17177,17,177,Stephenson County,19609,5365,14244
0500000US17193,17,193,White County,6082,1634,4448
0500000US17203,17,203,Woodford County,14566,4688,9878
0500000US17071,17,071,Henderson County,2990,764,2226
0500000US17111,17,111,McHenry County,111812,40772,71040
0500000US17113,17,113,McLean County,66159,19432,46727
0500000US17145,17,145,Perry County,8323,2394,5929
0500000US17149,17,149,Pike County,6527,1891,4636
0500000US17161,17,161,Rock Island County,60294,17254,43040
0500000US17163,17,163,St. Clair County,103063,31263,71800
0500000US17185,17,185,Wabash County,4896,1403,3493
0500000US17013,17,013,Calhoun County,1805,453,1352
0500000US17035,17,035,Cumberland County,4322,1286,3036
0500000US17085,17,085,Jo Daviess County,9758,2252,7506
0500000US17089,17,089,Kane County,178050,69563,108487
0500000US17101,17,101,Lawrence County,6144,1930,4214
0500000US17009,17,009,Brown County,2087,583,1504
0500000US17123,17,123,Marshall County,4893,1219,3674
0500000US17075,17,075,Iroquois County,11779,3308,8471
0500000US17021,17,021,Christian County,13939,3894,10045
0500000US17025,17,025,Clay County,5638,1573,4065
0500000US17059,17,059,Gallatin County,2314,757,1557
0500000US17077,17,077,Jackson County,23728,5388,18340
0500000US17133,17,133,Monroe County,13349,4398,8951
0500000US17143,17,143,Peoria County,73629,21040,52589
0500000US17181,17,181,Union County,6669,1927,4742
0500000US17201,17,201,Winnebago County,114608,35404,79204
0500000US17147,17,147,Piatt County,6700,2001,4699
0500000US17153,17,153,Pulaski County,2173,434,1739
0500000US17169,17,169,Schuyler County,2836,700,2136
0500000US17175,17,175,Stark County,2294,598,1696
0500000US17045,17,045,Edgar County,7590,2345,5245
0500000US17005,17,005,Bond County,6218,1711,4507
0500000US17007,17,007,Boone County,18731,7320,11411
0500000US17011,17,011,Bureau County,13805,4075,9730
0500000US17015,17,015,Carroll County,6476,1538,4938
0500000US17029,17,029,Coles County,21139,5557,15582
0500000US17033,17,033,Crawford County,7653,2250,5403
0500000US18105,18,105,Monroe County,55537,12763,42774
0500000US18045,18,045,Fountain County,7015,1906,5109
0500000US18039,18,039,Elkhart County,72329,26703,45626
0500000US18025,18,025,Crawford County,3915,1016,2899
0500000US18017,18,017,Cass County,14666,4368,10298
0500000US18097,18,097,Marion County,369033,105395,263638
0500000US18021,18,021,Clay County,10510,3611,6899
0500000US18063,18,063,Hendricks County,58078,22199,35879
0500000US18047,18,047,Franklin County,8744,3088,5656
0500000US18053,18,053,Grant County,26121,7879,18242
0500000US18071,18,071,Jackson County,16746,5741,11005
0500000US18067,18,067,Howard County,34550,9830,24720
0500000US18119,18,119,Owen County,8695,2395,6300
0500000US18135,18,135,Randolph County,10477,2853,7624
0500000US18183,18,183,Whitley County,13548,4035,9513
0500000US18013,18,013,Brown County,6093,1537,4556
0500000US18023,18,023,Clinton County,12007,4014,7993
0500000US18161,18,161,Union County,2846,812,2034
0500000US18027,18,027,Daviess County,11417,4124,7293
0500000US18029,18,029,Dearborn County,18648,5828,12820
0500000US18083,18,083,Knox County,14955,4934,10021
0500000US18093,18,093,Lawrence County,18487,5611,12876
0500000US18123,18,123,Perry County,7465,2198,5267
0500000US18131,18,131,Pulaski County,5200,1436,3764
0500000US18129,18,129,Posey County,10175,2998,7177
0500000US18171,18,171,Warren County,3384,1066,2318
0500000US18165,18,165,Vermillion County,6616,1972,4644
0500000US18003,18,003,Allen County,143500,47467,96033
0500000US18031,18,031,Decatur County,10425,3355,7070
0500000US18043,18,043,Floyd County,29356,8775,20581
0500000US18079,18,079,Jennings County,10659,3404,7255
0500000US18081,18,081,Johnson County,55777,20921,34856
0500000US18109,18,109,Morgan County,25926,8411,17515
0500000US18051,18,051,Gibson County,13244,4098,9146
0500000US18117,18,117,Orange County,7881,2388,5493
0500000US18085,18,085,Kosciusko County,30676,10111,20565
0500000US18099,18,099,Marshall County,17245,5538,11707
0500000US18163,18,163,Vanderburgh County,75197,20732,54465
0500000US18009,18,009,Blackford County,5225,1392,3833
0500000US18143,18,143,Scott County,9004,2920,6084
0500000US18061,18,061,Harrison County,14584,4361,10223
0500000US18091,18,091,LaPorte County,42904,12537,30367
0500000US18169,18,169,Wabash County,12875,3675,9200
0500000US18073,18,073,Jasper County,12539,3765,8774
0500000US18101,18,101,Martin County,4198,1177,3021
0500000US18127,18,127,Porter County,63969,21181,42788
0500000US18145,18,145,Shelby County,17725,5248,12477
0500000US18137,18,137,Ripley County,11165,3556,7609
0500000US18147,18,147,Spencer County,8109,2307,5802
0500000US18153,18,153,Sullivan County,7707,2476,5231
0500000US18159,18,159,Tipton County,6295,1828,4467
0500000US18157,18,157,Tippecanoe County,69112,19558,49554
0500000US18167,18,167,Vigo County,41874,12052,29822
0500000US18173,18,173,Warrick County,24267,8254,16013
0500000US18057,18,057,Hamilton County,116982,48390,68592
0500000US18033,18,033,DeKalb County,16789,5332,11457
0500000US18087,18,087,LaGrange County,12079,4677,7402
0500000US18005,18,005,Bartholomew County,31669,9959,21710
0500000US18139,18,139,Rush County,6725,2194,4531
0500000US18011,18,011,Boone County,24645,9152,15493
0500000US18049,18,049,Fulton County,7884,2226,5658
0500000US18089,18,089,Lake County,185437,59225,126212
0500000US18107,18,107,Montgomery County,15271,5010,10261
0500000US18113,18,113,Noble County,18090,6001,12089
0500000US18001,18,001,Adams County,12476,4485,7991
0500000US18041,18,041,Fayette County,9568,2782,6786
0500000US19055,19,055,Delaware County,6939,1978,4961
0500000US19185,19,185,Wayne County,2669,718,1951
0500000US19113,19,113,Linn County,89807,27858,61949
0500000US19163,19,163,Scott County,67025,20530,46495
0500000US19141,19,141,O'Brien County,6031,1716,4315
0500000US19011,19,011,Benton County,10224,3152,7072
0500000US19061,19,061,Dubuque County,38330,11410,26920
0500000US19079,19,079,Hamilton County,6315,1707,4608
0500000US19151,19,151,Pocahontas County,3205,725,2480
0500000US19175,19,175,Union County,5194,1463,3731
0500000US19177,19,177,Van Buren County,2863,687,2176
0500000US19159,19,159,Ringgold County,1997,518,1479
0500000US19001,19,001,Adair County,3136,777,2359
0500000US19009,19,009,Audubon County,2677,626,2051
0500000US19039,19,039,Clarke County,3854,1301,2553
0500000US19051,19,051,Davis County,3215,1176,2039
0500000US19093,19,093,Ida County,3010,804,2206
0500000US19107,19,107,Keokuk County,4384,1152,3232
0500000US19135,19,135,Monroe County,3329,954,2375
0500000US19179,19,179,Wapello County,14418,4337,10081
0500000US19167,19,167,Sioux County,12166,4447,7719
0500000US19025,19,025,Calhoun County,4191,1133,3058
0500000US19031,19,031,Cedar County,7546,2151,5395
0500000US19033,19,033,Cerro Gordo County,19213,4912,14301
0500000US19073,19,073,Greene County,3889,1060,2829
0500000US19083,19,083,Hardin County,7175,1832,5343
0500000US19117,19,117,Lucas County,3642,953,2689
0500000US19189,19,189,Winnebago County,4605,1222,3383
0500000US19147,19,147,Palo Alto County,3812,942,2870
0500000US19007,19,007,Appanoose County,5416,1269,4147
0500000US19095,19,095,Iowa County,6791,2011,4780
0500000US19099,19,099,Jasper County,14548,4353,10195
0500000US19191,19,191,Winneshiek County,8205,2073,6132
0500000US19157,19,157,Poweshiek County,7681,2162,5519
0500000US19127,19,127,Marshall County,15338,4733,10605
0500000US19015,19,015,Boone County,10940,3101,7839
0500000US19017,19,017,Bremer County,9585,2768,6817
0500000US19089,19,089,Howard County,3868,1106,2762
0500000US19063,19,063,Emmet County,4110,1123,2987
0500000US19081,19,081,Hancock County,4766,1250,3516
0500000US19121,19,121,Madison County,6309,2171,4138
0500000US19125,19,125,Marion County,13314,4230,9084
0500000US19197,19,197,Wright County,5690,1539,4151
0500000US39097,39,097,Madison County,15080,5116,9964
0500000US39119,39,119,Muskingum County,34239,10176,24063
0500000US27037,27,037,Dakota County,160144,55460,104684
0500000US27083,27,083,Lyon County,10050,3178,6872
0500000US27129,27,129,Renville County,6180,1661,4519
0500000US27031,27,031,Cook County,2699,545,2154
0500000US27093,27,093,Meeker County,9191,2655,6536
0500000US27113,27,113,Pennington County,5970,1668,4302
0500000US27167,27,167,Wilkin County,2826,823,2003
0500000US27027,27,027,Clay County,23782,7773,16009
0500000US27045,27,045,Fillmore County,8595,2513,6082
0500000US27119,27,119,Polk County,12516,3513,9003
0500000US27135,27,135,Roseau County,5995,1849,4146
0500000US27165,27,165,Watonwan County,4318,1287,3031
0500000US27011,27,011,Big Stone County,2274,485,1789
0500000US27021,27,021,Cass County,13007,3406,9601
0500000US27049,27,049,Goodhue County,19313,5763,13550
0500000US27063,27,063,Jackson County,4388,1184,3204
0500000US27105,27,105,Nobles County,7897,2456,5441
0500000US27141,27,141,Sherburne County,31737,12295,19442
0500000US27019,27,019,Carver County,35852,14347,21505
0500000US27061,27,061,Itasca County,19346,5144,14202
0500000US27123,27,123,Ramsey County,209069,62462,146607
0500000US27169,27,169,Winona County,19515,4599,14916
0500000US28089,28,089,Madison County,39020,14057,24963
0500000US28091,28,091,Marion County,9543,2901,6642
0500000US48449,48,449,Titus County,10694,4310,6384
0500000US48291,48,291,Liberty County,26203,9060,17143
0500000US48497,48,497,Wise County,22080,7978,14102
0500000US48249,48,249,Jim Wells County,13043,4750,8293
0500000US48127,48,127,Dimmit County,3309,1198,2111
0500000US48157,48,157,Fort Bend County,230381,107732,122649
0500000US48235,48,235,Irion County,634,149,485
0500000US48097,48,097,Cooke County,15368,4998,10370
0500000US48115,48,115,Dawson County,4322,1333,2989
0500000US48051,48,051,Burleson County,6754,1848,4906
0500000US48245,48,245,Jefferson County,94002,30898,63104
0500000US48359,48,359,Oldham County,527,171,356
0500000US48141,48,141,El Paso County,265724,107835,157889
0500000US48443,48,443,Terrell County,396,60,336
0500000US48463,48,463,Uvalde County,8683,2777,5906
0500000US48009,48,009,Archer County,3332,1044,2288
0500000US48215,48,215,Hidalgo County,234879,116009,118870
0500000US48425,48,425,Somervell County,3239,1465,1774
0500000US48207,48,207,Haskell County,2125,594,1531
0500000US48333,48,333,Mills County,1750,458,1292
0500000US48351,48,351,Newton County,4978,1363,3615
0500000US49045,49,045,Tooele County,19901,9816,10085
0500000US49043,49,043,Summit County,14555,5289,9266
0500000US49031,49,031,Piute County,499,120,379
0500000US49001,49,001,Beaver County,2277,901,1376
0500000US49039,49,039,Sanpete County,8483,3451,5032
0500000US49049,49,049,Utah County,160649,78439,82210
0500000US50011,50,011,Franklin County,18582,6218,12364
0500000US50003,50,003,Bennington County,14927,3962,10965
0500000US50009,50,009,Essex County,2756,617,2139
0500000US51530,51,530,Buena Vista city,2539,810,1729
0500000US51730,51,730,Petersburg city,13274,3209,10065
0500000US51600,51,600,Fairfax city,8553,2714,5839
0500000US51683,51,683,Manassas city,12749,5161,7588
0500000US51800,51,800,Suffolk city,33198,12214,20984
0500000US51041,51,041,Chesterfield County,123010,43904,79106
0500000US51093,51,093,Isle of Wight County,14304,4346,9958
0500000US51620,51,620,Franklin city,3526,1111,2415
0500000US51540,51,540,Charlottesville city,18613,4366,14247
0500000US51087,51,087,Henrico County,127111,39459,87652
0500000US51101,51,101,King William County,6170,2121,4049
0500000US51109,51,109,Louisa County,13575,3664,9911
0500000US51147,51,147,Prince Edward County,7187,2173,5014
0500000US51159,51,159,Richmond County,3139,860,2279
0500000US51177,51,177,Spotsylvania County,43677,16878,26799
0500000US51043,51,043,Clarke County,5639,1663,3976
0500000US51117,51,117,Mecklenburg County,11815,2716,9099
0500000US51015,51,015,Augusta County,29297,8411,20886
0500000US51051,51,051,Dickenson County,5841,1600,4241
0500000US51107,51,107,Loudoun County,125309,60066,65243
0500000US51161,51,161,Roanoke County,38343,11248,27095
0500000US51570,51,570,Colonial Heights city,7054,2208,4846
0500000US51021,51,021,Bland County,2523,739,1784
0500000US51029,51,029,Buckingham County,5827,1714,4113
0500000US51580,51,580,Covington city,2409,848,1561
0500000US51810,51,810,Virginia Beach city,169290,58337,110953
0500000US51640,51,640,Galax city,2742,921,1821
0500000US51193,51,193,Westmoreland County,7612,1861,5751
0500000US51155,51,155,Pulaski County,14525,3471,11054
0500000US51590,51,590,Danville city,18479,4880,13599
0500000US51009,51,009,Amherst County,12044,3292,8752
0500000US51017,51,017,Bath County,1999,406,1593
0500000US51700,51,700,Newport News city,69324,21200,48124
0500000US51680,51,680,Lynchburg city,28069,7482,20587
0500000US51690,51,690,Martinsville city,5630,1595,4035
0500000US51057,51,057,Essex County,4463,1203,3260
0500000US51790,51,790,Staunton city,10520,2659,7861
0500000US51750,51,750,Radford city,5438,1158,4280
0500000US51045,51,045,Craig County,2266,615,1651
0500000US51071,51,071,Giles County,6987,2175,4812
0500000US51157,51,157,Rappahannock County,2976,704,2272
0500000US54085,54,085,Ritchie County,3930,1064,2866
0500000US54043,54,043,Lincoln County,7879,2186,5693
0500000US54079,54,079,Putnam County,21665,7301,14364
0500000US54005,54,005,Boone County,9148,2821,6327
0500000US54051,54,051,Marshall County,12232,3078,9154
0500000US54093,54,093,Tucker County,3103,830,2273
0500000US54087,54,087,Roane County,5679,1473,4206
0500000US54107,54,107,Wood County,36018,9986,26032
0500000US54053,54,053,Mason County,10849,3123,7726
0500000US54073,54,073,Pleasants County,2869,1001,1868
0500000US54037,54,037,Jefferson County,20895,6966,13929
0500000US54045,54,045,Logan County,13875,4134,9741
0500000US53031,53,031,Jefferson County,14239,2319,11920
0500000US53049,53,049,Pacific County,9087,1919,7168
0500000US53059,53,059,Skamania County,4685,1209,3476
0500000US53009,53,009,Clallam County,32732,7180,25552
0500000US53039,53,039,Klickitat County,8539,2027,6512
0500000US53017,53,017,Douglas County,15064,5089,9975
0500000US53053,53,053,Pierce County,317699,105589,212110
0500000US53071,53,071,Walla Walla County,22304,6473,15831
0500000US53061,53,061,Snohomish County,289737,97674,192063
0500000US53067,53,067,Thurston County,108070,33522,74548
0500000US53011,53,011,Clark County,171522,58317,113205
0500000US53001,53,001,Adams County,5881,2746,3135
0500000US53057,53,057,Skagit County,47937,14004,33933
0500000US53043,53,043,Lincoln County,4485,1118,3367
0500000US55119,55,119,Taylor County,8632,2565,6067
0500000US55099,55,099,Price County,6605,1403,5202
0500000US55079,55,079,Milwaukee County,382070,113437,268633
0500000US55033,55,033,Dunn County,16818,4639,12179
0500000US55045,55,045,Green County,15098,4551,10547
0500000US55115,55,115,Shawano County,17019,4348,12671
0500000US55078,55,078,Menominee County,1443,636,807
0500000US55011,55,011,Buffalo County,5713,1513,4200
0500000US55063,55,063,La Crosse County,47319,12901,34418
0500000US55035,55,035,Eau Claire County,40753,11037,29716
0500000US55095,55,095,Polk County,18314,5122,13192
0500000US55133,55,133,Waukesha County,157548,47314,110234
0500000US55125,55,125,Vilas County,10914,2026,8888
0500000US55057,55,057,Juneau County,10640,2751,7889
0500000US55131,55,131,Washington County,54138,16825,37313
0500000US55025,55,025,Dane County,219490,59940,159550
0500000US55039,55,039,Fond du Lac County,41346,11601,29745
0500000US55091,55,091,Pepin County,3095,833,2262
0500000US55097,55,097,Portage County,28357,7344,21013
0500000US56023,56,023,Lincoln County,7075,2357,4718
0500000US56021,56,021,Laramie County,39179,12407,26772
0500000US01093,01,093,Marion County,12212,3740,8472
0500000US01073,01,073,Jefferson County,260924,78736,182188
0500000US01059,01,059,Franklin County,11210,3389,7821
0500000US01019,01,019,Cherokee County,10606,2889,7717
0500000US01047,01,047,Dallas County,16336,4768,11568
0500000US01087,01,087,Macon County,7637,1794,5843
0500000US01117,01,117,Shelby County,78328,26503,51825
0500000US01003,01,003,Baldwin County,78622,20638,57984
0500000US01069,01,069,Houston County,39253,11743,27510
0500000US01125,01,125,Tuscaloosa County,72379,23108,49271
0500000US01027,01,027,Clay County,5236,1455,3781
0500000US01109,01,109,Pike County,11547,2771,8776
0500000US01037,01,037,Coosa County,4103,998,3105
0500000US01065,01,065,Hale County,5658,1614,4044
0500000US01053,01,053,Escambia County,13428,3707,9721
0500000US01013,01,013,Butler County,6708,1867,4841
0500000US01105,01,105,Perry County,3079,646,2433
0500000US01035,01,035,Conecuh County,4574,1098,3476
0500000US01007,01,007,Bibb County,6840,1995,4845
0500000US01017,01,017,Chambers County,13516,3494,10022
0500000US01057,01,057,Fayette County,6947,1977,4970
0500000US01009,01,009,Blount County,20600,6418,14182
0500000US01001,01,001,Autauga County,21115,7618,13497
0500000US01061,01,061,Geneva County,10479,3055,7424
0500000US02261,02,261,Valdez-Cordova Census Area,3093,822,2271
0500000US02105,02,105,Hoonah-Angoon Census Area,799,148,651
0500000US02275,02,275,Wrangell City and Borough,1074,253,821
0500000US04019,04,019,Pima County,400907,110478,290429
0500000US04007,04,007,Gila County,21708,5314,16394
0500000US04003,04,003,Cochise County,49250,14243,35007
0500000US04001,04,001,Apache County,20395,6509,13886
0500000US04025,04,025,Yavapai County,96007,19121,76886
0500000US04017,04,017,Navajo County,34407,11820,22587
0500000US05119,05,119,Pulaski County,157083,46331,110752
0500000US05021,05,021,Clay County,6441,1944,4497
0500000US05039,05,039,Dallas County,3033,774,2259
0500000US05121,05,121,Randolph County,7455,2430,5025
0500000US05009,05,009,Boone County,14870,4527,10343
0500000US05063,05,063,Independence County,14268,4955,9313
0500000US05053,05,053,Grant County,6780,2258,4522
0500000US05045,05,045,Faulkner County,44095,14143,29952
0500000US05089,05,089,Marion County,6669,1342,5327
0500000US05129,05,129,Searcy County,3271,784,2487
0500000US05033,05,033,Crawford County,23701,7897,15804
0500000US05059,05,059,Hot Spring County,12377,3863,8514
0500000US05087,05,087,Madison County,6195,1833,4362
0500000US05061,05,061,Howard County,5096,1587,3509
0500000US05093,05,093,Mississippi County,16888,5724,11164
0500000US05139,05,139,Union County,15904,5055,10849
0500000US39055,39,055,Geauga County,35285,10647,24638
0500000US39085,39,085,Lake County,95980,25730,70250
0500000US39023,39,023,Clark County,54905,16516,38389
0500000US39075,39,075,Holmes County,12437,5240,7197
0500000US39111,39,111,Monroe County,5945,1496,4449
0500000US39165,39,165,Warren County,81859,30554,51305
0500000US39005,39,005,Ashland County,20439,6048,14391
0500000US40133,40,133,Seminole County,9222,3150,6072
0500000US40011,40,011,Blaine County,3908,1259,2649
0500000US40029,40,029,Coal County,2236,706,1530
0500000US40073,40,073,Kingfisher County,5694,2060,3634
0500000US40095,40,095,Marshall County,6240,1996,4244
0500000US40105,40,105,Nowata County,4084,1343,2741
0500000US40131,40,131,Rogers County,34452,12453,21999
0500000US40003,40,003,Alfalfa County,1958,642,1316
0500000US40027,40,027,Cleveland County,105190,34520,70670
0500000US40005,40,005,Atoka County,5302,1686,3616
0500000US40043,40,043,Dewey County,1701,466,1235
0500000US40083,40,083,Logan County,15665,5483,10182
0500000US40147,40,147,Washington County,20667,6268,14399
0500000US40061,40,061,Haskell County,4864,1629,3235
0500000US40111,40,111,Okmulgee County,14665,4671,9994
0500000US40067,40,067,Jefferson County,2367,769,1598
0500000US40049,40,049,Garvin County,10425,3372,7053
0500000US40123,40,123,Pontotoc County,14354,4809,9545
0500000US40063,40,063,Hughes County,4073,1152,2921
0500000US40031,40,031,Comanche County,42610,14879,27731
0500000US40117,40,117,Pawnee County,6205,2002,4203
0500000US41019,41,019,Douglas County,45026,10956,34070
0500000US41053,41,053,Polk County,29692,9199,20493
0500000US41017,41,017,Deschutes County,72471,20030,52441
0500000US41071,41,071,Yamhill County,36197,11484,24713
0500000US41035,41,035,Klamath County,27402,7690,19712
0500000US41003,41,003,Benton County,35056,8243,26813
0500000US41013,41,013,Crook County,9339,2231,7108
0500000US41025,41,025,Harney County,3157,816,2341
0500000US41063,41,063,Wallowa County,3165,716,2449
0500000US41069,41,069,Wheeler County,661,113,548
0500000US41011,41,011,Coos County,26640,6397,20243
0500000US41027,41,027,Hood River County,8539,2644,5895
0500000US41051,41,051,Multnomah County,321968,85687,236281
0500000US42055,42,055,Franklin County,60210,17974,42236
0500000US42009,42,009,Bedford County,19674,5073,14601
0500000US42111,42,111,Somerset County,29708,7538,22170
0500000US42133,42,133,York County,171244,53736,117508
0500000US42015,42,015,Bradford County,24812,6901,17911
0500000US42029,42,029,Chester County,189592,62711,126881
0500000US42063,42,063,Indiana County,33892,8094,25798
0500000US42125,42,125,Washington County,84100,22761,61339
0500000US42103,42,103,Pike County,21871,6294,15577
0500000US42077,42,077,Lehigh County,138008,44851,93157
0500000US42031,42,031,Clarion County,15824,3958,11866
0500000US42033,42,033,Clearfield County,31349,7892,23457
0500000US42081,42,081,Lycoming County,45897,12699,33198
0500000US42123,42,123,Warren County,17080,4171,12909
0500000US42047,42,047,Elk County,13727,3381,10346
0500000US42085,42,085,Mercer County,46028,12219,33809
0500000US42113,42,113,Sullivan County,2721,566,2155
0500000US44003,44,003,Kent County,68833,18630,50203
0500000US44009,44,009,Washington County,49111,12768,36343
0500000US45005,45,005,Allendale County,3350,863,2487
0500000US45023,45,023,Chester County,12453,3202,9251
0500000US45067,45,067,Marion County,11538,3254,8284
0500000US45073,45,073,Oconee County,31818,8002,23816
0500000US45019,45,019,Charleston County,156482,40024,116458
0500000US45069,45,069,Marlboro County,9584,2922,6662
0500000US45021,45,021,Cherokee County,20373,4816,15557
0500000US45053,45,053,Jasper County,9982,3105,6877
0500000US45061,45,061,Lee County,6357,1347,5010
0500000US45083,45,083,Spartanburg County,114640,37276,77364
0500000US45013,45,013,Beaufort County,70607,16889,53718
0500000US45081,45,081,Saluda County,7211,2111,5100
0500000US46067,46,067,Hutchinson County,2862,754,2108
0500000US46017,46,017,Buffalo County,564,307,257
0500000US46041,46,041,Dewey County,1667,714,953
0500000US46065,46,065,Hughes County,7479,1949,5530
0500000US46111,46,111,Sanborn County,1051,272,779
0500000US46059,46,059,Hand County,1518,421,1097
0500000US46135,46,135,Yankton County,9359,2626,6733
0500000US46005,46,005,Beadle County,7770,2421,5349
0500000US46035,46,035,Davison County,8687,2290,6397
0500000US46073,46,073,Jerauld County,917,197,720
0500000US46117,46,117,Stanley County,1264,471,793
0500000US46107,46,107,Potter County,998,209,789
0500000US46023,46,023,Charles Mix County,3144,929,2215
0500000US46091,46,091,Marshall County,1862,519,1343
0500000US46101,46,101,Moody County,2636,751,1885
0500000US46121,46,121,Todd County,2703,1386,1317
0500000US46085,46,085,Lyman County,1404,516,888
0500000US46115,46,115,Spink County,2635,714,1921
0500000US46011,46,011,Brookings County,12764,3204,9560
0500000US46057,46,057,Hamlin County,2215,801,1414
0500000US47083,47,083,Houston County,2943,727,2216
0500000US47071,47,071,Hardin County,10267,3136,7131
0500000US47069,47,069,Hardeman County,8907,2554,6353
0500000US47139,47,139,Polk County,7096,2215,4881
0500000US47185,47,185,White County,9951,2989,6962
0500000US47171,47,171,Unicoi County,7521,2109,5412
0500000US47183,47,183,Weakley County,13605,3874,9731
0500000US47007,47,007,Bledsoe County,4853,1542,3311
0500000US47031,47,031,Coffee County,21626,6844,14782
0500000US47073,47,073,Hawkins County,23330,7157,16173
0500000US47111,47,111,Macon County,9202,3265,5937
0500000US47147,47,147,Robertson County,25388,9357,16031
0500000US47021,47,021,Cheatham County,14952,4731,10221
0500000US47055,47,055,Giles County,11496,3376,8120
0500000US47113,47,113,Madison County,37729,11294,26435
0500000US47137,47,137,Pickett County,2218,643,1575
0500000US47181,47,181,Wayne County,5954,1748,4206
0500000US47003,47,003,Bedford County,16882,6453,10429
0500000US47035,47,035,Cumberland County,25347,5828,19519
0500000US47025,47,025,Claiborne County,13238,3547,9691
0500000US47085,47,085,Humphreys County,6858,1787,5071
0500000US47141,47,141,Putnam County,31110,8608,22502
0500000US47161,47,161,Stewart County,5246,1525,3721
0500000US47039,47,039,Decatur County,4623,1155,3468
0500000US47109,47,109,McNairy County,10022,2898,7124
0500000US47011,47,011,Bradley County,39840,12494,27346
0500000US48267,48,267,Kimble County,1948,516,1432
0500000US48467,48,467,Van Zandt County,19615,6207,13408
0500000US48317,48,317,Martin County,1626,631,995
0500000US48501,48,501,Yoakum County,2676,1226,1450
0500000US48387,48,387,Red River County,5048,1183,3865
0500000US48435,48,435,Sutton County,1484,488,996
0500000US48459,48,459,Upshur County,14036,4390,9646
0500000US48481,48,481,Wharton County,15256,5511,9745
0500000US48033,48,033,Borden County,261,85,176
0500000US48315,48,315,Marion County,4459,871,3588
0500000US48181,48,181,Grayson County,47957,15604,32353
0500000US48363,48,363,Palo Pinto County,10312,2994,7318
0500000US48123,48,123,DeWitt County,7088,2614,4474
0500000US48059,48,059,Callahan County,5319,1273,4046
0500000US48183,48,183,Gregg County,45532,15459,30073
0500000US48303,48,303,Lubbock County,112185,36478,75707
0500000US48257,48,257,Kaufman County,37364,15998,21366
0500000US48153,48,153,Floyd County,2328,810,1518
0500000US48071,48,071,Chambers County,13529,5742,7787
0500000US48027,48,027,Bell County,120241,46132,74109
0500000US48233,48,233,Hutchinson County,7191,2337,4854
0500000US48361,48,361,Orange County,31989,10891,21098
0500000US48495,48,495,Winkler County,2572,931,1641
0500000US48053,48,053,Burnet County,16849,4943,11906
0500000US48113,48,113,Dallas County,917276,330586,586690
0500000US48311,48,311,McMullen County,223,76,147
0500000US48251,48,251,Johnson County,56433,22035,34398
0500000US48205,48,205,Hartley County,1681,632,1049
0500000US48293,48,293,Limestone County,8169,2621,5548
0500000US48367,48,367,Parker County,44255,15672,28583
0500000US48109,48,109,Culberson County,681,193,488
0500000US48169,48,169,Garza County,1628,584,1044
0500000US48453,48,453,Travis County,458484,137429,321055
0500000US48087,48,087,Collingsworth County,1055,381,674
0500000US48279,48,279,Lamb County,4754,1703,3051
0500000US48301,48,301,Loving County,33,7,26
0500000US28117,28,117,Prentiss County,9399,3021,6378
0500000US28059,28,059,Jackson County,51429,15112,36317
0500000US28143,28,143,Tunica County,3943,1427,2516
0500000US28021,28,021,Claiborne County,3009,829,2180
0500000US28075,28,075,Lauderdale County,29657,9361,20296
0500000US28127,28,127,Simpson County,9361,3227,6134
0500000US28007,28,007,Attala County,7129,2476,4653
0500000US28027,28,027,Coahoma County,8744,3142,5602
0500000US28147,28,147,Walthall County,5683,1802,3881
0500000US28115,28,115,Pontotoc County,10788,3925,6863
0500000US28003,28,003,Alcorn County,14502,4591,9911
0500000US28033,28,033,DeSoto County,62078,24325,37753
0500000US29129,29,129,Mercer County,1326,299,1027
0500000US29047,29,047,Clay County,90285,29827,60458
0500000US29065,29,065,Dent County,6300,1733,4567
0500000US29227,29,227,Worth County,856,222,634
0500000US29510,29,510,St. Louis city,140455,32191,108264
0500000US29023,29,023,Butler County,16357,5060,11297
0500000US29087,29,087,Holt County,2056,515,1541
0500000US29139,29,139,Montgomery County,4891,1545,3346
0500000US29207,29,207,Stoddard County,11684,3329,8355
0500000US29221,29,221,Washington County,9114,2899,6215
0500000US29063,29,063,DeKalb County,3812,1036,2776
0500000US29107,29,107,Lafayette County,12959,4125,8834
0500000US29197,29,197,Schuyler County,1588,447,1141
0500000US29029,29,029,Camden County,16096,3133,12963
0500000US29097,29,097,Jasper County,45261,15015,30246
0500000US29119,29,119,McDonald County,8110,3070,5040
0500000US29167,29,167,Polk County,11557,3738,7819
0500000US29179,29,179,Reynolds County,2638,723,1915
0500000US29201,29,201,Scott County,15428,5031,10397
0500000US29011,29,011,Barton County,4931,1648,3283
0500000US29051,29,051,Cole County,29749,9139,20610
0500000US29073,29,073,Gasconade County,6116,1508,4608
0500000US29121,29,121,Macon County,5889,1506,4383
0500000US29155,29,155,Pemiscot County,6845,2219,4626
0500000US29203,29,203,Shannon County,3173,797,2376
0500000US29067,29,067,Douglas County,5126,1077,4049
0500000US29083,29,083,Henry County,9199,2708,6491
0500000US29109,29,109,Lawrence County,14604,4726,9878
0500000US30015,30,015,Chouteau County,2256,729,1527
0500000US30053,30,053,Lincoln County,8259,1553,6706
0500000US30103,30,103,Treasure County,365,78,287
0500000US30097,30,097,Sweet Grass County,1547,356,1191
0500000US30079,30,079,Prairie County,540,122,418
0500000US30035,30,035,Glacier County,4178,1260,2918
0500000US30037,30,037,Golden Valley County,337,65,272
0500000US30095,30,095,Stillwater County,3716,850,2866
0500000US30039,30,039,Granite County,1280,164,1116
0500000US30057,30,057,Madison County,3481,548,2933
0500000US30091,30,091,Sheridan County,1645,363,1282
0500000US30003,30,003,Big Horn County,3687,1745,1942
0500000US30049,30,049,Lewis and Clark County,27800,7554,20246
0500000US30063,30,063,Missoula County,48608,12358,36250
0500000US30013,30,013,Cascade County,34444,9502,24942
0500000US30033,30,033,Garfield County,447,112,335
0500000US30077,30,077,Powell County,2388,529,1859
0500000US30031,30,031,Gallatin County,41985,11603,30382
0500000US30001,30,001,Beaverhead County,3977,742,3235
0500000US30065,30,065,Musselshell County,2077,474,1603
0500000US31161,31,161,Sheridan County,2251,563,1688
0500000US31129,31,129,Nuckolls County,1914,445,1469
0500000US31063,31,063,Frontier County,1116,291,825
0500000US31055,31,055,Douglas County,215787,71229,144558
0500000US31029,31,029,Chase County,1714,432,1282
0500000US31005,31,005,Arthur County,193,47,146
0500000US31061,31,061,Franklin County,1354,312,1042
0500000US31095,31,095,Jefferson County,3283,684,2599
0500000US31115,31,115,Loup County,279,58,221
0500000US31137,31,137,Phelps County,3927,1167,2760
0500000US31157,31,157,Scotts Bluff County,14613,4788,9825
0500000US31105,31,105,Kimball County,1571,393,1178
0500000US31121,31,121,Merrick County,3324,919,2405
0500000US31021,31,021,Burt County,2919,827,2092
0500000US31039,31,039,Cuming County,3752,1029,2723
0500000US31075,31,075,Grant County,293,69,224
0500000US31085,31,085,Hayes County,413,88,325
0500000US31027,31,027,Cedar County,3456,924,2532
0500000US31097,31,097,Johnson County,1820,554,1266
0500000US31071,31,071,Garfield County,886,213,673
0500000US31133,31,133,Pawnee County,1219,276,943
0500000US31183,31,183,Wheeler County,357,71,286
0500000US31185,31,185,York County,5691,1499,4192
0500000US31037,31,037,Colfax County,3718,1384,2334
0500000US31113,31,113,Logan County,341,97,244
0500000US31143,31,143,Polk County,2052,583,1469
0500000US31017,31,017,Brown County,1434,294,1140
0500000US32015,32,015,Lander County,2087,877,1210
0500000US32011,32,011,Eureka County,750,222,528
0500000US34021,34,021,Mercer County,129873,42851,87022
0500000US34035,34,035,Somerset County,117012,40858,76154
0500000US34001,34,001,Atlantic County,99874,31547,68327
0500000US34023,34,023,Middlesex County,284174,103196,180978
0500000US34009,34,009,Cape May County,39904,9619,30285
0500000US34039,34,039,Union County,188987,70357,118630
0500000US34019,34,019,Hunterdon County,47180,14082,33098
0500000US35028,35,028,Los Alamos County,7567,2116,5451
0500000US35061,35,061,Valencia County,27489,8488,19001
0500000US35001,35,001,Bernalillo County,265657,76506,189151
0500000US35011,35,011,De Baca County,705,177,528
0500000US35023,35,023,Hidalgo County,1753,510,1243
0500000US35043,35,043,Sandoval County,50340,15800,34540
0500000US35009,35,009,Curry County,18515,6841,11674
0500000US35021,35,021,Harding County,211,18,193
0500000US35045,35,045,San Juan County,43134,15567,27567
0500000US35005,35,005,Chaves County,23169,8537,14632
0500000US35059,35,059,Union County,1381,299,1082
0500000US35041,35,041,Roosevelt County,6993,2237,4756
0500000US36005,36,005,Bronx County,499728,187931,311797
0500000US36035,36,035,Fulton County,22439,6492,15947
0500000US36083,36,083,Rensselaer County,64563,17367,47196
0500000US36043,36,043,Herkimer County,24583,6445,18138
0500000US36089,36,089,St. Lawrence County,41669,12070,29599
0500000US36113,36,113,Warren County,27553,6258,21295
0500000US36027,36,027,Dutchess County,107347,31505,75842
0500000US36055,36,055,Monroe County,300796,83967,216829
0500000US36111,36,111,Ulster County,69539,18001,51538
0500000US36051,36,051,Livingston County,24383,6554,17829
0500000US36039,36,039,Greene County,17117,3854,13263
0500000US36003,36,003,Allegany County,18009,5180,12829
0500000US36009,36,009,Cattaraugus County,31433,8776,22657
0500000US36093,36,093,Schenectady County,53295,13577,39718
0500000US36123,36,123,Yates County,9029,2356,6673
0500000US37087,37,087,Haywood County,26336,6878,19458
0500000US37005,37,005,Alleghany County,4746,1222,3524
0500000US37045,37,045,Cleveland County,36882,10758,26124
0500000US37077,37,077,Granville County,21030,7215,13815
0500000US37093,37,093,Hoke County,17722,7294,10428
0500000US37097,37,097,Iredell County,65246,22300,42946
0500000US37147,37,147,Pitt County,69169,21118,48051
0500000US37039,37,039,Cherokee County,11895,2497,9398
0500000US37193,37,193,Wilkes County,28355,7630,20725
0500000US37003,37,003,Alexander County,13722,4149,9573
0500000US37031,37,031,Carteret County,29690,7431,22259
0500000US37139,37,139,Pasquotank County,14780,4489,10291
0500000US37173,37,173,Swain County,5443,1398,4045
0500000US37007,37,007,Anson County,9516,2453,7063
0500000US37069,37,069,Franklin County,24749,7652,17097
0500000US37113,37,113,Macon County,15699,3532,12167
0500000US37175,37,175,Transylvania County,14123,2944,11179
0500000US37047,37,047,Columbus County,22306,6927,15379
0500000US37123,37,123,Montgomery County,10411,2952,7459
0500000US37153,37,153,Richmond County,18546,5905,12641
0500000US37171,37,171,Surry County,28985,7955,21030
0500000US37021,37,021,Buncombe County,107093,25235,81858
0500000US37025,37,025,Cabarrus County,72299,28068,44231
0500000US37057,37,057,Davidson County,65471,20492,44979
0500000US37091,37,091,Hertford County,8899,2262,6637
0500000US37141,37,141,Pender County,21766,5882,15884
0500000US37189,37,189,Watauga County,20355,3857,16498
0500000US37177,37,177,Tyrrell County,1631,294,1337
0500000US38097,38,097,Traill County,3349,888,2461
0500000US38021,38,021,Dickey County,2170,631,1539
0500000US38101,38,101,Ward County,27564,8004,19560
0500000US38049,38,049,McHenry County,2628,738,1890
0500000US38005,38,005,Benson County,2285,830,1455
0500000US38075,38,075,Renville County,1022,274,748
0500000US38015,38,015,Burleigh County,39495,11810,27685
0500000US38065,38,065,Oliver County,750,195,555
0500000US38071,38,071,Ramsey County,5003,1321,3682
0500000US38039,38,039,Griggs County,1056,243,813
0500000US38083,38,083,Sheridan County,689,141,548
0500000US38103,38,103,Wells County,1960,407,1553
0500000US39099,39,099,Mahoning County,98052,25875,72177
0500000US39145,39,145,Scioto County,30086,9361,20725
0500000US39105,39,105,Meigs County,9193,2652,6541
0500000US39131,39,131,Pike County,10822,3429,7393
0500000US39061,39,061,Hamilton County,339966,96411,243555
0500000US39087,39,087,Lawrence County,23540,6826,16714
0500000US39157,39,157,Tuscarawas County,36817,11028,25789
0500000US39015,39,015,Brown County,17434,5386,12048
0500000US39043,39,043,Erie County,31301,7772,23529
0500000US39089,39,089,Licking County,64016,20865,43151
0500000US39019,39,019,Carroll County,11126,3208,7918
0500000US39025,39,025,Clermont County,77181,24799,52382
0500000US39071,39,071,Highland County,16646,5101,11545
0500000US39133,39,133,Portage County,61993,17304,44689
0500000US39013,39,013,Belmont County,26200,6724,19476
0500000US39127,39,127,Perry County,13547,4646,8901
0500000US48395,48,395,Robertson County,6358,1890,4468
0500000US48441,48,441,Taylor County,49482,16329,33153
0500000US48455,48,455,Trinity County,5918,1325,4593
0500000US48019,48,019,Bandera County,8242,1771,6471
0500000US48079,48,079,Cochran County,996,362,634
0500000US48091,48,091,Comal County,48903,15839,33064
0500000US48225,48,225,Houston County,8209,2266,5943
0500000US48375,48,375,Potter County,43944,15793,28151
0500000US48415,48,415,Scurry County,5884,1923,3961
0500000US48433,48,433,Stonewall County,582,111,471
0500000US48049,48,049,Brown County,14016,4546,9470
0500000US48025,48,025,Bee County,8537,3371,5166
0500000US48103,48,103,Crane County,1422,605,817
0500000US48307,48,307,McCulloch County,3255,974,2281
0500000US48287,48,287,Lee County,6104,1958,4146
0500000US48139,48,139,Ellis County,55840,22665,33175
0500000US48265,48,265,Kerr County,20766,5484,15282
0500000US48145,48,145,Falls County,5237,1390,3847
0500000US19137,19,137,Montgomery County,4587,1379,3208
0500000US19123,19,123,Mahaska County,8829,2879,5950
0500000US19019,19,019,Buchanan County,8046,2478,5568
0500000US19053,19,053,Decatur County,3213,865,2348
0500000US20085,20,085,Jackson County,5392,1555,3837
0500000US20109,20,109,Logan County,1137,327,810
0500000US20209,20,209,Wyandotte County,59983,20998,38985
0500000US20027,20,027,Clay County,3402,1014,2388
0500000US20169,20,169,Saline County,22210,6218,15992
0500000US20197,20,197,Wabaunsee County,2749,836,1913
0500000US20123,20,123,Mitchell County,2616,618,1998
0500000US20005,20,005,Atchison County,5980,1688,4292
0500000US20055,20,055,Finney County,12509,5254,7255
0500000US20103,20,103,Leavenworth County,27060,10029,17031
0500000US20187,20,187,Stanton County,807,189,618
0500000US20119,20,119,Meade County,1675,539,1136
0500000US20151,20,151,Pratt County,3684,1025,2659
0500000US20003,20,003,Anderson County,3069,843,2226
0500000US20061,20,061,Geary County,12754,5566,7188
0500000US20057,20,057,Ford County,11274,4731,6543
0500000US20117,20,117,Marshall County,4112,1053,3059
0500000US20023,20,023,Cheyenne County,1228,280,948
0500000US20035,20,035,Cowley County,13566,4343,9223
0500000US20059,20,059,Franklin County,9982,3065,6917
0500000US20089,20,089,Jewell County,1380,220,1160
0500000US20159,20,159,Rice County,3863,1103,2760
0500000US20017,20,017,Chase County,1029,244,785
0500000US20203,20,203,Wichita County,903,285,618
0500000US20137,20,137,Norton County,1930,593,1337
0500000US20009,20,009,Barton County,10892,3152,7740
0500000US20047,20,047,Edwards County,1302,336,966
0500000US20165,20,165,Rush County,1403,285,1118
0500000US20115,20,115,Marion County,4789,1287,3502
0500000US20143,20,143,Ottawa County,2420,668,1752
0500000US20007,20,007,Barber County,1960,483,1477
0500000US20041,20,041,Dickinson County,7801,2269,5532
0500000US21223,21,223,Trimble County,3604,990,2614
0500000US21105,21,105,Hickman County,1855,392,1463
0500000US21179,21,179,Nelson County,17491,5921,11570
0500000US21081,21,081,Grant County,8849,3358,5491
0500000US21141,21,141,Logan County,10565,3068,7497
0500000US21191,21,191,Pendleton County,5260,1869,3391
0500000US21215,21,215,Spencer County,6709,2597,4112
0500000US21011,21,011,Bath County,4624,1490,3134
0500000US21021,21,021,Boyle County,10984,3339,7645
0500000US21095,21,095,Harlan County,11213,3574,7639
0500000US21137,21,137,Lincoln County,9706,3470,6236
0500000US21171,21,171,Monroe County,4414,1259,3155
0500000US21225,21,225,Union County,5465,1674,3791
0500000US21035,21,035,Calloway County,14641,3874,10767
0500000US21059,21,059,Daviess County,39808,13024,26784
0500000US21101,21,101,Henderson County,18480,5638,12842
0500000US21119,21,119,Knott County,6348,2010,4338
0500000US21177,21,177,Muhlenberg County,11317,3434,7883
0500000US21199,21,199,Pulaski County,25663,7804,17859
0500000US21001,21,001,Adair County,7020,1973,5047
0500000US21057,21,057,Cumberland County,2769,774,1995
0500000US21129,21,129,Lee County,2864,633,2231
0500000US21135,21,135,Lewis County,5435,1642,3793
0500000US21239,21,239,Woodford County,10198,3426,6772
0500000US21113,21,113,Jessamine County,18773,6872,11901
0500000US21133,21,133,Letcher County,9892,3072,6820
0500000US21145,21,145,McCracken County,27841,7278,20563
0500000US21235,21,235,Whitley County,12490,4409,8081
0500000US21071,21,071,Floyd County,15163,4797,10366
0500000US21147,21,147,McCreary County,6203,2038,4165
0500000US21169,21,169,Metcalfe County,3998,1320,2678
0500000US21205,21,205,Rowan County,8505,2584,5921
0500000US21049,21,049,Clark County,14427,4578,9849
0500000US21041,21,041,Carroll County,3981,1403,2578
0500000US21065,21,065,Estill County,5503,1617,3886
0500000US21089,21,089,Greenup County,14057,4360,9697
0500000US21043,21,043,Carter County,9972,3112,6860
0500000US22057,22,057,Lafourche Parish,36449,12486,23963
0500000US22053,22,053,Jefferson Davis Parish,11501,4033,7468
0500000US22125,22,125,West Feliciana Parish,3908,1284,2624
0500000US22011,22,011,Beauregard Parish,13219,4656,8563
0500000US22039,22,039,Evangeline Parish,12051,3970,8081
0500000US22061,22,061,Lincoln Parish,17551,5283,12268
0500000US22119,22,119,Webster Parish,16230,4815,11415
0500000US22047,22,047,Iberville Parish,10918,3434,7484
0500000US22067,22,067,Morehouse Parish,9758,2696,7062
0500000US22109,22,109,Terrebonne Parish,40014,13864,26150
0500000US22027,22,027,Claiborne Parish,5891,1835,4056
0500000US22009,22,009,Avoyelles Parish,15085,5140,9945
0500000US22077,22,077,Pointe Coupee Parish,8961,2389,6572
0500000US22115,22,115,Vernon Parish,17801,6842,10959
0500000US22085,22,085,Sabine Parish,9185,2609,6576
0500000US22059,22,059,LaSalle Parish,5018,1771,3247
0500000US23015,23,015,Lincoln County,15372,3589,11783
0500000US23021,23,021,Piscataquis County,7357,1665,5692
0500000US23029,23,029,Washington County,13806,3371,10435
0500000US23023,23,023,Sagadahoc County,15833,4159,11674
0500000US23011,23,011,Kennebec County,51542,13110,38432
0500000US23009,23,009,Hancock County,23579,5644,17935
0500000US24039,24,039,Somerset County,8383,2464,5919
0500000US24001,24,001,Allegany County,27837,6840,20997
0500000US24033,24,033,Prince George's County,308849,101722,207127
0500000US24021,24,021,Frederick County,91405,32444,58961
0500000US24029,24,029,Kent County,7910,1569,6341
0500000US25027,25,027,Worcester County,307294,95928,211366
0500000US26033,26,033,Chippewa County,14046,3596,10450
0500000US26125,26,125,Oakland County,501260,145273,355987
0500000US26121,26,121,Muskegon County,65619,20778,44841
0500000US26087,26,087,Lapeer County,33320,9743,23577
0500000US26151,26,151,Sanilac County,17179,4567,12612
0500000US26131,26,131,Ontonagon County,2876,374,2502
0500000US26001,26,001,Alcona County,5008,761,4247
0500000US26079,26,079,Kalkaska County,7139,2022,5117
0500000US26129,26,129,Ogemaw County,9296,2171,7125
0500000US26165,26,165,Wexford County,13053,3819,9234
0500000US26043,26,043,Dickinson County,11087,2542,8545
0500000US26065,26,065,Ingham County,112200,28800,83400
0500000US26109,26,109,Menominee County,10665,2410,8255
0500000US26113,26,113,Missaukee County,6027,1661,4366
0500000US26159,26,159,Van Buren County,29013,9261,19752
0500000US26015,26,015,Barry County,23840,7198,16642
0500000US26019,26,019,Benzie County,6733,1431,5302
0500000US26153,26,153,Schoolcraft County,3351,773,2578
0500000US26055,26,055,Grand Traverse County,37134,10109,27025
0500000US26049,26,049,Genesee County,167889,50647,117242
0500000US26093,26,093,Livingston County,71180,22135,49045
0500000US26101,26,101,Manistee County,9591,1870,7721
0500000US26051,26,051,Gladwin County,10999,2485,8514
0500000US05075,05,075,Lawrence County,6531,2056,4475
0500000US05029,05,029,Conway County,8475,2226,6249
0500000US05001,05,001,Arkansas County,7682,2252,5430
0500000US05085,05,085,Lonoke County,26868,10526,16342
0500000US06047,06,047,Merced County,79606,36189,43417
0500000US06049,06,049,Modoc County,3660,830,2830
0500000US06027,06,027,Inyo County,8083,1600,6483
0500000US06099,06,099,Stanislaus County,172682,70808,101874
0500000US06103,06,103,Tehama County,24025,7572,16453
0500000US06069,06,069,San Benito County,17740,7626,10114
0500000US06017,06,017,El Dorado County,69172,19444,49728
0500000US06075,06,075,San Francisco County,359673,67394,292279
0500000US06107,06,107,Tulare County,136106,62109,73997
0500000US06057,06,057,Nevada County,40904,9289,31615
0500000US06039,06,039,Madera County,44759,18911,25848
0500000US06105,06,105,Trinity County,5796,1198,4598
0500000US06071,06,071,San Bernardino County,630633,268443,362190
0500000US06061,06,061,Placer County,140661,44991,95670
0500000US06095,06,095,Solano County,149067,52536,96531
0500000US06011,06,011,Colusa County,7113,2977,4136
0500000US06031,06,031,Kings County,42735,20028,22707
0500000US06019,06,019,Fresno County,304624,125525,179099
0500000US06111,06,111,Ventura County,271226,95920,175306
0500000US08123,08,123,Weld County,102101,39787,62314
0500000US08027,08,027,Custer County,2083,290,1793
0500000US08035,08,035,Douglas County,117426,49209,68217
0500000US08067,08,067,La Plata County,21793,5395,16398
0500000US08105,08,105,Rio Grande County,4504,1347,3157
0500000US08011,08,011,Bent County,1744,614,1130
0500000US08111,08,111,San Juan County,266,32,234
0500000US08075,08,075,Logan County,8183,2163,6020
0500000US08119,08,119,Teller County,10183,2363,7820
0500000US08039,08,039,Elbert County,9046,2742,6304
0500000US08073,08,073,Lincoln County,1520,304,1216
0500000US08003,08,003,Alamosa County,6153,1769,4384
0500000US08043,08,043,Fremont County,17163,4158,13005
0500000US08085,08,085,Montrose County,17125,4449,12676
0500000US08109,08,109,Saguache County,2645,554,2091
0500000US08053,08,053,Hinsdale County,387,65,322
0500000US08049,08,049,Grand County,5823,1039,4784
0500000US08089,08,089,Otero County,7691,2424,5267
0500000US09005,09,005,Litchfield County,73987,19174,54813
0500000US09011,09,011,New London County,107402,30996,76406
0500000US09001,09,001,Fairfield County,340491,117169,223322
0500000US10001,10,001,Kent County,64545,21250,43295
0500000US12057,12,057,Hillsborough County,516478,160791,355687
0500000US12129,12,129,Wakulla County,11068,3645,7423
0500000US12045,12,045,Gulf County,5359,1498,3861
0500000US12097,12,097,Osceola County,99158,37266,61892
0500000US12131,12,131,Walton County,26432,6776,19656
0500000US12065,12,065,Jefferson County,5771,1356,4415
0500000US12049,12,049,Hardee County,7772,2754,5018
0500000US12093,12,093,Okeechobee County,13759,4209,9550
0500000US12041,12,041,Gilchrist County,6511,1744,4767
0500000US12001,12,001,Alachua County,97048,21671,75377
0500000US12015,12,015,Charlotte County,76150,10963,65187
0500000US12085,12,085,Martin County,63865,12684,51181
0500000US12115,12,115,Sarasota County,180551,31083,149468
0500000US12017,12,017,Citrus County,62762,10744,52018
0500000US12113,12,113,Santa Rosa County,61345,21282,40063
0500000US12011,12,011,Broward County,682088,207100,474988
0500000US12087,12,087,Monroe County,30982,5954,25028
0500000US13313,13,313,Whitfield County,36043,14036,22007
0500000US13285,13,285,Troup County,24843,8815,16028
0500000US13145,13,145,Harris County,12158,4334,7824
0500000US13321,13,321,Worth County,8038,2466,5572
0500000US13109,13,109,Evans County,4006,1408,2598
0500000US13307,13,307,Webster County,1101,350,751
0500000US13125,13,125,Glascock County,1105,271,834
0500000US13051,13,051,Chatham County,108151,31974,76177
0500000US13173,13,173,Lanier County,3724,1265,2459
0500000US13195,13,195,Madison County,10712,3633,7079
0500000US13147,13,147,Hart County,10019,3050,6969
0500000US13191,13,191,McIntosh County,6033,1638,4395
0500000US13237,13,237,Putnam County,8660,1878,6782
0500000US13301,13,301,Warren County,2332,586,1746
0500000US13029,13,029,Bryan County,12636,6052,6584
0500000US13039,13,039,Camden County,19327,7235,12092
0500000US13099,13,099,Early County,4082,1291,2791
0500000US13069,13,069,Coffee County,14298,4716,9582
0500000US13123,13,123,Gilmer County,11645,2796,8849
0500000US13317,13,317,Wilkes County,3879,949,2930
0500000US13129,13,129,Gordon County,20294,7858,12436
0500000US13057,13,057,Cherokee County,85825,32486,53339
0500000US13177,13,177,Lee County,10354,4212,6142
0500000US13133,13,133,Greene County,7004,1520,5484
0500000US13075,13,075,Cook County,6233,2136,4097
0500000US13121,13,121,Fulton County,400016,113673,286343
0500000US13187,13,187,Lumpkin County,11649,3311,8338
0500000US13201,13,201,Miller County,2300,690,1610
0500000US13219,13,219,Oconee County,13093,5621,7472
0500000US13151,13,151,Henry County,73826,30099,43727
0500000US13183,13,183,Long County,5601,2579,3022
0500000US13257,13,257,Stephens County,9468,2941,6527
0500000US13293,13,293,Upson County,10204,2708,7496
0500000US13225,13,225,Peach County,10103,3205,6898
0500000US13229,13,229,Pierce County,7072,2556,4516
0500000US13251,13,251,Screven County,5257,1531,3726
0500000US13011,13,011,Banks County,6603,2160,4443
0500000US13061,13,061,Clay County,1202,270,932
0500000US13089,13,089,DeKalb County,277757,84645,193112
0500000US13157,13,157,Jackson County,22034,8325,13709
0500000US13181,13,181,Lincoln County,3424,819,2605
0500000US13235,13,235,Pulaski County,3817,1187,2630
0500000US13281,13,281,Towns County,4777,852,3925
0500000US13287,13,287,Turner County,3023,1034,1989
0500000US13001,13,001,Appling County,6682,2227,4455
0500000US16077,16,077,Power County,2581,859,1722
0500000US16071,16,071,Oneida County,1585,527,1058
0500000US16063,16,063,Lincoln County,1687,683,1004
0500000US16041,16,041,Franklin County,4294,1684,2610
0500000US16053,16,053,Jerome County,7828,3053,4775
0500000US16067,16,067,Minidoka County,7279,2812,4467
0500000US16013,16,013,Blaine County,8190,2206,5984
0500000US16021,16,021,Boundary County,4605,1269,3336
0500000US16047,16,047,Gooding County,5419,1944,3475
0500000US16007,16,007,Bear Lake County,2350,730,1620
0500000US16019,16,019,Bonneville County,39000,15131,23869
0500000US16035,16,035,Clearwater County,3707,675,3032
0500000US16059,16,059,Lemhi County,3549,637,2912
0500000US16017,16,017,Bonner County,17584,4480,13104
0500000US16037,16,037,Custer County,1761,340,1421
0500000US16065,16,065,Madison County,10625,4162,6463
0500000US16081,16,081,Teton County,3736,1411,2325
0500000US15003,15,003,Honolulu County,311525,103622,207903
0500000US17183,17,183,Vermilion County,31180,9157,22023
0500000US17023,17,023,Clark County,6774,2054,4720
0500000US17049,17,049,Effingham County,13555,4137,9418
0500000US17065,17,065,Hamilton County,3376,926,2450
0500000US17087,17,087,Johnson County,4342,1123,3219
0500000US17105,17,105,Livingston County,14320,4455,9865
0500000US17179,17,179,Tazewell County,54613,16412,38201
0500000US17187,17,187,Warren County,6690,1905,4785
0500000US17119,17,119,Madison County,107413,32454,74959
0500000US17131,17,131,Mercer County,6624,1911,4713
0500000US17003,17,003,Alexander County,2323,557,1766
0500000US17157,17,157,Randolph County,11873,3171,8702
0500000US17115,17,115,Macon County,44113,11685,32428
0500000US17191,17,191,Wayne County,7075,1925,5150
0500000US17055,17,055,Franklin County,16135,4381,11754
0500000US17109,17,109,McDonough County,11292,2634,8658
0500000US17139,17,139,Moultrie County,5910,1833,4077
0500000US17151,17,151,Pope County,1644,284,1360
0500000US17173,17,173,Shelby County,9203,2511,6692
0500000US17019,17,019,Champaign County,82499,20134,62365
0500000US17053,17,053,Ford County,5779,1738,4041
0500000US17093,17,093,Kendall County,40407,17874,22533
0500000US17121,17,121,Marion County,15913,4618,11295
0500000US17125,17,125,Mason County,6027,1731,4296
0500000US18149,18,149,Starke County,8735,2661,6074
0500000US18055,18,055,Greene County,12790,3971,8819
0500000US18177,18,177,Wayne County,26611,8070,18541
0500000US18037,18,037,Dubois County,16550,5139,11411
0500000US18059,18,059,Hancock County,28215,9631,18584
0500000US18115,18,115,Ohio County,2513,717,1796
0500000US18121,18,121,Parke County,6145,1590,4555
0500000US18007,18,007,Benton County,3403,1069,2334
0500000US18133,18,133,Putnam County,13439,4058,9381
0500000US18175,18,175,Washington County,10721,3434,7287
0500000US18065,18,065,Henry County,18408,5302,13106
0500000US18095,18,095,Madison County,51422,16116,35306
0500000US18125,18,125,Pike County,5129,1391,3738
0500000US18151,18,151,Steuben County,14156,4082,10074
0500000US18179,18,179,Wells County,10874,3417,7457
0500000US18035,18,035,Delaware County,46028,11968,34060
0500000US18077,18,077,Jefferson County,12759,4033,8726
0500000US18103,18,103,Miami County,13707,4188,9519
0500000US18111,18,111,Newton County,5562,1583,3979
0500000US18141,18,141,St. Joseph County,101241,30701,70540
0500000US18155,18,155,Switzerland County,4297,1449,2848
0500000US18015,18,015,Carroll County,7880,2349,5531
0500000US18069,18,069,Huntington County,14754,4231,10523
0500000US18181,18,181,White County,9745,2878,6867
0500000US18075,18,075,Jay County,8149,2655,5494
0500000US18019,18,019,Clark County,44275,13321,30954
0500000US19101,19,101,Jefferson County,6831,1508,5323
0500000US19005,19,005,Allamakee County,5957,1587,4370
0500000US19049,19,049,Dallas County,32886,13253,19633
0500000US19023,19,023,Butler County,6251,1659,4592
0500000US19071,19,071,Fremont County,2990,798,2192
0500000US19173,19,173,Taylor County,2650,668,1982
0500000US19195,19,195,Worth County,3170,910,2260
0500000US19003,19,003,Adams County,1641,400,1241
0500000US19037,19,037,Chickasaw County,5191,1393,3798
0500000US19059,19,059,Dickinson County,8069,1989,6080
0500000US19103,19,103,Johnson County,58163,15473,42690
0500000US19171,19,171,Tama County,6755,1997,4758
0500000US19069,19,069,Franklin County,4200,1228,2972
0500000US19027,19,027,Carroll County,8674,2327,6347
0500000US19067,19,067,Floyd County,6759,1711,5048
0500000US19115,19,115,Louisa County,4343,1375,2968
0500000US19119,19,119,Lyon County,4549,1659,2890
0500000US19165,19,165,Shelby County,5046,1302,3744
0500000US19087,19,087,Henry County,7714,2448,5266
0500000US19145,19,145,Page County,6323,1598,4725
0500000US19155,19,155,Pottawattamie County,36881,11020,25861
0500000US19043,19,043,Clayton County,7652,1813,5839
0500000US19021,19,021,Buena Vista County,7550,2671,4879
0500000US19077,19,077,Guthrie County,4397,1223,3174
0500000US19091,19,091,Humboldt County,4221,1042,3179
0500000US19183,19,183,Washington County,8720,2746,5974
