geo_id,state_id,county_id,county_name,employment_16_and_over_in_labor_force,employment_employed,employment_unemployed,employment_not_in_labor_force,employment_unemployment_rate
0500000US28151,28,151,Washington County,20174,17133,3041,15909,15.1
0500000US28111,28,111,Perry County,4928,4591,337,4557,6.8
0500000US28019,28,019,Choctaw County,3398,3097,301,3316,8.9
0500000US28057,28,057,Itawamba County,9923,9509,414,9026,4.2
0500000US28015,28,015,Carroll County,3843,3466,377,4561,9.8
0500000US28043,28,043,Grenada County,8958,8341,617,7924,6.9
0500000US28063,28,063,Jefferson County,2017,1865,152,3813,7.5
0500000US28041,28,041,Greene County,4297,3903,394,7073,9.2
0500000US28093,28,093,Marshall County,15249,14243,1006,13489,6.6
0500000US28119,28,119,Quitman County,3074,2280,794,2754,25.8
0500000US28011,28,011,Bolivar County,12061,10794,1267,13266,10.5
0500000US28073,28,073,Lamar County,30658,27694,2964,16495,9.7
0500000US28081,28,081,Lee County,40839,38207,2632,24535,6.4
0500000US28113,28,113,Pike County,15033,13927,1106,15520,7.4
0500000US28135,28,135,Tallahatchie County,4467,3833,634,7386,14.2
0500000US28129,28,129,Smith County,6795,6563,232,5798,3.4
0500000US28131,28,131,Stone County,8275,7874,401,6570,4.8
0500000US28149,28,149,Warren County,20877,19368,1509,15892,7.2
0500000US28023,28,023,Clarke County,6901,6337,564,5832,8.2
0500000US28069,28,069,Kemper County,3759,3499,260,4708,6.9
0500000US28097,28,097,Montgomery County,4331,3886,445,3764,10.3
0500000US28105,28,105,Oktibbeha County,23131,20852,2279,18521,9.9
0500000US28109,28,109,Pearl River County,23587,21599,1988,20515,8.4
0500000US28079,28,079,Leake County,9574,8521,1053,8069,11.0
0500000US28103,28,103,Noxubee County,4500,4046,454,3947,10.1
0500000US28099,28,099,Neshoba County,13154,12025,1129,8978,8.6
0500000US28121,28,121,Rankin County,76671,73418,3253,42739,4.2
0500000US28137,28,137,Tate County,12999,12012,987,9690,7.6
0500000US28077,28,077,Lawrence County,5176,4716,460,4669,8.9
0500000US28107,28,107,Panola County,13685,12702,983,12734,7.2
0500000US28161,28,161,Yalobusha County,5695,5442,253,4250,4.4
0500000US28017,28,017,Chickasaw County,7140,6729,411,6369,5.8
0500000US28029,28,029,Copiah County,11773,10523,1250,10922,10.6
0500000US28039,28,039,George County,9109,8266,843,9164,9.3
0500000US28049,28,049,Hinds County,116675,105648,11027,72082,9.5
0500000US28101,28,101,Newton County,8862,8250,612,7803,6.9
0500000US28145,28,145,Union County,12941,12120,821,9074,6.3
0500000US28125,28,125,Sharkey County,1784,1489,295,1758,16.5
0500000US28139,28,139,Tippah County,9596,8853,743,7464,7.7
0500000US28035,28,035,Forrest County,35925,32291,3634,23608,10.1
0500000US28045,28,045,Hancock County,20719,19029,1690,17078,8.2
0500000US28071,28,071,Lafayette County,26241,24456,1785,18457,6.8
0500000US28055,28,055,Issaquena County,415,358,57,722,13.7
0500000US28087,28,087,Lowndes County,26472,24037,2435,19344,9.2
0500000US28083,28,083,Leflore County,10343,9178,1165,12084,11.3
0500000US28157,28,157,Wilkinson County,2771,2468,303,4542,10.9
0500000US28047,28,047,Harrison County,93114,84189,8925,59407,9.6
0500000US28065,28,065,Jefferson Davis County,4659,4200,459,4810,9.9
0500000US28085,28,085,Lincoln County,13875,12850,1025,13248,7.4
0500000US28123,28,123,Scott County,12338,11360,978,9382,7.9
0500000US28159,28,159,Winston County,7825,7181,644,6751,8.2
0500000US28163,28,163,Yazoo County,9535,8109,1426,12449,15.0
0500000US28009,28,009,Benton County,3190,2917,273,3525,8.6
0500000US28037,28,037,Franklin County,2913,2727,186,3096,6.4
0500000US28061,28,061,Jasper County,6779,6375,404,6322,6.0
0500000US28067,28,067,Jones County,29765,27855,1910,23143,6.4
0500000US28095,28,095,Monroe County,15355,14371,984,13105,6.4
0500000US28133,28,133,Sunflower County,9735,8173,1562,11398,16.0
0500000US28155,28,155,Webster County,3940,3740,200,3760,5.1
0500000US28001,28,001,Adams County,11585,10424,1161,14046,10.0
0500000US28025,28,025,Clay County,8511,7546,965,7276,11.3
0500000US28031,28,031,Covington County,8089,7289,800,6741,9.9
0500000US28053,28,053,Humphreys County,3429,2797,632,3103,18.4
0500000US29123,29,123,Madison County,5252,5035,217,4431,4.1
0500000US29229,29,229,Wright County,7273,6688,585,6934,8.0
0500000US29217,29,217,Vernon County,9891,9527,364,6360,3.7
0500000US29195,29,195,Saline County,10955,10523,432,7465,3.9
0500000US29147,29,147,Nodaway County,11505,11062,443,7788,3.9
0500000US29041,29,041,Chariton County,3264,3158,106,2767,3.2
0500000US29079,29,079,Grundy County,4758,4590,168,3181,3.5
0500000US29141,29,141,Morgan County,7660,7368,292,8373,3.8
0500000US29223,29,223,Wayne County,4656,4236,420,6199,9.0
0500000US29017,29,017,Bollinger County,5295,5059,236,4661,4.5
0500000US29031,29,031,Cape Girardeau County,39668,37627,2041,23418,5.1
0500000US29205,29,205,Shelby County,3050,2945,105,1725,3.4
0500000US29225,29,225,Webster County,16301,15534,767,12404,4.7
0500000US29005,29,005,Atchison County,2739,2649,90,1627,3.3
0500000US29013,29,013,Bates County,7962,7612,350,4962,4.4
0500000US29015,29,015,Benton County,7162,6573,589,8989,8.2
0500000US29035,29,035,Carter County,2619,2433,186,2214,7.1
0500000US29057,29,057,Dade County,3397,3106,291,2872,8.6
0500000US29115,29,115,Linn County,5653,5496,157,3927,2.8
0500000US29091,29,091,Howell County,17406,16617,789,14309,4.5
0500000US29101,29,101,Johnson County,25580,24266,1314,14611,5.1
0500000US29105,29,105,Laclede County,16115,15006,1109,11466,6.9
0500000US29125,29,125,Maries County,3951,3677,274,3250,6.9
0500000US29161,29,161,Phelps County,20252,19026,1226,16220,6.1
0500000US29165,29,165,Platte County,54731,52703,2028,22855,3.7
0500000US29187,29,187,St. Francois County,28621,26991,1630,25438,5.7
0500000US29003,29,003,Andrew County,8752,8476,276,5211,3.2
0500000US29033,29,033,Carroll County,4045,3699,346,3000,8.6
0500000US29061,29,061,Daviess County,3625,3510,115,2800,3.2
0500000US29103,29,103,Knox County,1688,1575,113,1448,6.7
0500000US29127,29,127,Marion County,13802,13090,712,8706,5.2
0500000US29151,29,151,Osage County,7165,6991,174,3635,2.4
0500000US29181,29,181,Ripley County,5503,5129,374,5354,6.8
0500000US29219,29,219,Warren County,15871,14974,897,10698,5.7
0500000US29007,29,007,Audrain County,11578,10751,827,8877,7.1
0500000US29043,29,043,Christian County,41792,40014,1778,23362,4.3
0500000US29077,29,077,Greene County,144534,138126,6408,89815,4.4
0500000US29081,29,081,Harrison County,3947,3769,178,2751,4.5
0500000US29185,29,185,St. Clair County,3746,3592,154,3995,4.1
0500000US29001,29,001,Adair County,11578,10827,751,9769,6.5
0500000US29199,29,199,Scotland County,2202,2092,110,1452,5.0
0500000US29211,29,211,Sullivan County,2732,2648,84,2287,3.1
0500000US29045,29,045,Clark County,3390,3267,123,1986,3.6
0500000US29099,29,099,Jefferson County,117062,110438,6624,59467,5.7
0500000US29111,29,111,Lewis County,4760,4637,123,3248,2.6
0500000US29143,29,143,New Madrid County,7251,6622,629,6858,8.7
0500000US29157,29,157,Perry County,9540,9181,359,5514,3.8
0500000US29173,29,173,Ralls County,5240,5006,234,3029,4.5
0500000US29177,29,177,Ray County,11308,10745,563,6964,5.0
0500000US29189,29,189,St. Louis County,524576,497435,27141,279075,5.2
0500000US29209,29,209,Stone County,12954,12088,866,14113,6.7
0500000US29009,29,009,Barry County,15311,14590,721,13285,4.7
0500000US29019,29,019,Boone County,97537,93375,4162,46968,4.3
0500000US29039,29,039,Cedar County,5763,5243,520,5232,9.0
0500000US29055,29,055,Crawford County,10501,9443,1058,8761,10.1
0500000US29093,29,093,Iron County,4186,3884,302,4161,7.2
0500000US29117,29,117,Livingston County,6759,6605,154,5391,2.3
0500000US29135,29,135,Moniteau County,6992,6627,365,5368,5.2
0500000US29149,29,149,Oregon County,4220,4095,125,4378,3.0
0500000US29159,29,159,Pettis County,19782,18609,1173,13206,5.9
0500000US29186,29,186,Ste. Genevieve County,9156,8758,398,5315,4.3
0500000US29175,29,175,Randolph County,10887,10263,624,9191,5.7
0500000US29069,29,069,Dunklin County,12276,11346,930,11198,7.6
0500000US29071,29,071,Franklin County,52534,50288,2246,29252,4.3
0500000US29089,29,089,Howard County,4932,4727,205,3153,4.2
0500000US29095,29,095,Jackson County,362029,343721,18308,182392,5.1
0500000US29131,29,131,Miller County,11497,10823,674,8281,5.9
0500000US29169,29,169,Pulaski County,17940,16357,1583,12618,8.8
0500000US29171,29,171,Putnam County,2083,1981,102,1763,4.9
0500000US29213,29,213,Taney County,26131,24618,1513,18357,5.8
0500000US29215,29,215,Texas County,9565,8695,870,11146,9.1
0500000US29021,29,021,Buchanan County,44179,41913,2266,26575,5.1
0500000US29025,29,025,Caldwell County,3974,3874,100,3144,2.5
0500000US29027,29,027,Callaway County,21126,20425,701,15436,3.3
0500000US29037,29,037,Cass County,52942,50661,2281,27205,4.3
0500000US29049,29,049,Clinton County,9918,9424,494,6371,5.0
0500000US29053,29,053,Cooper County,8047,7669,378,6161,4.7
0500000US29059,29,059,Dallas County,6532,6197,335,6430,5.1
0500000US29075,29,075,Gentry County,3138,3026,112,2054,3.6
0500000US29085,29,085,Hickory County,3486,3258,228,4515,6.5
0500000US29113,29,113,Lincoln County,27492,26349,1143,15541,4.2
0500000US29133,29,133,Mississippi County,5028,4654,374,6032,7.4
0500000US29137,29,137,Monroe County,4036,3879,157,2912,3.9
0500000US29145,29,145,Newton County,27955,26841,1114,17864,4.0
0500000US29153,29,153,Ozark County,3380,3139,241,4283,7.1
0500000US29163,29,163,Pike County,7897,7540,357,7069,4.5
0500000US29183,29,183,St. Charles County,215715,208527,7188,91854,3.3
0500000US30017,30,017,Custer County,6596,6463,133,3018,2.0
0500000US30041,30,041,Hill County,7653,7171,482,4741,6.3
0500000US30075,30,075,Powder River County,978,965,13,442,1.3
0500000US30067,30,067,Park County,8569,8327,242,5032,2.8
0500000US30085,30,085,Roosevelt County,4412,3884,528,3492,12.0
0500000US30005,30,005,Blaine County,3039,2577,462,1880,15.2
0500000US30051,30,051,Liberty County,1132,1126,6,707,0.5
0500000US30083,30,083,Richland County,6241,6090,151,2736,2.4
0500000US30099,30,099,Teton County,2711,2661,50,2061,1.8
0500000US30101,30,101,Toole County,2200,2181,19,1913,0.9
0500000US30025,30,025,Fallon County,1565,1530,35,674,2.2
0500000US30019,30,019,Daniels County,890,876,14,555,1.6
0500000US30045,30,045,Judith Basin County,1017,984,33,652,3.2
0500000US30093,30,093,Silver Bow County,17258,16396,862,11243,5.0
0500000US30023,30,023,Deer Lodge County,3782,3667,115,4157,3.0
0500000US30043,30,043,Jefferson County,5675,5400,275,4002,4.8
0500000US30055,30,055,McCone County,785,783,2,525,0.3
0500000US30107,30,107,Wheatland County,1009,975,34,665,3.4
0500000US30087,30,087,Rosebud County,4216,3883,333,2704,7.9
0500000US30011,30,011,Carter County,657,643,14,418,2.1
0500000US30021,30,021,Dawson County,5002,4928,74,2422,1.5
0500000US30007,30,007,Broadwater County,2862,2686,176,2003,6.1
0500000US30047,30,047,Lake County,13094,12300,794,10276,6.1
0500000US30073,30,073,Pondera County,2750,2560,190,1928,6.9
0500000US30111,30,111,Yellowstone County,83603,80736,2867,40595,3.4
0500000US30081,30,081,Ravalli County,19140,18010,1130,15449,5.9
0500000US30105,30,105,Valley County,4033,3808,225,2080,5.6
0500000US30027,30,027,Fergus County,5872,5735,137,3329,2.3
0500000US30061,30,061,Mineral County,1698,1583,115,1857,6.8
0500000US30069,30,069,Petroleum County,235,228,7,121,3.0
0500000US30089,30,089,Sanders County,4422,4049,373,5230,8.4
0500000US30109,30,109,Wibaux County,579,567,12,301,2.1
0500000US30059,30,059,Meagher County,997,980,17,627,1.7
0500000US30009,30,009,Carbon County,5408,5208,200,3447,3.7
0500000US30029,30,029,Flathead County,49187,47354,1833,29575,3.7
0500000US30071,30,071,Phillips County,1850,1723,127,1391,6.9
0500000US31001,31,001,Adams County,16491,15946,545,8494,3.3
0500000US31109,31,109,Lancaster County,175535,169556,5979,69937,3.4
0500000US31011,31,011,Boone County,2911,2862,49,1310,1.7
0500000US31149,31,149,Rock County,755,752,3,381,0.4
0500000US31007,31,007,Banner County,410,405,5,149,1.2
0500000US31163,31,163,Sherman County,1564,1536,28,929,1.8
0500000US31147,31,147,Richardson County,4152,4010,142,2387,3.4
0500000US31093,31,093,Howard County,3443,3331,112,1580,3.3
0500000US31089,31,089,Holt County,5717,5655,62,2227,1.1
0500000US31065,31,065,Furnas County,2436,2384,52,1434,2.1
0500000US31073,31,073,Gosper County,1134,1101,33,543,2.9
0500000US31151,31,151,Saline County,7311,7085,226,3706,3.1
0500000US31153,31,153,Sarpy County,96860,93923,2937,33740,3.0
0500000US31173,31,173,Thurston County,3100,2635,465,1756,15.0
0500000US31177,31,177,Washington County,10634,10380,254,5264,2.4
0500000US31015,31,015,Boyd County,1017,1002,15,654,1.5
0500000US31031,31,031,Cherry County,3225,3173,52,1451,1.6
0500000US31053,31,053,Dodge County,19631,18723,908,9195,4.6
0500000US31059,31,059,Fillmore County,2870,2811,59,1716,2.1
0500000US31069,31,069,Garden County,877,865,12,641,1.4
0500000US31091,31,091,Hooker County,283,282,1,312,0.4
0500000US31123,31,123,Morrill County,2522,2382,140,1284,5.6
0500000US31127,31,127,Nemaha County,3560,3401,159,2160,4.5
0500000US31159,31,159,Seward County,9137,8947,190,4434,2.1
0500000US31171,31,171,Thomas County,362,356,6,164,1.7
0500000US31043,31,043,Dakota County,10857,10275,582,4142,5.4
0500000US31181,31,181,Webster County,1776,1734,42,1040,2.4
0500000US31003,31,003,Antelope County,3297,3232,65,1777,2.0
0500000US31023,31,023,Butler County,4323,4187,136,2114,3.1
0500000US31035,31,035,Clay County,3135,3023,112,1753,3.6
0500000US31041,31,041,Custer County,5682,5517,165,2881,2.9
0500000US31067,31,067,Gage County,11399,11016,383,5942,3.4
0500000US31081,31,081,Hamilton County,5003,4880,123,2293,2.5
0500000US31099,31,099,Kearney County,3520,3420,100,1605,2.8
0500000US31101,31,101,Keith County,4302,4142,160,2356,3.7
0500000US31119,31,119,Madison County,19096,18521,575,7984,3.0
0500000US31135,31,135,Perkins County,1514,1497,17,752,1.1
0500000US31155,31,155,Saunders County,11206,10935,271,5152,2.4
0500000US31179,31,179,Wayne County,5569,5464,105,2142,1.9
0500000US31103,31,103,Keya Paha County,457,457,0,182,0.0
0500000US31107,31,107,Knox County,4388,4249,139,2323,3.2
0500000US31111,31,111,Lincoln County,17725,17242,483,10068,2.7
0500000US31139,31,139,Pierce County,3878,3787,91,1729,2.3
0500000US31165,31,165,Sioux County,665,658,7,343,1.1
0500000US31025,31,025,Cass County,13630,13225,405,6396,3.0
0500000US31051,31,051,Dixon County,3041,2941,100,1423,3.3
0500000US31057,31,057,Dundy County,954,939,15,571,1.6
0500000US31077,31,077,Greeley County,1207,1190,17,708,1.4
0500000US31079,31,079,Hall County,32894,31413,1481,13469,4.5
0500000US31131,31,131,Otoe County,8457,8223,234,4028,2.8
0500000US31145,31,145,Red Willow County,5915,5727,188,2772,3.2
0500000US31045,31,045,Dawes County,4643,4587,56,2861,1.2
0500000US31033,31,033,Cheyenne County,5507,5354,153,2225,2.8
0500000US31047,31,047,Dawson County,12665,12194,471,5407,3.7
0500000US31117,31,117,McPherson County,222,222,0,142,0.0
0500000US31125,31,125,Nance County,1820,1760,60,1034,3.3
0500000US31167,31,167,Stanton County,3286,3191,95,1350,2.9
0500000US31175,31,175,Valley County,2253,2214,39,1115,1.7
0500000US31083,31,083,Harlan County,1670,1646,24,1102,1.4
0500000US31009,31,009,Blaine County,264,264,0,119,0.0
0500000US31019,31,019,Buffalo County,28541,27694,847,10174,3.0
0500000US31049,31,049,Deuel County,975,928,47,560,4.8
0500000US31087,31,087,Hitchcock County,1371,1315,56,905,4.1
0500000US31141,31,141,Platte County,18424,17724,700,7094,3.8
0500000US31169,31,169,Thayer County,2635,2607,28,1446,1.1
0500000US31013,31,013,Box Butte County,5622,5332,290,2974,5.2
0500000US32001,32,001,Churchill County,10042,9320,722,8213,7.2
0500000US32005,32,005,Douglas County,22070,20933,1137,18440,5.2
0500000US32027,32,027,Pershing County,2174,2022,152,3482,7.0
0500000US32009,32,009,Esmeralda County,395,388,7,399,1.8
0500000US32013,32,013,Humboldt County,9016,8539,477,3734,5.3
0500000US32021,32,021,Mineral County,2032,1732,300,1723,14.8
0500000US32033,32,033,White Pine County,3802,3656,146,4105,3.8
0500000US32007,32,007,Elko County,27415,26171,1244,11970,4.5
0500000US32017,32,017,Lincoln County,1994,1782,212,2440,10.6
0500000US32023,32,023,Nye County,16289,14762,1527,20796,9.4
0500000US32029,32,029,Storey County,1739,1664,75,1649,4.3
0500000US32031,32,031,Washoe County,239148,225689,13459,122861,5.6
0500000US32003,32,003,Clark County,1081607,1003320,78287,604133,7.2
0500000US32510,32,510,Carson City,26752,25098,1654,17877,6.2
0500000US32019,32,019,Lyon County,24052,21969,2083,18803,8.7
0500000US33005,33,005,Cheshire County,41752,40161,1591,22412,3.8
0500000US33013,33,013,Merrimack County,82049,78874,3175,41780,3.9
0500000US33009,33,009,Grafton County,48331,46707,1624,28428,3.4
0500000US33015,33,015,Rockingham County,179920,173214,6706,71659,3.7
0500000US33001,33,001,Belknap County,32457,30946,1511,18213,4.7
0500000US33019,33,019,Sullivan County,22141,21315,826,13603,3.7
0500000US33011,33,011,Hillsborough County,234955,224741,10214,100384,4.3
0500000US33017,33,017,Strafford County,72862,69879,2983,33465,4.1
0500000US33007,33,007,Coos County,15413,14544,869,11972,5.6
0500000US33003,33,003,Carroll County,24529,23636,893,16662,3.6
0500000US34025,34,025,Monmouth County,333155,315831,17324,172609,5.2
0500000US34037,34,037,Sussex County,80037,75439,4598,37189,5.7
0500000US34011,34,011,Cumberland County,67856,62928,4928,53300,7.3
0500000US34013,34,013,Essex County,411521,373790,37731,213359,9.2
0500000US34029,34,029,Ocean County,272412,256360,16052,193130,5.9
0500000US34015,34,015,Gloucester County,157619,147707,9912,76051,6.3
0500000US34033,34,033,Salem County,31676,29352,2324,19631,7.3
0500000US34031,34,031,Passaic County,251492,238879,12613,144713,5.0
0500000US34007,34,007,Camden County,266385,247509,18876,137378,7.1
0500000US34003,34,003,Bergen County,498438,476034,22404,257002,4.5
0500000US34041,34,041,Warren County,58887,55187,3700,28768,6.3
0500000US34017,34,017,Hudson County,375081,352378,22703,168957,6.1
0500000US34005,34,005,Burlington County,237787,222818,14969,120796,6.3
0500000US34027,34,027,Morris County,274418,261479,12939,127279,4.7
0500000US35039,35,039,Rio Arriba County,-888888888,-888888888,-888888888,-888888888,-888888888.0
0500000US35047,35,047,San Miguel County,10375,9714,661,13064,6.4
0500000US35057,35,057,Torrance County,6028,5712,316,6738,5.2
0500000US35035,35,035,Otero County,25921,23841,2080,23596,8.0
0500000US35006,35,006,Cibola County,11273,9537,1736,10142,15.4
0500000US35019,35,019,Guadalupe County,1399,1311,88,2292,6.3
0500000US35003,35,003,Catron County,842,842,0,2348,0.0
0500000US35029,35,029,Luna County,8703,7658,1045,9781,12.0
0500000US35031,35,031,McKinley County,28025,23614,4411,25913,15.7
0500000US35055,35,055,Taos County,14923,13666,1257,12545,8.4
0500000US35017,35,017,Grant County,11332,10473,859,11439,7.6
0500000US35007,35,007,Colfax County,5223,4737,486,5064,9.3
0500000US35015,35,015,Eddy County,27243,26013,1230,16575,4.5
0500000US35033,35,033,Mora County,1510,1399,111,2241,7.4
0500000US35037,35,037,Quay County,3032,2846,186,3570,6.1
0500000US35027,35,027,Lincoln County,7291,6979,312,9202,4.3
0500000US35025,35,025,Lea County,30645,28674,1971,20425,6.4
0500000US35049,35,049,Santa Fe County,73951,70648,3303,50490,4.5
0500000US35051,35,051,Sierra County,4063,3619,444,5470,10.9
0500000US35053,35,053,Socorro County,5857,5579,278,7533,4.7
0500000US35013,35,013,Do�a Ana County,96502,88450,8052,70281,8.3
0500000US36095,36,095,Schoharie County,15380,14488,892,11118,5.8
0500000US36067,36,067,Onondaga County,234997,220979,14018,140863,6.0
0500000US36019,36,019,Clinton County,37869,36060,1809,30016,4.8
0500000US36099,36,099,Seneca County,16136,15571,565,12422,3.5
0500000US36079,36,079,Putnam County,53932,51066,2866,27789,5.3
0500000US36033,36,033,Franklin County,21748,20209,1539,20061,7.1
0500000US36069,36,069,Ontario County,56678,54358,2320,32917,4.1
0500000US36081,36,081,Queens County,1205909,1131527,74382,675211,6.2
0500000US36101,36,101,Steuben County,45989,42997,2992,32309,6.5
0500000US36041,36,041,Hamilton County,2116,1946,170,1903,8.0
0500000US36115,36,115,Washington County,30266,28537,1729,21097,5.7
0500000US36013,36,013,Chautauqua County,60147,56021,4126,45961,6.9
0500000US36047,36,047,Kings County,1309155,1217624,91531,751672,7.0
0500000US36061,36,061,New York County,951338,897040,54298,467419,5.7
0500000US36107,36,107,Tioga County,24622,23065,1557,15260,6.3
0500000US36011,36,011,Cayuga County,38573,36489,2084,25777,5.4
0500000US36073,36,073,Orleans County,19160,18161,999,14892,5.2
0500000US36091,36,091,Saratoga County,123573,118824,4749,61533,3.8
0500000US36087,36,087,Rockland County,157009,148410,8599,86098,5.5
0500000US36021,36,021,Columbia County,31082,29545,1537,20355,4.9
0500000US36049,36,049,Lewis County,12583,11711,872,8402,6.9
0500000US36063,36,063,Niagara County,106318,100682,5636,67808,5.3
0500000US36119,36,119,Westchester County,509497,479775,29722,268863,5.8
0500000US36025,36,025,Delaware County,21301,20204,1097,17600,5.1
0500000US36031,36,031,Essex County,18366,17294,1072,13966,5.8
0500000US36057,36,057,Montgomery County,23337,21536,1801,16020,7.7
0500000US36059,36,059,Nassau County,714628,684098,30530,383370,4.3
0500000US36085,36,085,Richmond County,222165,211293,10872,159707,4.9
0500000US36097,36,097,Schuyler County,8889,8397,492,6055,5.5
0500000US36109,36,109,Tompkins County,52688,50250,2438,36730,4.6
0500000US36017,36,017,Chenango County,23229,21902,1327,16223,5.7
0500000US36023,36,023,Cortland County,24638,23525,1113,15232,4.5
0500000US36045,36,045,Jefferson County,47853,44760,3093,31859,6.5
0500000US36065,36,065,Oneida County,108266,102319,5947,78483,5.5
0500000US36103,36,103,Suffolk County,781705,744693,37012,423669,4.7
0500000US36121,36,121,Wyoming County,19719,18562,1157,13647,5.9
0500000US36015,36,015,Chemung County,39242,37261,1981,29921,5.0
0500000US36075,36,075,Oswego County,57908,53360,4548,38826,7.9
0500000US36077,36,077,Otsego County,30101,28171,1930,21558,6.4
0500000US36117,36,117,Wayne County,46512,43779,2733,26898,5.9
0500000US36001,36,001,Albany County,167879,159756,8123,88929,4.8
0500000US36007,36,007,Broome County,93347,87190,6157,67780,6.6
0500000US36029,36,029,Erie County,471692,449109,22583,282441,4.8
0500000US36053,36,053,Madison County,35367,33712,1655,23893,4.7
0500000US36105,36,105,Sullivan County,35603,32846,2757,25587,7.7
0500000US36037,36,037,Genesee County,31365,29897,1468,16356,4.7
0500000US36071,36,071,Orange County,183891,174834,9057,104947,4.9
0500000US37079,37,079,Greene County,8948,8077,871,8140,9.7
0500000US37121,37,121,Mitchell County,6534,6254,280,6090,4.3
0500000US37041,37,041,Chowan County,6015,5351,664,5612,11.0
0500000US37027,37,027,Caldwell County,38821,36275,2546,28131,6.6
0500000US37035,37,035,Catawba County,78455,73002,5453,47279,7.0
0500000US37049,37,049,Craven County,44019,40506,3513,32002,8.0
0500000US37065,37,065,Edgecombe County,23641,21773,1868,18991,7.9
0500000US37085,37,085,Harnett County,55073,50735,4338,39589,7.9
0500000US37089,37,089,Henderson County,53364,51829,1535,40857,2.9
0500000US37095,37,095,Hyde County,2215,1984,231,2117,10.4
0500000US37119,37,119,Mecklenburg County,588213,554107,34106,238313,5.8
0500000US37131,37,131,Northampton County,7774,7233,541,9110,7.0
0500000US37159,37,159,Rowan County,66597,61491,5106,45382,7.7
0500000US37181,37,181,Vance County,20511,18594,1917,14609,9.3
0500000US37053,37,053,Currituck County,12633,12025,608,7726,4.8
0500000US37179,37,179,Union County,116210,109997,6213,55872,5.3
0500000US37067,37,067,Forsyth County,181302,169738,11564,113094,6.4
0500000US37127,37,127,Nash County,46235,43343,2892,29334,6.3
0500000US37017,37,017,Bladen County,13783,12805,978,13660,7.1
0500000US37055,37,055,Dare County,19054,18054,1000,10434,5.2
0500000US37185,37,185,Warren County,8012,7288,724,8777,9.0
0500000US37195,37,195,Wilson County,38095,35051,3044,26106,8.0
0500000US37015,37,015,Bertie County,8486,7496,990,8047,11.7
0500000US37073,37,073,Gates County,5571,5190,381,3874,6.8
0500000US37075,37,075,Graham County,3416,3180,236,3615,6.9
0500000US37117,37,117,Martin County,10391,9257,1134,8481,10.9
0500000US37115,37,115,Madison County,10070,9511,559,7826,5.6
0500000US37137,37,137,Pamlico County,5220,4806,414,5805,7.9
0500000US37143,37,143,Perquimans County,5688,5305,383,5437,6.7
0500000US37149,37,149,Polk County,9092,8617,475,8330,5.2
0500000US37151,37,151,Randolph County,69457,65738,3719,44585,5.4
0500000US37157,37,157,Rockingham County,42031,39463,2568,32707,6.1
0500000US37169,37,169,Stokes County,22142,20742,1400,15874,6.3
0500000US37187,37,187,Washington County,4813,4454,359,5198,7.5
0500000US37029,37,029,Camden County,4933,4473,460,3108,9.3
0500000US37043,37,043,Clay County,4496,4391,105,4548,2.3
0500000US37051,37,051,Cumberland County,138439,125926,12513,91237,9.0
0500000US37071,37,071,Gaston County,106027,98902,7125,66965,6.7
0500000US37081,37,081,Guilford County,266134,250123,16011,153528,6.0
0500000US37099,37,099,Jackson County,19540,18614,926,16310,4.7
0500000US37125,37,125,Moore County,42179,39935,2244,33272,5.3
0500000US37155,37,155,Robeson County,52163,47923,4240,51373,8.1
0500000US37167,37,167,Stanly County,30160,28295,1865,19176,6.2
0500000US37183,37,183,Wake County,576748,551929,24819,241170,4.3
0500000US37199,37,199,Yancey County,7764,7159,605,7024,7.8
0500000US37037,37,037,Chatham County,33230,31532,1698,24003,5.1
0500000US37111,37,111,McDowell County,19817,18674,1143,17205,5.8
0500000US37101,37,101,Johnston County,94669,89484,5185,51874,5.5
0500000US37103,37,103,Jones County,4272,3891,381,3793,8.9
0500000US37145,37,145,Person County,19768,18065,1703,12228,8.6
0500000US37019,37,019,Brunswick County,54223,50793,3430,54321,6.3
0500000US37009,37,009,Ashe County,13044,12440,604,9443,4.6
0500000US37013,37,013,Beaufort County,20706,18867,1839,17923,8.9
0500000US37107,37,107,Lenoir County,26652,23378,3274,19144,12.3
0500000US37109,37,109,Lincoln County,40684,38100,2584,25367,6.4
0500000US37133,37,133,Onslow County,69930,63221,6709,43546,9.6
0500000US37135,37,135,Orange County,76525,73172,3353,41604,4.4
0500000US37161,37,161,Rutherford County,28832,26422,2410,25499,8.4
0500000US37163,37,163,Sampson County,29042,26584,2458,20538,8.5
0500000US37197,37,197,Yadkin County,16620,15731,889,14024,5.3
0500000US37011,37,011,Avery County,7018,6718,300,8193,4.3
0500000US37023,37,023,Burke County,42012,38284,3728,32534,8.9
0500000US37033,37,033,Caswell County,10247,9549,698,8634,6.8
0500000US37059,37,059,Davie County,20409,19284,1125,13856,5.5
0500000US37061,37,061,Duplin County,26866,24447,2419,19308,9.0
0500000US37063,37,063,Durham County,167049,158434,8615,79849,5.2
0500000US37105,37,105,Lee County,28809,26541,2268,17749,7.9
0500000US37129,37,129,New Hanover County,116158,109010,7148,69844,6.2
0500000US37191,37,191,Wayne County,56836,52418,4418,38358,7.8
0500000US37165,37,165,Scotland County,13808,12081,1727,14177,12.5
0500000US37083,37,083,Halifax County,21288,19437,1851,20604,8.7
0500000US37001,37,001,Alamance County,80141,75612,4529,48262,5.7
0500000US38013,38,013,Burke County,1071,1052,19,490,1.8
0500000US38061,38,061,Mountrail County,4930,4726,204,2793,4.1
0500000US38105,38,105,Williams County,18579,18154,425,6967,2.3
0500000US38007,38,007,Billings County,519,500,19,220,3.7
0500000US38043,38,043,Kidder County,1282,1268,14,736,1.1
0500000US38019,38,019,Cavalier County,1946,1921,25,1139,1.3
0500000US38037,38,037,Grant County,1160,1132,28,799,2.4
0500000US38067,38,067,Pembina County,3550,3450,100,2112,2.8
0500000US38091,38,091,Steele County,1013,991,22,549,2.2
0500000US38041,38,041,Hettinger County,1170,1149,21,899,1.8
0500000US38045,38,045,LaMoure County,2063,2053,10,1256,0.5
0500000US38059,38,059,Morton County,17831,17282,549,6583,3.1
0500000US38017,38,017,Cass County,104601,101585,3016,34028,2.9
0500000US38025,38,025,Dunn County,2173,2100,73,1293,3.4
0500000US38029,38,029,Emmons County,1530,1508,22,1233,1.4
0500000US38051,38,051,McIntosh County,1395,1391,4,833,0.3
0500000US38063,38,063,Nelson County,1491,1486,5,952,0.3
0500000US38077,38,077,Richland County,8897,8628,269,4318,3.0
0500000US38079,38,079,Rolette County,5661,5214,447,4469,7.9
0500000US38099,38,099,Walsh County,5628,5488,140,2968,2.5
0500000US38001,38,001,Adams County,1235,1219,16,706,1.3
0500000US38009,38,009,Bottineau County,3419,3288,131,1952,3.8
0500000US38003,38,003,Barnes County,5988,5830,158,3015,2.6
0500000US38027,38,027,Eddy County,1211,1196,15,662,1.2
0500000US38035,38,035,Grand Forks County,39945,38410,1535,15984,3.8
0500000US38053,38,053,McKenzie County,6641,6393,248,2417,3.7
0500000US38057,38,057,Mercer County,4438,4397,41,2411,0.9
0500000US38055,38,055,McLean County,4609,4545,64,3103,1.4
0500000US38069,38,069,Pierce County,2070,2050,20,1336,1.0
0500000US38073,38,073,Ransom County,2820,2782,38,1554,1.3
0500000US38085,38,085,Sioux County,1596,1340,256,1367,16.0
0500000US38011,38,011,Bowman County,1769,1725,44,725,2.5
0500000US38033,38,033,Golden Valley County,1036,1019,17,490,1.6
0500000US38047,38,047,Logan County,1002,993,9,605,0.9
0500000US38095,38,095,Towner County,1057,1014,43,744,4.1
0500000US38093,38,093,Stutsman County,11121,10758,363,6116,3.3
0500000US38023,38,023,Divide County,1183,1175,8,848,0.7
0500000US38031,38,031,Foster County,1815,1793,22,809,1.2
0500000US38081,38,081,Sargent County,2179,2151,28,1022,1.3
0500000US38087,38,087,Slope County,340,336,4,232,1.2
0500000US38089,38,089,Stark County,16940,16382,558,6828,3.3
0500000US39053,39,053,Gallia County,12753,12096,657,11360,5.2
0500000US39077,39,077,Huron County,28630,27219,1411,17130,4.9
0500000US39009,39,009,Athens County,29754,27470,2284,27551,7.7
0500000US39001,39,001,Adams County,10882,10105,777,10951,7.1
0500000US39103,39,103,Medina County,96103,93038,3065,45356,3.2
0500000US39159,39,159,Union County,28482,27762,720,14990,2.5
0500000US39021,39,021,Champaign County,19545,18365,1180,11776,6.0
0500000US39125,39,125,Paulding County,9046,8631,415,5906,4.6
0500000US39057,39,057,Greene County,82401,77851,4550,50735,5.5
0500000US39049,39,049,Franklin County,702381,665824,36557,303809,5.2
0500000US39101,39,101,Marion County,28305,26402,1903,24723,6.7
0500000US39115,39,115,Morgan County,6054,5752,302,5877,5.0
0500000US39169,39,169,Wayne County,57855,55599,2256,33176,3.9
0500000US39175,39,175,Wyandot County,11367,10939,428,6316,3.8
0500000US39017,39,017,Butler County,192925,183136,9789,105679,5.1
0500000US39067,39,067,Harrison County,6804,6423,381,5733,5.6
0500000US39083,39,083,Knox County,30039,28453,1586,18721,5.3
0500000US39139,39,139,Richland County,54362,50829,3533,43458,6.5
0500000US39163,39,163,Vinton County,5826,5253,573,4704,9.8
0500000US39063,39,063,Hancock County,40249,38531,1718,20433,4.3
0500000US39045,39,045,Fairfield County,75355,72028,3327,44903,4.4
0500000US39039,39,039,Defiance County,19868,18951,917,10606,4.6
0500000US39069,39,069,Henry County,13866,13278,588,7765,4.2
0500000US39081,39,081,Jefferson County,29569,27203,2366,25763,8.0
0500000US39137,39,137,Putnam County,18013,17499,514,8269,2.9
0500000US39027,39,027,Clinton County,20789,19514,1275,12327,6.1
0500000US39047,39,047,Fayette County,13340,12543,797,9176,6.0
0500000US39129,39,129,Pickaway County,26073,24995,1078,20442,4.1
0500000US39091,39,091,Logan County,22580,21477,1103,13480,4.9
0500000US39153,39,153,Summit County,282703,266743,15960,158041,5.6
0500000US39143,39,143,Sandusky County,29631,28152,1479,17718,5.0
0500000US39149,39,149,Shelby County,25942,24780,1162,12063,4.5
0500000US27033,27,033,Cottonwood County,5624,5395,229,3292,4.1
0500000US27139,27,139,Scott County,81345,78641,2704,26062,3.3
0500000US27039,27,039,Dodge County,11605,11309,296,4096,2.6
0500000US27157,27,157,Wabasha County,11679,11302,377,5736,3.2
0500000US27117,27,117,Pipestone County,4513,4384,129,2621,2.9
0500000US27035,27,035,Crow Wing County,31246,30366,880,20166,2.8
0500000US27107,27,107,Norman County,3225,3121,104,1973,3.2
0500000US27171,27,171,Wright County,73782,71417,2365,25495,3.2
0500000US27103,27,103,Nicollet County,19789,19085,704,7419,3.6
0500000US27041,27,041,Douglas County,19819,19219,600,10292,3.0
0500000US27051,27,051,Grant County,3039,2916,123,1684,4.0
0500000US27069,27,069,Kittson County,2306,2247,59,1210,2.6
0500000US27079,27,079,Le Sueur County,15382,14840,542,6647,3.5
0500000US27087,27,087,Mahnomen County,2357,2177,180,1571,7.6
0500000US27025,27,025,Chisago County,29993,28762,1231,13655,4.1
0500000US27127,27,127,Redwood County,7680,7490,190,4363,2.5
0500000US27173,27,173,Yellow Medicine County,5065,4913,152,2792,3.0
0500000US27153,27,153,Todd County,11473,11127,346,7757,3.0
0500000US27007,27,007,Beltrami County,22868,21100,1768,12654,7.7
0500000US27013,27,013,Blue Earth County,39107,37545,1562,15479,4.0
0500000US27055,27,055,Houston County,10367,10164,203,4700,2.0
0500000US27073,27,073,Lac qui Parle County,3460,3381,79,2191,2.3
0500000US27077,27,077,Lake of the Woods County,2129,2063,66,1032,3.1
0500000US27111,27,111,Otter Tail County,29177,28193,984,17621,3.4
0500000US27161,27,161,Waseca County,9626,9280,346,5345,3.6
0500000US27137,27,137,St. Louis County,103122,98063,5059,62795,4.9
0500000US27003,27,003,Anoka County,197341,189965,7376,75692,3.7
0500000US27145,27,145,Stearns County,89838,85674,4164,34841,4.6
0500000US27081,27,081,Lincoln County,2918,2847,71,1611,2.4
0500000US27089,27,089,Marshall County,4937,4805,132,2547,2.7
0500000US27095,27,095,Mille Lacs County,12860,12088,772,7303,6.0
0500000US27163,27,163,Washington County,139893,135605,4288,57860,3.1
0500000US27017,27,017,Carlton County,17373,16640,733,10938,4.2
0500000US27065,27,065,Kanabec County,8113,7742,371,4871,4.6
0500000US27071,27,071,Koochiching County,6158,5737,421,4439,6.8
0500000US27097,27,097,Morrison County,17167,16432,735,8910,4.3
0500000US27131,27,131,Rice County,35457,34128,1329,17529,3.7
0500000US27147,27,147,Steele County,19706,18903,803,8618,4.1
0500000US27125,27,125,Red Lake County,2068,2000,68,1056,3.3
0500000US27001,27,001,Aitkin County,6599,6207,392,6930,5.9
0500000US27043,27,043,Faribault County,7316,7082,234,3851,3.2
0500000US27101,27,101,Murray County,4367,4252,115,2408,2.6
0500000US27067,27,067,Kandiyohi County,22462,21779,683,10923,3.0
0500000US27075,27,075,Lake County,5099,4874,225,3836,4.4
0500000US27133,27,133,Rock County,4882,4788,94,2484,1.9
0500000US27143,27,143,Sibley County,8180,7949,231,3557,2.8
0500000US27155,27,155,Traverse County,1699,1650,49,1031,2.9
0500000US27005,27,005,Becker County,17012,16399,613,9407,3.6
0500000US27053,27,053,Hennepin County,717635,687713,29922,272528,4.2
0500000US27015,27,015,Brown County,13926,13652,274,6428,2.0
0500000US27023,27,023,Chippewa County,6298,6127,171,3238,2.7
0500000US27029,27,029,Clearwater County,4116,3790,326,2792,7.9
0500000US27057,27,057,Hubbard County,9950,9600,350,6998,3.5
0500000US27059,27,059,Isanti County,20854,19894,960,9635,4.6
0500000US27091,27,091,Martin County,10402,10037,365,5702,3.5
0500000US27099,27,099,Mower County,20043,19147,896,10751,4.5
0500000US27115,27,115,Pine County,13365,12673,692,10639,5.2
0500000US27109,27,109,Olmsted County,84505,81361,3144,34673,3.7
0500000US27159,27,159,Wadena County,6349,6034,315,4254,5.0
0500000US27009,27,009,Benton County,21594,20722,872,9013,4.0
0500000US27047,27,047,Freeborn County,15882,15190,692,8725,4.4
0500000US27085,27,085,McLeod County,19608,19095,513,8848,2.6
0500000US27121,27,121,Pope County,5793,5636,157,3142,2.7
0500000US27149,27,149,Stevens County,5376,5254,122,2586,2.3
0500000US27151,27,151,Swift County,4939,4799,140,2580,2.8
0500000US28051,28,051,Holmes County,5902,4777,1125,7931,19.1
0500000US28005,28,005,Amite County,4797,4402,395,5346,8.2
0500000US28013,28,013,Calhoun County,5781,5365,416,5668,7.2
0500000US28141,28,141,Tishomingo County,8634,7801,833,7066,9.6
0500000US28153,28,153,Wayne County,9017,8174,843,6983,9.3
0500000US48015,48,015,Austin County,14475,13801,674,8879,4.7
0500000US48261,48,261,Kenedy County,220,220,0,208,0.0
0500000US48355,48,355,Nueces County,175891,165496,10395,103638,5.9
0500000US48089,48,089,Colorado County,9832,9489,343,6753,3.5
0500000US48409,48,409,San Patricio County,30490,29024,1466,20268,4.8
0500000US48379,48,379,Rains County,4941,4690,251,4461,5.1
0500000US48381,48,381,Randall County,72638,70272,2366,31055,3.3
0500000US48385,48,385,Real County,1307,1292,15,1518,1.1
0500000US48411,48,411,San Saba County,2530,2452,78,2370,3.1
0500000US48413,48,413,Schleicher County,1547,1405,142,723,9.2
0500000US48431,48,431,Sterling County,596,587,9,296,1.5
0500000US48507,48,507,Zavala County,5013,4592,421,3997,8.4
0500000US48057,48,057,Calhoun County,10348,9606,742,6648,7.2
0500000US48065,48,065,Carson County,2965,2897,68,1731,2.3
0500000US48155,48,155,Foard County,714,642,72,480,10.1
0500000US48161,48,161,Freestone County,7697,7273,424,8040,5.5
0500000US48175,48,175,Goliad County,3265,3075,190,2848,5.8
0500000US48193,48,193,Hamilton County,3627,3583,44,3096,1.2
0500000US48197,48,197,Hardeman County,1807,1674,133,1313,7.4
0500000US48335,48,335,Mitchell County,2911,2743,168,4273,5.8
0500000US48045,48,045,Briscoe County,730,690,40,561,5.5
0500000US48285,48,285,Lavaca County,9273,8969,304,6453,3.3
0500000US48445,48,445,Terry County,5185,4658,527,4375,10.2
0500000US48243,48,243,Jeff Davis County,928,879,49,956,5.3
0500000US48247,48,247,Jim Hogg County,1988,1759,229,1821,11.5
0500000US48339,48,339,Montgomery County,274389,262084,12305,149200,4.5
0500000US48111,48,111,Dallam County,3770,3623,147,1421,3.9
0500000US48479,48,479,Webb County,112530,106666,5864,77878,5.2
0500000US48011,48,011,Armstrong County,960,951,9,610,0.9
0500000US48069,48,069,Castro County,3512,3438,74,2261,2.1
0500000US48273,48,273,Kleberg County,14536,13211,1325,9714,9.1
0500000US48489,48,489,Willacy County,8251,6975,1276,8688,15.5
0500000US48107,48,107,Crosby County,2634,2443,191,1793,7.3
0500000US48151,48,151,Fisher County,1832,1715,117,1357,6.4
0500000US48131,48,131,Duval County,4555,4073,482,4107,10.6
0500000US48031,48,031,Blanco County,5664,5343,321,3776,5.7
0500000US48241,48,241,Jasper County,14335,13109,1226,13620,8.6
0500000US48271,48,271,Kinney County,1300,1213,87,1726,6.7
0500000US48117,48,117,Deaf Smith County,8999,8581,418,4575,4.6
0500000US48167,48,167,Galveston County,163434,153139,10295,92130,6.3
0500000US48283,48,283,La Salle County,2947,2822,125,3101,4.2
0500000US48393,48,393,Roberts County,372,367,5,319,1.3
0500000US48457,48,457,Tyler County,7443,6714,729,10463,9.8
0500000US48483,48,483,Wheeler County,2648,2534,114,1549,4.3
0500000US48037,48,037,Bowie County,39723,37085,2638,34152,6.6
0500000US48043,48,043,Brewster County,4515,4318,197,3132,4.4
0500000US48263,48,263,Kent County,321,309,12,286,3.7
0500000US48423,48,423,Smith County,105905,99381,6524,69327,6.2
0500000US48105,48,105,Crockett County,1741,1741,0,1059,0.0
0500000US48199,48,199,Hardin County,24555,23565,990,19361,4.0
0500000US48227,48,227,Howard County,15629,14563,1066,13862,6.8
0500000US48289,48,289,Leon County,6935,6463,472,6739,6.8
0500000US48337,48,337,Montague County,8707,8240,467,6776,5.4
0500000US48365,48,365,Panola County,10318,9846,472,8106,4.6
0500000US49027,49,027,Millard County,5723,5539,184,3471,3.2
0500000US49053,49,053,Washington County,68050,65077,2973,53864,4.4
0500000US49025,49,025,Kane County,3363,3265,98,2524,2.9
0500000US49019,49,019,Grand County,5372,5078,294,2517,5.5
0500000US49033,49,033,Rich County,766,766,0,844,0.0
0500000US49051,49,051,Wasatch County,15363,15195,168,6487,1.1
0500000US49003,49,003,Box Elder County,24030,23020,1010,13758,4.2
0500000US49021,49,021,Iron County,22649,21504,1145,14428,5.1
0500000US49041,49,041,Sevier County,9355,8838,517,6100,5.5
0500000US49057,49,057,Weber County,124083,118705,5378,59456,4.3
0500000US49013,49,013,Duchesne County,8690,8117,573,5286,6.6
0500000US49037,49,037,San Juan County,5983,5488,495,4999,8.3
0500000US49035,49,035,Salt Lake County,599324,576623,22701,241554,3.8
0500000US49047,49,047,Uintah County,16207,15090,1117,9155,6.9
0500000US49009,49,009,Daggett County,260,257,3,235,1.2
0500000US49011,49,011,Davis County,164488,159157,5331,74526,3.2
0500000US49055,49,055,Wayne County,1262,1248,14,851,1.1
0500000US49007,49,007,Carbon County,9387,8868,519,6141,5.5
0500000US49015,49,015,Emery County,4211,4035,176,3220,4.2
0500000US49029,49,029,Morgan County,4945,4809,136,2853,2.8
0500000US49005,49,005,Cache County,60738,59014,1724,27776,2.8
0500000US49017,49,017,Garfield County,2301,2211,90,1667,3.9
0500000US49023,49,023,Juab County,5000,4843,157,2622,3.1
0500000US50021,50,021,Rutland County,31367,30183,1184,18731,3.8
0500000US50019,50,019,Orleans County,12783,12213,570,9472,4.5
0500000US50013,50,013,Grand Isle County,3874,3691,183,2013,4.7
0500000US50017,50,017,Orange County,16130,15404,726,7994,4.5
0500000US50007,50,007,Chittenden County,94512,90996,3516,41535,3.7
0500000US50015,50,015,Lamoille County,14185,13602,583,6513,4.1
0500000US50027,50,027,Windsor County,29637,28422,1215,16805,4.1
0500000US50005,50,005,Caledonia County,15188,14620,568,9989,3.7
0500000US50025,50,025,Windham County,23164,21908,1256,13175,5.4
0500000US50001,50,001,Addison County,20930,20040,890,10369,4.3
0500000US50023,50,023,Washington County,32498,31374,1124,15984,3.5
0500000US51185,51,185,Tazewell County,16883,15604,1279,18078,7.6
0500000US51610,51,610,Falls Church city,8028,7717,311,2757,3.9
0500000US51685,51,685,Manassas Park city,9226,8645,581,3390,6.3
0500000US51735,51,735,Poquoson city,6008,5690,318,3658,5.3
0500000US51183,51,183,Sussex County,3659,3339,320,6288,8.7
0500000US51820,51,820,Waynesboro city,10776,10293,483,6472,4.5
0500000US51770,51,770,Roanoke city,50937,47450,3487,28599,6.8
0500000US51775,51,775,Salem city,12897,12228,669,8233,5.2
0500000US51710,51,710,Norfolk city,114289,104931,9358,62239,8.2
0500000US51037,51,037,Charlotte County,5338,5031,307,4498,5.8
0500000US51059,51,059,Fairfax County,638310,611628,26682,254269,4.2
0500000US51081,51,081,Greensville County,4222,3943,279,5703,6.6
0500000US51095,51,095,James City County,34852,33444,1408,25463,4.0
0500000US51167,51,167,Russell County,10205,9508,697,12700,6.8
0500000US51173,51,173,Smyth County,13368,12593,775,12455,5.8
0500000US51678,51,678,Lexington city,2350,2251,99,4164,4.2
0500000US51031,51,031,Campbell County,27964,26938,1026,17534,3.7
0500000US51089,51,089,Henry County,21890,20064,1826,20799,8.3
0500000US51099,51,099,King George County,13399,12863,536,6282,4.0
0500000US51103,51,103,Lancaster County,4492,4338,154,4907,3.4
0500000US51105,51,105,Lee County,8335,7474,861,11787,10.3
0500000US51115,51,115,Mathews County,3874,3768,106,3774,2.7
0500000US51119,51,119,Middlesex County,4502,4302,200,4708,4.4
0500000US51149,51,149,Prince George County,16291,15090,1201,12945,7.4
0500000US51165,51,165,Rockingham County,40641,39144,1497,23309,3.7
0500000US51169,51,169,Scott County,8831,8340,491,9528,5.6
0500000US51181,51,181,Surry County,3213,2983,230,2340,7.2
0500000US51011,51,011,Appomattox County,7238,6963,275,5341,3.8
0500000US51067,51,067,Franklin County,26485,25156,1329,20243,5.0
0500000US51097,51,097,King and Queen County,3275,3081,194,2603,5.9
0500000US51121,51,121,Montgomery County,48434,46179,2255,35816,4.7
0500000US51127,51,127,New Kent County,11041,10544,497,6089,4.5
0500000US51049,51,049,Cumberland County,5005,4656,349,3124,7.0
0500000US51075,51,075,Goochland County,11073,10715,358,7763,3.2
0500000US51083,51,083,Halifax County,15352,14700,652,13143,4.2
0500000US51113,51,113,Madison County,6431,6080,351,4258,5.5
0500000US51153,51,153,Prince William County,246265,234698,11567,93104,4.7
0500000US51175,51,175,Southampton County,8149,7799,350,6726,4.3
0500000US51091,51,091,Highland County,898,893,5,1045,0.6
0500000US51025,51,025,Brunswick County,6916,6422,494,7272,7.1
0500000US51033,51,033,Caroline County,14481,13695,786,7683,5.4
0500000US51073,51,073,Gloucester County,18144,17623,521,12248,2.9
0500000US51131,51,131,Northampton County,5053,4897,156,4737,3.1
0500000US51141,51,141,Patrick County,7722,7283,439,7444,5.7
0500000US51145,51,145,Powhatan County,13602,13269,333,10566,2.4
0500000US51163,51,163,Rockbridge County,10788,10153,635,8208,5.9
0500000US51171,51,171,Shenandoah County,21460,20419,1041,13397,4.9
0500000US51061,51,061,Fauquier County,36820,35568,1252,17917,3.4
0500000US51036,51,036,Charles City County,3491,3318,173,2520,5.0
0500000US51047,51,047,Culpeper County,25527,24163,1364,13565,5.3
0500000US51053,51,053,Dinwiddie County,14619,13594,1025,8506,7.0
0500000US51079,51,079,Greene County,10342,9820,522,4805,5.0
0500000US51085,51,085,Hanover County,56681,54987,1694,27357,3.0
0500000US51111,51,111,Lunenburg County,4675,4470,205,5448,4.4
0500000US51137,51,137,Orange County,17603,16575,1028,11031,5.8
0500000US51595,51,595,Emporia city,2528,1939,589,1655,23.3
0500000US51197,51,197,Wythe County,13994,13070,924,9924,6.6
0500000US51550,51,550,Chesapeake city,116386,110464,5922,63536,5.1
0500000US51660,51,660,Harrisonburg city,27108,25898,1210,18293,4.5
0500000US51003,51,003,Albemarle County,53539,52003,1536,33178,2.9
0500000US51019,51,019,Bedford County,38617,37064,1553,25686,4.0
0500000US51023,51,023,Botetourt County,16496,15847,649,11012,3.9
0500000US51195,51,195,Wise County,14402,13075,1327,17741,9.2
0500000US51520,51,520,Bristol city,7624,7174,450,6093,5.9
0500000US51740,51,740,Portsmouth city,45600,41388,4212,26173,9.2
0500000US51830,51,830,Williamsburg city,6515,6027,488,6815,7.5
0500000US51005,51,005,Alleghany County,6412,6054,358,6403,5.6
0500000US51035,51,035,Carroll County,13421,12952,469,11249,3.5
0500000US51191,51,191,Washington County,25403,23898,1505,20159,5.9
0500000US51133,51,133,Northumberland County,5107,4780,327,5486,6.4
0500000US51139,51,139,Page County,11539,10794,745,7919,6.5
0500000US51187,51,187,Warren County,20311,19074,1237,11548,6.1
0500000US51510,51,510,Alexandria city,99424,96180,3244,28195,3.3
0500000US51630,51,630,Fredericksburg city,16201,15332,869,6666,5.4
0500000US51650,51,650,Hampton city,66810,61974,4836,37998,7.2
0500000US51013,51,013,Arlington County,150026,145621,4405,41551,2.9
0500000US51670,51,670,Hopewell city,10234,9384,850,6934,8.3
0500000US51027,51,027,Buchanan County,6946,6383,563,11660,8.1
0500000US51069,51,069,Frederick County,44522,42883,1639,23199,3.7
0500000US51179,51,179,Stafford County,73328,70371,2957,33589,4.0
0500000US51199,51,199,York County,32228,30286,1942,17521,6.0
0500000US51760,51,760,Richmond city,121985,112654,9331,64837,7.6
0500000US51125,51,125,Nelson County,7283,6997,286,5068,3.9
0500000US51143,51,143,Pittsylvania County,29209,27404,1805,21782,6.2
0500000US51720,51,720,Norton city,1786,1539,247,1326,13.8
0500000US51065,51,065,Fluvanna County,12924,12252,672,8631,5.2
0500000US51007,51,007,Amelia County,6419,6241,178,3983,2.8
0500000US51840,51,840,Winchester city,14253,13718,535,7914,3.8
0500000US51001,51,001,Accomack County,14422,13817,605,12135,4.2
0500000US51063,51,063,Floyd County,7340,7163,177,5574,2.4
0500000US51077,51,077,Grayson County,6904,6457,447,6499,6.5
0500000US51135,51,135,Nottoway County,5812,5596,216,7020,3.7
0500000US54033,54,033,Harrison County,32145,29985,2160,23003,6.7
0500000US54069,54,069,Ohio County,21092,20013,1079,14332,5.1
0500000US54013,54,013,Calhoun County,2600,2203,397,3489,15.3
0500000US54065,54,065,Morgan County,8223,7516,707,6543,8.6
0500000US54081,54,081,Raleigh County,31082,28669,2413,31070,7.8
0500000US54007,54,007,Braxton County,6266,5398,868,5564,13.9
0500000US54001,54,001,Barbour County,7067,6500,567,6682,8.0
0500000US54047,54,047,McDowell County,4433,4019,414,11254,9.3
0500000US54099,54,099,Wayne County,14980,13808,1172,18177,7.8
0500000US54109,54,109,Wyoming County,7013,6088,925,10800,13.2
0500000US54035,54,035,Jackson County,11795,11288,507,11775,4.3
0500000US54055,54,055,Mercer County,24116,22660,1456,25417,6.0
0500000US54097,54,097,Upshur County,10720,9860,860,9409,8.0
0500000US54101,54,101,Webster County,3352,2989,363,3686,10.8
0500000US54003,54,003,Berkeley County,57921,53940,3981,31267,6.9
0500000US54019,54,019,Fayette County,17121,15861,1260,18999,7.4
0500000US54023,54,023,Grant County,5158,4897,261,4544,5.1
0500000US54027,54,027,Hampshire County,9525,9021,504,10016,5.3
0500000US54089,54,089,Summers County,4967,4473,494,6114,9.9
0500000US54009,54,009,Brooke County,10511,10189,322,8582,3.1
0500000US54017,54,017,Doddridge County,3096,2941,155,4180,5.0
0500000US54025,54,025,Greenbrier County,14648,13667,981,14483,6.7
0500000US54031,54,031,Hardy County,6627,6428,199,4641,3.0
0500000US54049,54,049,Marion County,26450,24881,1569,19990,5.9
0500000US54057,54,057,Mineral County,12348,11555,793,10143,6.4
0500000US54059,54,059,Mingo County,8261,6894,1367,11654,16.5
0500000US54029,54,029,Hancock County,14412,13388,1024,10137,7.1
0500000US54041,54,041,Lewis County,6778,6363,415,6343,6.1
0500000US54067,54,067,Nicholas County,10469,9758,711,10247,6.8
0500000US54075,54,075,Pocahontas County,3637,3468,169,3572,4.6
0500000US54095,54,095,Tyler County,3414,3194,220,3963,6.4
0500000US54083,54,083,Randolph County,12136,11339,797,11925,6.6
0500000US54091,54,091,Taylor County,7448,6842,606,6433,8.1
0500000US54105,54,105,Wirt County,2235,2106,129,2438,5.8
0500000US54015,54,015,Clay County,2830,2600,230,4197,8.1
0500000US54021,54,021,Gilmer County,2941,2659,282,4204,9.6
0500000US54061,54,061,Monongalia County,53662,50112,3550,36237,6.6
0500000US54063,54,063,Monroe County,5576,5139,437,5497,7.8
0500000US54103,54,103,Wetzel County,5932,5519,413,6908,7.0
0500000US54011,54,011,Cabell County,41062,38865,2197,37066,5.4
0500000US54039,54,039,Kanawha County,84768,79515,5253,67630,6.2
0500000US54071,54,071,Pendleton County,2947,2805,142,2930,4.8
0500000US54077,54,077,Preston County,14706,13494,1212,13282,8.2
0500000US53035,53,035,Kitsap County,119537,113310,6227,81866,5.2
0500000US53033,53,033,King County,1231992,1176560,55432,531496,4.5
0500000US53051,53,051,Pend Oreille County,4953,4654,299,6034,6.0
0500000US53055,53,055,San Juan County,7896,7657,239,6620,3.0
0500000US53075,53,075,Whitman County,24770,22539,2231,17286,9.0
0500000US53077,53,077,Yakima County,112196,104784,7412,69998,6.6
0500000US53015,53,015,Cowlitz County,47402,43701,3701,36238,7.8
0500000US53019,53,019,Ferry County,2869,2648,221,3566,7.7
0500000US53041,53,041,Lewis County,33136,30414,2722,29166,8.2
0500000US53027,53,027,Grays Harbor County,29888,27388,2500,28631,8.4
0500000US53029,53,029,Island County,34356,32257,2099,28701,6.1
0500000US53069,53,069,Wahkiakum County,1460,1383,77,2153,5.3
0500000US53021,53,021,Franklin County,42097,39752,2345,21740,5.6
0500000US53025,53,025,Grant County,43427,40985,2442,25887,5.6
0500000US53073,53,073,Whatcom County,112112,105049,7063,66540,6.3
0500000US53047,53,047,Okanogan County,18104,16954,1150,14951,6.4
0500000US53037,53,037,Kittitas County,22861,21497,1364,14898,6.0
0500000US53005,53,005,Benton County,91475,86708,4767,56218,5.2
0500000US53013,53,013,Columbia County,1845,1762,83,1505,4.5
0500000US53003,53,003,Asotin County,10354,9643,711,7960,6.9
0500000US53023,53,023,Garfield County,997,923,74,786,7.4
0500000US53045,53,045,Mason County,26019,24072,1947,25804,7.5
0500000US53065,53,065,Stevens County,17529,16351,1178,18120,6.7
0500000US53063,53,063,Spokane County,241199,227651,13548,155291,5.6
0500000US53007,53,007,Chelan County,36619,34693,1926,23134,5.3
0500000US55105,55,105,Rock County,84371,79644,4727,43561,5.6
0500000US55137,55,137,Waushara County,10898,10464,434,9282,4.0
0500000US55001,55,001,Adams County,8121,7517,604,9349,7.4
0500000US55007,55,007,Bayfield County,7371,7024,347,5308,4.7
0500000US55065,55,065,Lafayette County,8821,8630,191,4309,2.2
0500000US55081,55,081,Monroe County,22321,21524,797,12566,3.6
0500000US55093,55,093,Pierce County,24153,23534,619,9802,2.6
0500000US55141,55,141,Wood County,37896,36451,1445,21223,3.8
0500000US55003,55,003,Ashland County,7751,7291,460,4884,5.9
0500000US55015,55,015,Calumet County,28098,27476,622,10930,2.2
0500000US55037,55,037,Florence County,2048,1924,124,1662,6.1
0500000US55055,55,055,Jefferson County,47584,45835,1749,21035,3.7
0500000US55059,55,059,Kenosha County,89922,83794,6128,43349,6.8
0500000US55051,55,051,Iron County,2708,2509,199,2291,7.3
0500000US55019,55,019,Clark County,16328,15832,496,9136,3.0
0500000US55109,55,109,St. Croix County,49376,48173,1203,18544,2.4
0500000US55083,55,083,Oconto County,19666,18968,698,11278,3.5
0500000US55069,55,069,Lincoln County,14769,14200,569,8657,3.9
0500000US55135,55,135,Waupaca County,27126,26292,834,15128,3.1
0500000US55005,55,005,Barron County,22882,22141,741,13706,3.2
0500000US55113,55,113,Sawyer County,7662,7221,441,5799,5.8
0500000US55047,55,047,Green Lake County,9419,9154,265,5624,2.8
0500000US55077,55,077,Marquette County,7302,6925,377,5247,5.2
0500000US55075,55,075,Marinette County,19656,18712,944,14150,4.8
0500000US55101,55,101,Racine County,99386,94656,4730,55545,4.8
0500000US55139,55,139,Winnebago County,90983,87968,3015,47831,3.3
0500000US55041,55,041,Forest County,3972,3704,268,3431,6.7
0500000US55043,55,043,Grant County,27213,26382,831,15012,3.1
0500000US55107,55,107,Rusk County,6663,6409,254,4929,3.8
0500000US55117,55,117,Sheboygan County,61892,59637,2255,30461,3.6
0500000US55067,55,067,Langlade County,9255,8588,667,6678,7.2
0500000US55087,55,087,Outagamie County,102407,99454,2953,43283,2.9
0500000US55123,55,123,Vernon County,13860,13479,381,9597,2.7
0500000US55021,55,021,Columbia County,31522,30458,1064,14382,3.4
0500000US55061,55,061,Kewaunee County,10896,10585,311,5550,2.9
0500000US55009,55,009,Brown County,141495,136550,4945,62727,3.5
0500000US55073,55,073,Marathon County,73683,71176,2507,34075,3.4
0500000US55085,55,085,Oneida County,17182,16687,495,12781,2.9
0500000US55121,55,121,Trempealeau County,15515,15051,464,7428,3.0
0500000US55129,55,129,Washburn County,7292,6973,319,5708,4.4
0500000US55027,55,027,Dodge County,46552,44570,1982,24905,4.3
0500000US55127,55,127,Walworth County,56206,53838,2368,27351,4.2
0500000US55023,55,023,Crawford County,7836,7566,270,5506,3.4
0500000US55071,55,071,Manitowoc County,41855,40603,1252,23074,3.0
0500000US55111,55,111,Sauk County,35191,34048,1143,15514,3.2
0500000US55013,55,013,Burnett County,6941,6596,345,5879,5.0
0500000US55017,55,017,Chippewa County,32686,31621,1065,18117,3.3
0500000US55029,55,029,Door County,13998,13445,553,9471,4.0
0500000US55031,55,031,Douglas County,22832,21862,970,12768,4.2
0500000US55053,55,053,Jackson County,9965,9464,501,6528,5.0
0500000US55049,55,049,Iowa County,12885,12469,416,5873,3.2
0500000US55089,55,089,Ozaukee County,48482,47039,1443,23166,3.0
0500000US55103,55,103,Richland County,8632,8403,229,5472,2.7
0500000US56005,56,005,Campbell County,25905,24722,1183,9840,4.6
0500000US56019,56,019,Johnson County,4509,4328,181,2226,4.0
0500000US56025,56,025,Natrona County,43312,41314,1998,19910,4.6
0500000US56009,56,009,Converse County,7169,6829,340,3699,4.7
0500000US56027,56,027,Niobrara County,1047,1032,15,1039,1.4
0500000US56039,56,039,Teton County,14527,14317,210,4456,1.4
0500000US56037,56,037,Sweetwater County,23342,22129,1213,10181,5.2
0500000US56031,56,031,Platte County,4425,4307,118,2684,2.7
0500000US56033,56,033,Sheridan County,15491,15075,416,8704,2.7
0500000US56003,56,003,Big Horn County,5458,5178,280,3750,5.1
0500000US56011,56,011,Crook County,3570,3446,124,2211,3.5
0500000US56029,56,029,Park County,15123,14615,508,8840,3.4
0500000US56001,56,001,Albany County,22128,21168,960,10082,4.3
0500000US56007,56,007,Carbon County,7716,7503,213,4454,2.8
0500000US56015,56,015,Goshen County,6721,6258,463,4252,6.9
0500000US56041,56,041,Uinta County,10141,9527,614,5019,6.1
0500000US56043,56,043,Washakie County,4088,3835,253,2462,6.2
0500000US56017,56,017,Hot Springs County,2350,2292,58,1489,2.5
0500000US56013,56,013,Fremont County,19422,18248,1174,11561,6.0
0500000US56035,56,035,Sublette County,5720,5525,195,2092,3.4
0500000US56045,56,045,Weston County,3305,3188,117,2397,3.5
0500000US01099,01,099,Monroe County,7781,6422,1359,9351,17.5
0500000US01079,01,079,Lawrence County,13334,12568,766,13388,5.7
0500000US01081,01,081,Lee County,77367,72956,4411,50763,5.7
0500000US01107,01,107,Pickens County,7978,7136,842,8859,10.6
0500000US01119,01,119,Sumter County,4787,4207,580,5966,12.1
0500000US01023,01,023,Choctaw County,4768,4264,504,6032,10.6
0500000US01091,01,091,Marengo County,7269,6563,706,8434,9.7
0500000US01113,01,113,Russell County,25550,23550,2000,18732,7.8
0500000US01039,01,039,Covington County,16327,14899,1428,13759,8.7
0500000US01041,01,041,Crenshaw County,5959,5612,347,5100,5.8
0500000US01077,01,077,Lauderdale County,42397,40130,2267,33634,5.3
0500000US01085,01,085,Lowndes County,3907,3457,450,4190,11.5
0500000US01083,01,083,Limestone County,42552,39595,2957,31622,6.9
0500000US01115,01,115,St. Clair County,41069,38881,2188,28370,5.3
0500000US01133,01,133,Winston County,9740,9000,740,9747,7.6
0500000US01043,01,043,Cullman County,34906,33003,1903,30924,5.5
0500000US01051,01,051,Elmore County,36030,33811,2219,28711,6.2
0500000US01071,01,071,Jackson County,21466,20189,1277,20873,5.9
0500000US01121,01,121,Talladega County,34086,31082,3004,31312,8.8
0500000US01129,01,129,Washington County,6055,5538,517,7508,8.5
0500000US01031,01,031,Coffee County,23096,21725,1371,16270,5.9
0500000US01103,01,103,Morgan County,54328,51513,2815,40624,5.2
0500000US01021,01,021,Chilton County,18836,17500,1336,15680,7.1
0500000US01033,01,033,Colbert County,23833,22436,1397,20448,5.9
0500000US01045,01,045,Dale County,19763,18025,1738,16897,8.8
0500000US01055,01,055,Etowah County,45312,42367,2945,38061,6.5
0500000US01049,01,049,DeKalb County,29988,28637,1351,25954,4.5
0500000US01075,01,075,Lamar County,5803,5338,465,5357,8.0
0500000US01111,01,111,Randolph County,9079,8628,451,9139,5.0
0500000US01097,01,097,Mobile County,185743,174229,11514,141445,6.2
0500000US01127,01,127,Walker County,27082,24707,2375,24718,8.8
0500000US01029,01,029,Cleburne County,6086,5628,458,5739,7.5
0500000US01063,01,063,Greene County,2619,2204,415,4042,15.8
0500000US01005,01,005,Barbour County,9638,8720,918,11310,9.5
0500000US01011,01,011,Bullock County,4430,3940,490,3983,11.1
0500000US01015,01,015,Calhoun County,52785,48157,4628,39945,8.8
0500000US01025,01,025,Clarke County,8930,7647,1283,10822,14.4
0500000US01101,01,101,Montgomery County,108842,100599,8243,68958,7.6
0500000US01095,01,095,Marshall County,41088,38997,2091,33009,5.1
0500000US01067,01,067,Henry County,7362,6868,494,6608,6.7
0500000US01089,01,089,Madison County,183263,172631,10632,103537,5.8
0500000US01123,01,123,Tallapoosa County,16838,15083,1755,16185,10.4
0500000US01131,01,131,Wilcox County,3412,2882,530,5136,15.5
0500000US02068,02,068,Denali Borough,1523,1478,45,445,3.0
0500000US02122,02,122,Kenai Peninsula Borough,27740,25564,2176,18540,7.8
0500000US02016,02,016,Aleutians West Census Area,3968,3889,79,850,2.0
0500000US02060,02,060,Bristol Bay Borough,531,488,43,176,8.1
0500000US02150,02,150,Kodiak Island Borough,7300,6919,381,2537,5.2
0500000US02188,02,188,Northwest Arctic Borough,3241,2636,605,2038,18.7
0500000US02050,02,050,Bethel Census Area,7559,6178,1381,4663,18.3
0500000US02185,02,185,North Slope Borough,6004,5465,539,1481,9.0
0500000US02220,02,220,Sitka City and Borough,4962,4746,216,2013,4.4
0500000US02090,02,090,Fairbanks North Star Borough,50069,46543,3526,21130,7.0
0500000US02130,02,130,Ketchikan Gateway Borough,7516,7017,499,3310,6.6
0500000US02170,02,170,Matanuska-Susitna Borough,47536,43000,4536,30319,9.5
0500000US02180,02,180,Nome Census Area,4397,3664,733,2444,16.7
0500000US02070,02,070,Dillingham Census Area,2298,2024,274,1304,11.9
0500000US02100,02,100,Haines Borough,1380,1329,51,628,3.7
0500000US02282,02,282,Yakutat City and Borough,380,357,23,138,6.1
0500000US02110,02,110,Juneau City and Borough,18634,17562,1072,7224,5.8
0500000US02164,02,164,Lake and Peninsula Borough,705,594,111,351,15.7
0500000US02240,02,240,Southeast Fairbanks Census Area,3226,2896,330,1832,10.2
0500000US02290,02,290,Yukon-Koyukuk Census Area,2609,2118,491,1463,18.8
0500000US02020,02,020,Anchorage Municipality,159183,150201,8982,63000,5.6
0500000US02013,02,013,Aleutians East Borough,2482,2395,87,517,3.5
0500000US02230,02,230,Skagway Municipality,746,695,51,158,6.8
0500000US02198,02,198,Prince of Wales-Hyder Census Area,3174,2789,385,1925,12.1
0500000US02195,02,195,Petersburg Borough,1647,1577,70,940,4.3
0500000US02158,02,158,Kusilvak Census Area,2937,2088,849,2239,28.9
0500000US04013,04,013,Maricopa County,2121295,2004236,117059,1203765,5.5
0500000US04009,04,009,Graham County,14166,12837,1329,14584,9.4
0500000US04023,04,023,Santa Cruz County,18798,17233,1565,16612,8.3
0500000US04012,04,012,La Paz County,7028,6466,562,10696,8.0
0500000US04015,04,015,Mohave County,78198,71244,6954,95566,8.9
0500000US04005,04,005,Coconino County,71700,66310,5390,42293,7.5
0500000US04027,04,027,Yuma County,84215,75912,8303,72564,9.9
0500000US04011,04,011,Greenlee County,4094,3812,282,3031,6.9
0500000US04021,04,021,Pinal County,163079,150294,12785,169048,7.8
0500000US05123,05,123,St. Francis County,9449,8697,752,11756,8.0
0500000US05145,05,145,White County,33993,32028,1965,28182,5.8
0500000US05099,05,099,Nevada County,3337,3151,186,3379,5.6
0500000US05037,05,037,Cross County,7974,7516,458,5465,5.7
0500000US05043,05,043,Drew County,8304,7825,479,6639,5.8
0500000US05027,05,027,Columbia County,10544,9469,1075,9019,10.2
0500000US05125,05,125,Saline County,58672,56382,2290,34767,3.9
0500000US05141,05,141,Van Buren County,6114,5675,439,7578,7.2
0500000US05065,05,065,Izard County,5130,4654,476,6222,9.3
0500000US05079,05,079,Lincoln County,3488,3366,122,8120,3.5
0500000US05083,05,083,Logan County,9560,8723,837,7977,8.8
0500000US05035,05,035,Crittenden County,22525,20402,2123,14508,9.4
0500000US05047,05,047,Franklin County,6986,6773,213,7167,3.0
0500000US05109,05,109,Pike County,4764,4548,216,3927,4.5
0500000US05069,05,069,Jefferson County,28935,26047,2888,27459,10.0
0500000US05097,05,097,Montgomery County,3481,3284,197,4023,5.7
0500000US05127,05,127,Scott County,4196,3763,433,3863,10.3
0500000US05131,05,131,Sebastian County,59831,56926,2905,40148,4.9
0500000US05007,05,007,Benton County,128841,125343,3498,68489,2.7
0500000US05017,05,017,Chicot County,3968,3583,385,4666,9.7
0500000US05071,05,071,Johnson County,10804,10363,441,9726,4.1
0500000US05077,05,077,Lee County,3196,2708,488,4699,15.3
0500000US05041,05,041,Desha County,4959,4426,533,4253,10.7
0500000US05049,05,049,Fulton County,4329,4045,284,5585,6.6
0500000US05051,05,051,Garland County,43378,40302,3076,37156,7.1
0500000US05115,05,115,Pope County,28902,27105,1797,21763,6.2
0500000US05117,05,117,Prairie County,3700,3465,235,3066,6.4
0500000US39161,39,161,Van Wert County,14255,13624,631,8208,4.4
0500000US39167,39,167,Washington County,28180,27060,1120,21957,4.0
0500000US39171,39,171,Williams County,18543,17734,809,10932,4.4
0500000US39011,39,011,Auglaize County,24181,23343,838,11815,3.5
0500000US39029,39,029,Columbiana County,49022,45728,3294,36003,6.7
0500000US39037,39,037,Darke County,25984,24771,1213,14787,4.7
0500000US39123,39,123,Ottawa County,20413,19463,950,13618,4.7
0500000US39051,39,051,Fulton County,21832,20788,1044,11688,4.8
0500000US39065,39,065,Hardin County,15218,14325,893,9915,5.9
0500000US39079,39,079,Jackson County,15124,13539,1585,10471,10.5
0500000US39095,39,095,Lucas County,216534,200292,16242,126718,7.5
0500000US39117,39,117,Morrow County,18144,17483,661,9738,3.6
0500000US39121,39,121,Noble County,4381,4171,210,7606,4.8
0500000US39135,39,135,Preble County,20732,19706,1026,12276,4.9
0500000US39147,39,147,Seneca County,27416,26063,1353,17303,4.9
0500000US39151,39,151,Stark County,190187,178755,11432,111985,6.0
0500000US39003,39,003,Allen County,51500,48430,3070,30818,6.0
0500000US39031,39,031,Coshocton County,16612,15575,1037,12131,6.2
0500000US39033,39,033,Crawford County,19846,18793,1053,13948,5.3
0500000US39041,39,041,Delaware County,104199,101375,2824,45258,2.7
0500000US39059,39,059,Guernsey County,17945,16691,1254,13565,7.0
0500000US39073,39,073,Hocking County,13367,12581,786,9660,5.9
0500000US39107,39,107,Mercer County,21494,20927,567,10123,2.6
0500000US39141,39,141,Ross County,32888,30398,2490,29429,7.6
0500000US39035,39,035,Cuyahoga County,644380,591135,53245,376231,8.3
0500000US39093,39,093,Lorain County,150868,141361,9507,95610,6.3
0500000US39109,39,109,Miami County,53519,51077,2442,29906,4.6
0500000US39113,39,113,Montgomery County,262404,243624,18780,163537,7.2
0500000US39155,39,155,Trumbull County,92469,87675,4794,72440,5.2
0500000US39173,39,173,Wood County,72255,68820,3435,34146,4.8
0500000US39007,39,007,Ashtabula County,42848,39737,3111,36077,7.3
0500000US40001,40,001,Adair County,8545,8089,456,8315,5.3
0500000US40137,40,137,Stephens County,19546,18265,1281,15337,6.6
0500000US40025,40,025,Cimarron County,1018,999,19,694,1.9
0500000US40019,40,019,Carter County,22143,20921,1222,15278,5.5
0500000US40053,40,053,Grant County,2112,2048,64,1367,3.0
0500000US40055,40,055,Greer County,2177,1993,184,2755,8.5
0500000US40087,40,087,McClain County,18543,17918,625,11168,3.4
0500000US40091,40,091,McIntosh County,7417,6895,522,8819,7.0
0500000US40099,40,099,Murray County,6231,5992,239,4771,3.8
0500000US40103,40,103,Noble County,5352,5133,219,3599,4.1
0500000US40115,40,115,Ottawa County,13699,12799,900,10974,6.6
0500000US40135,40,135,Sequoyah County,16845,15472,1373,15986,8.2
0500000US40145,40,145,Wagoner County,38607,36367,2240,22227,5.8
0500000US40151,40,151,Woods County,4639,4432,207,2921,4.5
0500000US40015,40,015,Caddo County,12193,11272,921,10633,7.6
0500000US40101,40,101,Muskogee County,28700,26897,1803,25182,6.3
0500000US40107,40,107,Okfuskee County,4241,3866,375,5343,8.8
0500000US40013,40,013,Bryan County,20479,19332,1147,15736,5.6
0500000US40059,40,059,Harper County,1778,1742,36,1162,2.0
0500000US40071,40,071,Kay County,20330,18912,1418,14639,7.0
0500000US40035,40,035,Craig County,6058,5708,350,5609,5.8
0500000US40143,40,143,Tulsa County,330702,312623,18079,165336,5.5
0500000US40017,40,017,Canadian County,71856,68679,3177,32593,4.4
0500000US40057,40,057,Harmon County,1292,1237,55,845,4.3
0500000US40077,40,077,Latimer County,4222,3880,342,4273,8.1
0500000US40113,40,113,Osage County,20288,18960,1328,17536,6.5
0500000US40139,40,139,Texas County,11406,11079,327,4559,2.9
0500000US40127,40,127,Pushmataha County,4534,4196,338,4368,7.5
0500000US40047,40,047,Garfield County,29525,28012,1513,16941,5.1
0500000US40069,40,069,Johnston County,4410,4097,313,4325,7.1
0500000US40121,40,121,Pittsburg County,18933,17700,1233,16667,6.5
0500000US40129,40,129,Roger Mills County,1662,1558,104,1148,6.3
0500000US40153,40,153,Woodward County,9759,9249,510,6518,5.2
0500000US40021,40,021,Cherokee County,20652,19115,1537,18191,7.4
0500000US40041,40,041,Delaware County,16581,15339,1242,17853,7.5
0500000US40045,40,045,Ellis County,1895,1790,105,1327,5.5
0500000US40051,40,051,Grady County,25605,24655,950,17343,3.7
0500000US40119,40,119,Payne County,38630,36741,1889,28628,4.9
0500000US40125,40,125,Pottawatomie County,31863,29887,1976,24738,6.2
0500000US40037,40,037,Creek County,31664,30518,1146,24393,3.6
0500000US40141,40,141,Tillman County,3278,3124,154,2626,4.7
0500000US40149,40,149,Washita County,5227,4995,232,3618,4.4
0500000US40033,40,033,Cotton County,2574,2379,195,2179,7.6
0500000US40075,40,075,Kiowa County,4165,3969,196,2948,4.7
0500000US40079,40,079,Le Flore County,20309,19091,1218,18954,6.0
0500000US40089,40,089,McCurtain County,13253,12437,816,12244,6.2
0500000US40093,40,093,Major County,3492,3390,102,2448,2.9
0500000US40097,40,097,Mayes County,18195,17234,961,14290,5.3
0500000US40109,40,109,Oklahoma County,389900,370683,19217,206991,4.9
0500000US40039,40,039,Custer County,14369,13892,477,8233,3.3
0500000US40007,40,007,Beaver County,2507,2395,112,1691,4.5
0500000US40085,40,085,Love County,4289,4103,186,3458,4.3
0500000US40009,40,009,Beckham County,9510,9113,397,7858,4.2
0500000US40023,40,023,Choctaw County,5593,5094,499,6081,8.9
0500000US40065,40,065,Jackson County,11129,10559,570,7168,5.1
0500000US40081,40,081,Lincoln County,15140,14330,810,12233,5.4
0500000US41047,41,047,Marion County,160227,150509,9718,100476,6.1
0500000US41029,41,029,Jackson County,100280,93750,6530,74395,6.5
0500000US41023,41,023,Grant County,3245,3002,243,2794,7.5
0500000US41031,41,031,Jefferson County,9508,8558,950,8855,10.0
0500000US41005,41,005,Clackamas County,212734,202784,9950,115083,4.7
0500000US41043,41,043,Linn County,56793,52322,4471,41153,7.9
0500000US41057,41,057,Tillamook County,10880,10361,519,10764,4.8
0500000US41001,41,001,Baker County,6538,5998,540,6710,8.3
0500000US41033,41,033,Josephine County,34097,31292,2805,36833,8.2
0500000US41059,41,059,Umatilla County,34886,32139,2747,24574,7.9
0500000US41041,41,041,Lincoln County,20475,19254,1221,20165,6.0
0500000US41009,41,009,Columbia County,23423,21783,1640,17794,7.0
0500000US41055,41,055,Sherman County,748,719,29,649,3.9
0500000US41065,41,065,Wasco County,12071,11539,532,8614,4.4
0500000US41039,41,039,Lane County,183022,170022,13000,124979,7.1
0500000US41045,41,045,Malheur County,11717,10814,903,11869,7.7
0500000US41067,41,067,Washington County,317073,301195,15878,142612,5.0
0500000US41049,41,049,Morrow County,5019,4791,228,3470,4.5
0500000US41007,41,007,Clatsop County,18420,17307,1113,12864,6.0
0500000US41015,41,015,Curry County,8155,7503,652,11430,8.0
0500000US41021,41,021,Gilliam County,809,734,75,745,9.3
0500000US41037,41,037,Lake County,3275,3077,198,3210,6.0
0500000US41061,41,061,Union County,12102,11322,780,8804,6.4
0500000US42045,42,045,Delaware County,294516,276888,17628,159117,6.0
0500000US42119,42,119,Union County,18995,18296,699,19164,3.7
0500000US42127,42,127,Wayne County,22558,21197,1361,21269,6.0
0500000US42043,42,043,Dauphin County,144292,137092,7200,75429,5.0
0500000US42053,42,053,Forest County,924,866,58,5856,6.3
0500000US42089,42,089,Monroe County,85210,78487,6723,53549,7.9
0500000US42101,42,101,Philadelphia County,766468,688298,78170,498307,10.2
0500000US42129,42,129,Westmoreland County,180813,172824,7989,116139,4.4
0500000US42013,42,013,Blair County,59583,56627,2956,41889,5.0
0500000US42021,42,021,Cambria County,61359,57311,4048,50146,6.6
0500000US42011,42,011,Berks County,217610,203128,14482,115994,6.7
0500000US42061,42,061,Huntingdon County,19729,18486,1243,18356,6.3
0500000US42073,42,073,Lawrence County,42095,39489,2606,30140,6.2
0500000US42087,42,087,Mifflin County,21868,21081,787,15360,3.6
0500000US42041,42,041,Cumberland County,130954,125972,4982,71388,3.8
0500000US42003,42,003,Allegheny County,660197,625294,34903,360135,5.3
0500000US42109,42,109,Snyder County,20764,20196,568,12148,2.7
0500000US42115,42,115,Susquehanna County,19452,18265,1187,15087,6.1
0500000US42039,42,039,Crawford County,40873,38481,2392,29217,5.9
0500000US42049,42,049,Erie County,134836,126884,7952,87865,5.9
0500000US42057,42,057,Fulton County,7013,6617,396,4892,5.6
0500000US42067,42,067,Juniata County,11623,11171,452,8012,3.9
0500000US42107,42,107,Schuylkill County,66841,62675,4166,51667,6.2
0500000US42131,42,131,Wyoming County,13773,12971,802,9054,5.8
0500000US42001,42,001,Adams County,52623,50247,2376,30983,4.5
0500000US42005,42,005,Armstrong County,31622,29632,1990,23459,6.3
0500000US42035,42,035,Clinton County,18936,17867,1069,13011,5.6
0500000US42025,42,025,Carbon County,31577,29356,2221,21342,7.0
0500000US42027,42,027,Centre County,80150,76741,3409,59749,4.3
0500000US42097,42,097,Northumberland County,43675,41723,1952,32538,4.5
0500000US42095,42,095,Northampton County,157256,148960,8296,90916,5.3
0500000US42023,42,023,Cameron County,2232,2152,80,1819,3.6
0500000US42121,42,121,Venango County,24446,22786,1660,18954,6.8
0500000US42007,42,007,Beaver County,85439,81095,4344,52474,5.1
0500000US42017,42,017,Bucks County,346229,330564,15665,166452,4.5
0500000US42069,42,069,Lackawanna County,103289,98366,4923,70186,4.8
0500000US42083,42,083,McKean County,19606,18267,1339,14937,6.8
0500000US42051,42,051,Fayette County,59386,55046,4340,50690,7.3
0500000US42091,42,091,Montgomery County,452489,431585,20904,210485,4.6
0500000US42059,42,059,Greene County,15330,14652,678,15485,4.4
0500000US42075,42,075,Lebanon County,70925,67157,3768,39326,5.3
0500000US42079,42,079,Luzerne County,160283,150246,10037,102538,6.3
0500000US42093,42,093,Montour County,8961,8761,200,6040,2.2
0500000US42037,42,037,Columbia County,31677,30132,1545,24146,4.9
0500000US42019,42,019,Butler County,97512,93394,4118,55556,4.2
0500000US42065,42,065,Jefferson County,20782,19889,893,14985,4.3
0500000US42071,42,071,Lancaster County,281273,270060,11213,143087,4.0
0500000US42099,42,099,Perry County,23673,22786,887,13506,3.7
0500000US42105,42,105,Potter County,7099,6631,468,6723,6.6
0500000US42117,42,117,Tioga County,19224,18091,1133,14792,5.9
0500000US44007,44,007,Providence County,332522,310070,22452,185527,6.8
0500000US44001,44,001,Bristol County,26105,25195,910,14632,3.5
0500000US44005,44,005,Newport County,43369,41378,1991,24008,4.6
0500000US45003,45,003,Aiken County,77562,71542,6020,56693,7.8
0500000US45071,45,071,Newberry County,17729,16459,1270,12913,7.2
0500000US45037,45,037,Edgefield County,11233,10489,744,11270,6.6
0500000US45027,45,027,Clarendon County,13295,11726,1569,14897,11.8
0500000US45029,45,029,Colleton County,17178,15620,1558,12741,9.1
0500000US45085,45,085,Sumter County,47636,42568,5068,33748,10.6
0500000US45063,45,063,Lexington County,147214,138852,8362,79517,5.7
0500000US45011,45,011,Barnwell County,8949,8235,714,7943,8.0
0500000US45015,45,015,Berkeley County,101750,96452,5298,57460,5.2
0500000US45031,45,031,Darlington County,30026,26540,3486,23858,11.6
0500000US45043,45,043,Georgetown County,27156,24850,2306,24257,8.5
0500000US45091,45,091,York County,134940,126871,8069,67326,6.0
0500000US45007,45,007,Anderson County,93867,88386,5481,61982,5.8
0500000US45025,45,025,Chesterfield County,20930,18961,1969,15975,9.4
0500000US45047,45,047,Greenwood County,32790,30079,2711,23274,8.3
0500000US45051,45,051,Horry County,152029,142291,9738,115642,6.4
0500000US45055,45,055,Kershaw County,29205,27280,1925,21793,6.6
0500000US45075,45,075,Orangeburg County,38529,34965,3564,32538,9.3
0500000US45001,45,001,Abbeville County,10548,9748,800,9521,7.6
0500000US45009,45,009,Bamberg County,5769,5433,336,6118,5.8
0500000US45017,45,017,Calhoun County,6823,6388,435,5440,6.4
0500000US45033,45,033,Dillon County,12390,11306,1084,11346,8.7
0500000US45079,45,079,Richland County,209230,194982,14248,109726,6.8
0500000US45039,45,039,Fairfield County,9361,8626,735,9497,7.9
0500000US45049,45,049,Hampton County,8380,7552,828,7524,9.9
0500000US45045,45,045,Greenville County,252439,240453,11986,142186,4.7
0500000US45057,45,057,Lancaster County,40942,38181,2761,30914,6.7
0500000US45035,45,035,Dorchester County,77483,73015,4468,43055,5.8
0500000US45041,45,041,Florence County,65652,60509,5143,43285,7.8
0500000US45059,45,059,Laurens County,30527,27963,2564,23138,8.4
0500000US45065,45,065,McCormick County,3032,2633,399,5538,13.2
0500000US45077,45,077,Pickens County,57895,54520,3375,44159,5.8
0500000US45087,45,087,Union County,12580,11637,943,9752,7.5
0500000US45089,45,089,Williamsburg County,12639,11712,927,13249,7.3
0500000US46003,46,003,Aurora County,1460,1442,18,663,1.2
0500000US46051,46,051,Grant County,3753,3716,37,2054,1.0
0500000US46123,46,123,Tripp County,2885,2783,102,1453,3.5
0500000US46071,46,071,Jackson County,1117,1023,94,1238,8.4
0500000US46099,46,099,Minnehaha County,107899,104419,3480,36151,3.2
0500000US46033,46,033,Custer County,4067,3928,139,3355,3.4
0500000US46069,46,069,Hyde County,681,668,13,417,1.9
0500000US46025,46,025,Clark County,1851,1786,65,962,3.5
0500000US46049,46,049,Faulk County,1094,1090,4,760,0.4
0500000US46077,46,077,Kingsbury County,2691,2670,21,1289,0.8
0500000US46129,46,129,Walworth County,2832,2753,79,1526,2.8
0500000US46027,46,027,Clay County,8118,7645,473,3576,5.8
0500000US46037,46,037,Day County,2706,2654,52,1719,1.9
0500000US46043,46,043,Douglas County,1460,1444,16,835,1.1
0500000US46063,46,063,Harding County,701,685,16,372,2.3
0500000US46089,46,089,McPherson County,1123,1032,91,818,8.1
0500000US46109,46,109,Roberts County,5025,4718,307,2755,6.1
0500000US46119,46,119,Sully County,685,681,4,363,0.6
0500000US46083,46,083,Lincoln County,30652,29972,680,9735,2.2
0500000US46079,46,079,Lake County,7036,6737,299,3228,4.2
0500000US46081,46,081,Lawrence County,13964,13595,369,7242,2.6
0500000US46029,46,029,Codington County,15712,15309,403,6399,2.6
0500000US46019,46,019,Butte County,5130,4935,195,2893,3.8
0500000US46031,46,031,Corson County,1743,1282,461,1056,26.4
0500000US46045,46,045,Edmunds County,1984,1933,51,1114,2.6
0500000US46021,46,021,Campbell County,734,727,7,447,1.0
0500000US46007,46,007,Bennett County,1388,1224,164,957,11.8
0500000US46055,46,055,Haakon County,959,934,25,674,2.6
0500000US46075,46,075,Jones County,431,410,21,220,4.9
0500000US46093,46,093,Meade County,14282,14081,201,6099,1.4
0500000US46125,46,125,Turner County,4352,4243,109,2160,2.5
0500000US46013,46,013,Brown County,21248,20784,464,9449,2.2
0500000US46061,46,061,Hanson County,1649,1629,20,782,1.2
0500000US46087,46,087,McCook County,3025,2909,116,1152,3.8
0500000US46095,46,095,Mellette County,624,573,51,817,8.2
0500000US46105,46,105,Perkins County,1629,1577,52,732,3.2
0500000US46103,46,103,Pennington County,56835,54687,2148,28339,3.8
0500000US46127,46,127,Union County,8225,8074,151,3748,1.8
0500000US46097,46,097,Miner County,1144,1114,30,573,2.6
0500000US46137,46,137,Ziebach County,1338,1029,309,667,23.1
0500000US46039,46,039,Deuel County,2331,2284,47,1080,2.0
0500000US46009,46,009,Bon Homme County,2951,2911,40,2862,1.4
0500000US46015,46,015,Brule County,2809,2752,57,1292,2.0
0500000US46047,46,047,Fall River County,3255,3197,58,2488,1.8
0500000US46053,46,053,Gregory County,2054,2032,22,1231,1.1
0500000US46102,46,102,Oglala Lakota County,4320,3469,851,5310,19.7
0500000US47119,47,119,Maury County,44329,42042,2287,26502,5.2
0500000US47173,47,173,Union County,7885,7209,676,7679,8.6
0500000US47125,47,125,Montgomery County,86151,80066,6085,49726,7.1
0500000US47043,47,043,Dickson County,23764,22818,946,17416,4.0
0500000US47129,47,129,Morgan County,7865,7263,602,10129,7.7
0500000US47061,47,061,Grundy County,5199,4756,443,5541,8.5
0500000US47123,47,123,Monroe County,18764,17042,1722,18439,9.2
0500000US47079,47,079,Henry County,13335,12437,898,12905,6.7
0500000US47029,47,029,Cocke County,15530,13973,1557,13427,10.0
0500000US47033,47,033,Crockett County,6418,6085,333,4946,5.2
0500000US47041,47,041,DeKalb County,8359,7931,428,7476,5.1
0500000US47095,47,095,Lake County,2208,1991,217,4355,9.8
0500000US47093,47,093,Knox County,238383,226894,11489,131575,4.8
0500000US47101,47,101,Lewis County,5133,4941,192,4448,3.7
0500000US47107,47,107,McMinn County,22723,21141,1582,19913,7.0
0500000US47117,47,117,Marshall County,15246,14297,949,10355,6.2
0500000US47131,47,131,Obion County,13610,12747,863,10957,6.3
0500000US47143,47,143,Rhea County,14317,13217,1100,11535,7.7
0500000US47151,47,151,Scott County,9105,8290,815,8164,9.0
0500000US47167,47,167,Tipton County,29545,27266,2279,18210,7.7
0500000US47001,47,001,Anderson County,35100,32986,2114,26491,6.0
0500000US47045,47,045,Dyer County,17309,15976,1333,12196,7.7
0500000US47049,47,049,Fentress County,7137,6640,497,7335,7.0
0500000US47053,47,053,Gibson County,21266,19867,1399,17388,6.6
0500000US47065,47,065,Hamilton County,179763,169798,9965,110832,5.5
0500000US47105,47,105,Loudon County,21833,20653,1180,20817,5.4
0500000US47149,47,149,Rutherford County,169438,161242,8196,69083,4.8
0500000US47159,47,159,Smith County,9125,8792,333,6377,3.6
0500000US47189,47,189,Wilson County,68760,66073,2687,35656,3.9
0500000US47163,47,163,Sullivan County,70391,66020,4371,59180,6.2
0500000US47177,47,177,Warren County,17994,16895,1099,13985,6.1
0500000US47179,47,179,Washington County,61683,58720,2963,43440,4.8
0500000US47005,47,005,Benton County,6106,5627,479,7271,7.8
0500000US47013,47,013,Campbell County,16729,15286,1443,15666,8.6
0500000US47015,47,015,Cannon County,6611,6286,325,4704,4.9
0500000US47047,47,047,Fayette County,18909,17629,1280,13830,6.8
0500000US47067,47,067,Hancock County,2506,2295,211,2882,8.4
0500000US47091,47,091,Johnson County,6039,5810,229,9120,3.8
0500000US47103,47,103,Lincoln County,15427,14678,749,11701,4.9
0500000US47127,47,127,Moore County,2899,2763,136,2303,4.7
0500000US47051,47,051,Franklin County,19080,18194,886,14956,4.6
0500000US47009,47,009,Blount County,62987,59749,3238,42456,5.1
0500000US47019,47,019,Carter County,24334,23008,1326,22769,5.4
0500000US47057,47,057,Grainger County,10318,9651,667,8564,6.5
0500000US47097,47,097,Lauderdale County,10225,9376,849,10749,8.3
0500000US47099,47,099,Lawrence County,17663,16131,1532,15767,8.7
0500000US47115,47,115,Marion County,13080,12401,679,10128,5.2
0500000US47133,47,133,Overton County,9358,8982,376,8390,4.0
0500000US47165,47,165,Sumner County,93808,90151,3657,47504,3.9
0500000US47169,47,169,Trousdale County,4486,4051,435,3367,9.7
0500000US47187,47,187,Williamson County,114160,110383,3777,51380,3.3
0500000US47027,47,027,Clay County,2843,2717,126,3468,4.4
0500000US47059,47,059,Greene County,30210,28254,1956,26824,6.5
0500000US47157,47,157,Shelby County,468378,432142,36236,257195,7.7
0500000US47175,47,175,Van Buren County,2441,2153,288,2319,11.8
0500000US47077,47,077,Henderson County,12266,11310,956,9911,7.8
0500000US47081,47,081,Hickman County,10278,9771,507,9809,4.9
0500000US47089,47,089,Jefferson County,24342,22913,1429,19364,5.9
0500000US47153,47,153,Sequatchie County,6279,5929,350,5774,5.6
0500000US47155,47,155,Sevier County,49040,46263,2777,29574,5.7
0500000US47017,47,017,Carroll County,11583,10892,691,11128,6.0
0500000US47023,47,023,Chester County,7554,6840,714,6313,9.5
0500000US47037,47,037,Davidson County,391360,373294,18066,160447,4.6
0500000US47087,47,087,Jackson County,4707,4335,372,5053,7.9
0500000US47135,47,135,Perry County,3044,2790,254,3374,8.3
0500000US47145,47,145,Roane County,23034,21345,1689,21231,7.3
0500000US47121,47,121,Meigs County,4944,4480,464,4796,9.4
0500000US47063,47,063,Hamblen County,28377,26125,2252,22227,7.9
0500000US47075,47,075,Haywood County,8238,7648,590,5949,7.2
0500000US48143,48,143,Erath County,20287,19604,683,13490,3.4
0500000US48039,48,039,Brazoria County,173351,165147,8204,96838,4.7
0500000US48345,48,345,Motley County,545,503,42,329,7.7
0500000US48129,48,129,Donley County,1521,1487,34,1235,2.2
0500000US48013,48,013,Atascosa County,21796,20037,1759,14729,8.1
0500000US48083,48,083,Coleman County,3461,3348,113,3348,3.3
0500000US48353,48,353,Nolan County,6565,6092,473,4961,7.2
0500000US48229,48,229,Hudspeth County,1220,1119,101,1968,8.3
0500000US48325,48,325,Medina County,22158,21359,799,16921,3.6
0500000US48475,48,475,Ward County,5242,4914,328,3498,6.3
0500000US48213,48,213,Henderson County,33280,31583,1697,31869,5.1
0500000US48203,48,203,Harrison County,29923,28251,1672,21639,5.6
0500000US48327,48,327,Menard County,1164,1128,36,666,3.1
0500000US48277,48,277,Lamar County,22481,21218,1263,16541,5.6
0500000US48149,48,149,Fayette County,11397,11209,188,9110,1.6
0500000US48491,48,491,Williamson County,278826,266094,12732,124131,4.6
0500000US48373,48,373,Polk County,19941,18582,1359,19271,6.8
0500000US48391,48,391,Refugio County,3103,2809,294,2598,9.5
0500000US48055,48,055,Caldwell County,18842,18334,508,13945,2.7
0500000US48487,48,487,Wilbarger County,6655,6395,260,3690,3.9
0500000US48383,48,383,Reagan County,1762,1685,77,969,4.4
0500000US48189,48,189,Hale County,15170,14154,1016,10533,6.7
0500000US48419,48,419,Shelby County,10260,9522,738,9126,7.2
0500000US48399,48,399,Runnels County,4473,4354,119,3653,2.7
0500000US48407,48,407,San Jacinto County,10825,10060,765,11300,7.1
0500000US48451,48,451,Tom Green County,56144,53898,2246,33278,4.0
0500000US48469,48,469,Victoria County,45032,42576,2456,26034,5.5
0500000US48473,48,473,Waller County,24200,22715,1485,14928,6.1
0500000US48485,48,485,Wichita County,58292,55188,3104,40847,5.3
0500000US48493,48,493,Wilson County,22661,21274,1387,15120,6.1
0500000US48219,48,219,Hockley County,11156,10373,783,6547,7.0
0500000US48323,48,323,Maverick County,24337,21520,2817,17436,11.6
0500000US48329,48,329,Midland County,85702,82866,2836,36151,3.3
0500000US48297,48,297,Live Oak County,4539,4437,102,5357,2.2
0500000US48299,48,299,Llano County,8381,7748,633,9607,7.6
0500000US48147,48,147,Fannin County,14120,13461,659,13615,4.7
0500000US48255,48,255,Karnes County,5625,5382,243,6842,4.3
0500000US48041,48,041,Brazos County,109653,104813,4840,69026,4.4
0500000US48067,48,067,Cass County,12520,11615,905,11431,7.2
0500000US48165,48,165,Gaines County,8691,8273,418,4891,4.8
0500000US48179,48,179,Gray County,9861,9264,597,7533,6.1
0500000US48313,48,313,Madison County,4542,4402,140,6842,3.1
0500000US48237,48,237,Jack County,3359,3251,108,3850,3.2
0500000US48259,48,259,Kendall County,20377,19498,879,12910,4.3
0500000US48035,48,035,Bosque County,7917,7563,354,6728,4.5
0500000US48029,48,029,Bexar County,941816,887464,54352,523941,5.8
0500000US48017,48,017,Bailey County,3347,3273,74,1947,2.2
0500000US48023,48,023,Baylor County,1542,1505,37,1353,2.4
0500000US48061,48,061,Cameron County,168689,157501,11188,136976,6.6
0500000US48121,48,121,Denton County,455705,436490,19215,169679,4.2
0500000US48477,48,477,Washington County,15829,14874,955,12321,6.0
0500000US48343,48,343,Morris County,5614,5135,479,4258,8.5
0500000US48429,48,429,Stephens County,3915,3647,268,3573,6.8
0500000US48201,48,201,Harris County,2366473,2223265,143208,1125015,6.1
0500000US48003,48,003,Andrews County,8625,8221,404,4291,4.7
0500000US48171,48,171,Gillespie County,12442,11911,531,9216,4.3
0500000US48177,48,177,Gonzales County,9495,9083,412,6132,4.3
0500000US48305,48,305,Lynn County,2557,2342,215,1872,8.4
0500000US48503,48,503,Young County,8300,8045,255,5896,3.1
0500000US48505,48,505,Zapata County,5657,5036,621,4355,11.0
0500000US48221,48,221,Hood County,24655,23937,718,21471,2.9
0500000US48223,48,223,Hopkins County,16692,15927,765,11456,4.6
0500000US48357,48,357,Ochiltree County,4895,4627,268,2595,5.5
0500000US48269,48,269,King County,132,122,10,39,7.6
0500000US48275,48,275,Knox County,1538,1454,84,1300,5.5
0500000US48309,48,309,McLennan County,118563,113281,5282,74902,4.5
0500000US48073,48,073,Cherokee County,21530,20364,1166,18629,5.4
0500000US48095,48,095,Concho County,1260,1245,15,2495,1.2
0500000US48119,48,119,Delta County,2176,2060,116,1980,5.3
0500000US48137,48,137,Edwards County,941,902,39,799,4.1
0500000US48133,48,133,Eastland County,6890,6531,359,8028,5.2
0500000US48253,48,253,Jones County,5076,4877,199,11738,3.9
0500000US48389,48,389,Reeves County,6125,5681,444,5983,7.2
0500000US48403,48,403,Sabine County,3379,3135,244,5426,7.2
0500000US48421,48,421,Sherman County,1643,1629,14,799,0.9
0500000US48437,48,437,Swisher County,2843,2657,186,3011,6.5
0500000US48231,48,231,Hunt County,42404,40070,2334,30019,5.5
0500000US48063,48,063,Camp County,5586,5239,347,4216,6.2
0500000US48195,48,195,Hansford County,2396,2286,110,1721,4.6
0500000US48187,48,187,Guadalupe County,75113,72170,2943,43411,3.9
0500000US48077,48,077,Clay County,4678,4355,323,3809,6.9
0500000US48217,48,217,Hill County,16124,14899,1225,11966,7.6
0500000US48347,48,347,Nacogdoches County,30535,27948,2587,21111,8.5
0500000US48369,48,369,Parmer County,4537,4476,61,2765,1.3
0500000US48377,48,377,Presidio County,2814,2532,282,2582,10.0
0500000US48465,48,465,Val Verde County,20058,18916,1142,14929,5.7
0500000US48135,48,135,Ector County,78917,73658,5259,36586,6.7
0500000US48173,48,173,Glasscock County,694,694,0,436,0.0
0500000US48185,48,185,Grimes County,11107,10583,524,10955,4.7
0500000US48085,48,085,Collin County,512045,492047,19998,210081,3.9
0500000US48005,48,005,Angelina County,38864,35779,3085,28648,7.9
0500000US48101,48,101,Cottle County,716,655,61,428,8.5
0500000US48209,48,209,Hays County,109560,103747,5813,51863,5.3
0500000US48295,48,295,Lipscomb County,1736,1630,106,918,6.1
0500000US48321,48,321,Matagorda County,16890,15709,1181,11527,7.0
0500000US48371,48,371,Pecos County,6318,6096,222,5973,3.5
0500000US48397,48,397,Rockwall County,48223,46149,2074,22569,4.3
0500000US48401,48,401,Rusk County,22207,20822,1385,20377,6.2
0500000US48447,48,447,Throckmorton County,743,703,40,569,5.4
0500000US48471,48,471,Walker County,25811,24925,886,35989,3.4
0500000US48499,48,499,Wood County,16929,15878,1051,19348,6.2
0500000US48007,48,007,Aransas County,10919,10195,724,9833,6.6
0500000US48075,48,075,Childress County,3147,2801,346,2888,11.0
0500000US48081,48,081,Coke County,1457,1411,46,1243,3.2
0500000US48099,48,099,Coryell County,25694,23340,2354,25628,9.2
0500000US48211,48,211,Hemphill County,2019,1917,102,902,5.1
0500000US48341,48,341,Moore County,10612,10090,522,5022,4.9
0500000US48349,48,349,Navarro County,22753,20941,1812,14628,8.0
0500000US48405,48,405,San Augustine County,2861,2591,270,4004,9.4
0500000US48417,48,417,Shackelford County,1645,1512,133,972,8.1
0500000US48427,48,427,Starr County,25494,21842,3652,19707,14.3
0500000US48461,48,461,Upton County,1464,1437,27,1215,1.8
0500000US48021,48,021,Bastrop County,37547,35049,2498,26182,6.7
0500000US48191,48,191,Hall County,1383,1236,147,1064,10.6
0500000US48159,48,159,Franklin County,5029,4654,375,3426,7.5
0500000US48163,48,163,Frio County,7228,6757,471,8209,6.5
0500000US48281,48,281,Lampasas County,9455,8776,679,6911,7.2
0500000US48319,48,319,Mason County,2242,2115,127,1265,5.7
0500000US48125,48,125,Dickens County,879,743,136,931,15.5
0500000US48439,48,439,Tarrant County,1050005,997459,52546,489453,5.0
0500000US48001,48,001,Anderson County,19865,19206,659,27991,3.3
0500000US48239,48,239,Jackson County,6860,6580,280,4541,4.1
0500000US48331,48,331,Milam County,10363,9931,432,8906,4.2
0500000US48093,48,093,Comanche County,5812,5638,174,4971,3.0
0500000US48047,48,047,Brooks County,2843,2428,415,2695,14.6
0500000US19029,19,029,Cass County,6614,6455,159,4056,2.4
0500000US19035,19,035,Cherokee County,6071,5930,141,3225,2.3
0500000US19047,19,047,Crawford County,8592,7993,599,4755,7.0
0500000US19057,19,057,Des Moines County,20147,19087,1060,11424,5.3
0500000US19065,19,065,Fayette County,10290,9937,353,5945,3.4
0500000US19085,19,085,Harrison County,7461,7347,114,3846,1.5
0500000US19109,19,109,Kossuth County,7734,7496,238,4406,3.1
0500000US19129,19,129,Mills County,7767,7475,292,4036,3.8
0500000US19133,19,133,Monona County,4404,4269,135,2781,3.1
0500000US19139,19,139,Muscatine County,22056,21523,533,11351,2.4
0500000US19143,19,143,Osceola County,3243,3162,81,1572,2.5
0500000US19153,19,153,Polk County,265328,253971,11357,101965,4.3
0500000US19187,19,187,Webster County,17829,17033,796,12074,4.5
0500000US19169,19,169,Story County,54205,51875,2330,28275,4.3
0500000US19193,19,193,Woodbury County,54128,51572,2556,24317,4.7
0500000US19013,19,013,Black Hawk County,72835,69573,3262,34324,4.5
0500000US19075,19,075,Grundy County,6380,6244,136,3429,2.1
0500000US19097,19,097,Jackson County,9964,9531,433,5733,4.3
0500000US19105,19,105,Jones County,10218,9825,393,6428,3.8
0500000US19111,19,111,Lee County,17158,15928,1230,10722,7.2
0500000US19131,19,131,Mitchell County,5392,5225,167,3039,3.1
0500000US19181,19,181,Warren County,26886,25999,887,11507,3.3
0500000US19161,19,161,Sac County,5182,5027,155,2726,3.0
0500000US19149,19,149,Plymouth County,13621,13314,307,5911,2.3
0500000US19041,19,041,Clay County,8569,8262,307,4434,3.6
0500000US19045,19,045,Clinton County,23705,22653,1052,13921,4.4
0500000US20183,20,183,Smith County,1745,1697,48,1285,2.8
0500000US20067,20,067,Grant County,3814,3611,203,1608,5.3
0500000US20095,20,095,Kingman County,3778,3579,199,2231,5.3
0500000US20131,20,131,Nemaha County,5233,5132,101,2533,1.9
0500000US20149,20,149,Pottawatomie County,11323,10868,455,5844,4.0
0500000US20021,20,021,Cherokee County,9126,8699,427,6993,4.7
0500000US20015,20,015,Butler County,32476,31098,1378,18772,4.2
0500000US20105,20,105,Lincoln County,1538,1464,74,936,4.8
0500000US20191,20,191,Sumner County,11144,10727,417,7019,3.7
0500000US20195,20,195,Trego County,1661,1634,27,713,1.6
0500000US20205,20,205,Wilson County,4263,4045,218,2692,5.1
0500000US20207,20,207,Woodson County,1531,1400,131,1026,8.6
0500000US20135,20,135,Ness County,1426,1387,39,945,2.7
0500000US20141,20,141,Osborne County,1817,1771,46,1099,2.5
0500000US20011,20,011,Bourbon County,6495,6334,161,4753,2.5
0500000US20075,20,075,Hamilton County,1218,1192,26,678,2.1
0500000US20097,20,097,Kiowa County,1282,1249,33,741,2.6
0500000US20177,20,177,Shawnee County,88383,84391,3992,51707,4.5
0500000US20181,20,181,Sherman County,3033,2905,128,1646,4.2
0500000US20193,20,193,Thomas County,4409,4327,82,1797,1.9
0500000US20125,20,125,Montgomery County,15363,14519,844,10569,5.5
0500000US20127,20,127,Morris County,2687,2602,85,1787,3.2
0500000US20153,20,153,Rawlins County,1245,1226,19,807,1.5
0500000US20163,20,163,Rooks County,2514,2414,100,1573,4.0
0500000US20025,20,025,Clark County,1032,1020,12,561,1.2
0500000US20053,20,053,Ellsworth County,2778,2678,100,2480,3.6
0500000US20077,20,077,Harper County,2616,2536,80,1828,3.1
0500000US20167,20,167,Russell County,3436,3221,215,2268,6.3
0500000US20111,20,111,Lyon County,18422,17377,1045,8196,5.7
0500000US20145,20,145,Pawnee County,2653,2595,58,3075,2.2
0500000US20001,20,001,Allen County,6168,5887,281,3941,4.6
0500000US20033,20,033,Comanche County,981,958,23,461,2.3
0500000US20049,20,049,Elk County,1060,993,67,1029,6.3
0500000US20063,20,063,Gove County,1314,1290,24,799,1.8
0500000US20079,20,079,Harvey County,17444,16922,522,9582,3.0
0500000US20083,20,083,Hodgeman County,976,946,30,526,3.1
0500000US20093,20,093,Kearny County,1755,1693,62,1124,3.5
0500000US20185,20,185,Stafford County,2131,2040,91,1198,4.3
0500000US20113,20,113,McPherson County,15290,14932,358,7596,2.3
0500000US20139,20,139,Osage County,7835,7419,416,4745,5.3
0500000US20071,20,071,Greeley County,570,565,5,351,0.9
0500000US20031,20,031,Coffey County,4314,4126,188,2405,4.4
0500000US20037,20,037,Crawford County,19723,18831,892,11778,4.5
0500000US20051,20,051,Ellis County,16642,16239,403,6604,2.4
0500000US20073,20,073,Greenwood County,2959,2866,93,2043,3.1
0500000US20099,20,099,Labette County,9940,9545,395,6049,4.0
0500000US20107,20,107,Linn County,4405,4145,260,3326,5.9
0500000US20173,20,173,Sedgwick County,260607,246997,13610,130437,5.2
0500000US20175,20,175,Seward County,11328,10733,595,4760,5.3
0500000US20157,20,157,Republic County,2391,2332,59,1510,2.5
0500000US20065,20,065,Graham County,1191,1149,42,891,3.5
0500000US20091,20,091,Johnson County,327589,317390,10199,128465,3.1
0500000US20045,20,045,Douglas County,69358,66273,3085,29967,4.4
0500000US20179,20,179,Sheridan County,1290,1261,29,651,2.2
0500000US20121,20,121,Miami County,16941,16404,537,8860,3.2
0500000US20069,20,069,Gray County,3260,3166,94,1225,2.9
0500000US20199,20,199,Wallace County,801,781,20,422,2.5
0500000US20189,20,189,Stevens County,2669,2549,120,1476,4.5
0500000US20201,20,201,Washington County,2772,2692,80,1657,2.9
0500000US20019,20,019,Chautauqua County,1515,1403,112,1229,7.4
0500000US20129,20,129,Morton County,1323,1276,47,893,3.6
0500000US20155,20,155,Reno County,31274,29866,1408,19084,4.5
0500000US20029,20,029,Cloud County,4716,4496,220,2519,4.7
0500000US20043,20,043,Doniphan County,3858,3712,146,2559,3.8
0500000US20081,20,081,Haskell County,1989,1938,51,996,2.6
0500000US20101,20,101,Lane County,906,885,21,405,2.3
0500000US20171,20,171,Scott County,2692,2589,103,1083,3.8
0500000US20133,20,133,Neosho County,7646,7359,287,4888,3.8
0500000US20013,20,013,Brown County,4668,4500,168,2752,3.6
0500000US20147,20,147,Phillips County,2758,2690,68,1562,2.5
0500000US20161,20,161,Riley County,38784,36646,2138,18636,5.5
0500000US20039,20,039,Decatur County,1418,1386,32,968,2.3
0500000US20087,20,087,Jefferson County,9827,9287,540,5273,5.5
0500000US21031,21,031,Butler County,5404,5078,326,4808,6.0
0500000US21061,21,061,Edmonson County,5083,4642,441,5049,8.7
0500000US21097,21,097,Harrison County,8438,8008,430,6455,5.1
0500000US21023,21,023,Bracken County,3833,3622,211,2624,5.5
0500000US21143,21,143,Lyon County,2936,2857,79,4165,2.7
0500000US21063,21,063,Elliott County,1880,1792,88,4443,4.7
0500000US21111,21,111,Jefferson County,404378,380718,23660,209169,5.9
0500000US21123,21,123,Larue County,6674,6287,387,4711,5.8
0500000US21161,21,161,Mason County,7472,7067,405,6148,5.4
0500000US21167,21,167,Mercer County,10436,9480,956,6820,9.2
0500000US21201,21,201,Robertson County,959,916,43,848,4.5
0500000US21207,21,207,Russell County,6872,6298,574,7326,8.4
0500000US21229,21,229,Washington County,6047,5751,296,3421,4.9
0500000US21007,21,007,Ballard County,3537,3341,196,2950,5.5
0500000US21009,21,009,Barren County,20063,18622,1441,14536,7.2
0500000US21087,21,087,Green County,4767,4562,205,4200,4.3
0500000US21091,21,091,Hancock County,3852,3628,224,2869,5.8
0500000US21159,21,159,Martin County,3591,3099,492,6167,13.7
0500000US21093,21,093,Hardin County,50956,47969,2987,30260,5.9
0500000US21149,21,149,McLean County,4055,3771,284,3204,7.0
0500000US21183,21,183,Ohio County,10594,9628,966,8157,9.1
0500000US21197,21,197,Powell County,4995,4644,351,4682,7.0
0500000US21233,21,233,Webster County,5408,5143,265,5061,4.9
0500000US21033,21,033,Caldwell County,5646,5365,281,4571,5.0
0500000US21045,21,045,Casey County,6069,5563,506,6551,8.3
0500000US21047,21,047,Christian County,25851,23711,2140,20612,8.3
0500000US21085,21,085,Grayson County,11040,10556,484,9635,4.4
0500000US21103,21,103,Henry County,7451,7058,393,5109,5.3
0500000US21107,21,107,Hopkins County,19843,18721,1122,16526,5.7
0500000US21109,21,109,Jackson County,4769,4290,479,5965,10.0
0500000US21125,21,125,Laurel County,25278,23236,2042,22532,8.1
0500000US21157,21,157,Marshall County,13704,12950,754,11928,5.5
0500000US21163,21,163,Meade County,13037,12105,932,8705,7.1
0500000US21173,21,173,Montgomery County,12143,11353,790,9718,6.5
0500000US21181,21,181,Nicholas County,3020,2805,215,2593,7.1
0500000US21185,21,185,Oldham County,32574,31579,995,18015,3.1
0500000US21187,21,187,Owen County,4320,4098,222,4174,5.1
0500000US21203,21,203,Rockcastle County,7062,6477,585,6556,8.3
0500000US21209,21,209,Scott County,28677,27517,1160,12636,4.0
0500000US21227,21,227,Warren County,65441,62113,3328,35230,5.1
0500000US21003,21,003,Allen County,9120,8616,504,7201,5.5
0500000US21017,21,017,Bourbon County,10044,9402,642,6015,6.4
0500000US21019,21,019,Boyd County,20173,18353,1820,18734,9.0
0500000US21029,21,029,Bullitt County,41271,39278,1993,22472,4.8
0500000US21055,21,055,Crittenden County,3795,3643,152,3539,4.0
0500000US21067,21,067,Fayette County,175829,166264,9565,82265,5.4
0500000US21075,21,075,Fulton County,2381,2223,158,2615,6.6
0500000US21115,21,115,Johnson County,7581,6854,727,10788,9.6
0500000US21165,21,165,Menifee County,2446,2293,153,2768,6.3
0500000US21175,21,175,Morgan County,3902,3671,231,7245,5.9
0500000US21193,21,193,Perry County,10304,8870,1434,11317,13.9
0500000US21237,21,237,Wolfe County,2170,1788,382,3537,17.6
0500000US21051,21,051,Clay County,6134,5492,642,10510,10.5
0500000US21013,21,013,Bell County,8286,7543,743,13727,9.0
0500000US21025,21,025,Breathitt County,4470,3950,520,6301,11.6
0500000US21083,21,083,Graves County,16952,15639,1313,12326,7.7
0500000US21099,21,099,Hart County,7622,7096,526,6860,6.9
0500000US21231,21,231,Wayne County,7703,7224,479,9087,6.2
0500000US21155,21,155,Marion County,8526,7751,775,6543,9.1
0500000US21221,21,221,Trigg County,6373,5750,623,5185,9.8
0500000US21015,21,015,Boone County,69183,66174,3009,29684,4.3
0500000US21131,21,131,Leslie County,3210,2880,330,5195,10.3
0500000US21121,21,121,Knox County,10984,10191,793,13922,7.2
0500000US21127,21,127,Lawrence County,5145,4679,466,7304,9.1
0500000US21139,21,139,Livingston County,4178,3955,223,3368,5.3
0500000US21195,21,195,Pike County,22504,20501,2003,26852,8.9
0500000US21211,21,211,Shelby County,23861,22729,1132,12941,4.7
0500000US21005,21,005,Anderson County,11242,10381,861,6232,7.7
0500000US21027,21,027,Breckinridge County,8492,7785,707,7499,8.3
0500000US21073,21,073,Franklin County,25804,24329,1475,15230,5.7
0500000US21117,21,117,Kenton County,87789,83543,4246,41352,4.8
0500000US21151,21,151,Madison County,45013,42056,2957,27655,6.6
0500000US21153,21,153,Magoffin County,4144,3654,490,5989,11.8
0500000US21189,21,189,Owsley County,1395,1245,150,2331,10.8
0500000US21213,21,213,Simpson County,8515,8242,273,5597,3.2
0500000US21217,21,217,Taylor County,10854,10231,623,9425,5.7
0500000US21219,21,219,Todd County,5074,4716,358,4282,7.1
0500000US21039,21,039,Carlisle County,1979,1862,117,1918,5.9
0500000US21053,21,053,Clinton County,3849,3573,276,4342,7.2
0500000US21077,21,077,Gallatin County,4046,3808,238,2786,5.9
0500000US21079,21,079,Garrard County,7947,7471,476,5879,6.0
0500000US21069,21,069,Fleming County,6601,6145,456,4654,6.9
0500000US21037,21,037,Campbell County,48901,46679,2222,26304,4.5
0500000US22113,22,113,Vermilion Parish,26625,24497,2128,19571,8.0
0500000US22089,22,089,St. Charles Parish,25919,24444,1475,15183,5.7
0500000US22029,22,029,Concordia Parish,7409,6939,470,8349,6.3
0500000US22107,22,107,Tensas Parish,1593,1327,266,2086,16.7
0500000US22093,22,093,St. James Parish,9634,9012,622,7396,6.5
0500000US22043,22,043,Grant Parish,7756,7320,436,10448,5.6
0500000US22051,22,051,Jefferson Parish,222629,209898,12731,126556,5.7
0500000US22013,22,013,Bienville Parish,4979,4710,269,5873,5.4
0500000US22015,22,015,Bossier Parish,57861,54532,3329,35560,5.8
0500000US22023,22,023,Cameron Parish,3371,3228,143,2241,4.2
0500000US22037,22,037,East Feliciana Parish,6997,6589,408,9324,5.8
0500000US22095,22,095,St. John the Baptist Parish,20915,19419,1496,13065,7.2
0500000US22075,22,075,Plaquemines Parish,10415,10036,379,6619,3.6
0500000US22073,22,073,Ouachita Parish,68875,64233,4642,52325,6.7
0500000US22079,22,079,Rapides Parish,57597,53433,4164,44318,7.2
0500000US22117,22,117,Washington Parish,18730,16678,2052,18000,11.0
0500000US22097,22,097,St. Landry Parish,32343,30347,1996,30802,6.2
0500000US22105,22,105,Tangipahoa Parish,60903,55675,5228,40767,8.6
0500000US22001,22,001,Acadia Parish,27905,25356,2549,19935,9.1
0500000US22101,22,101,St. Mary Parish,22125,20144,1981,18362,9.0
0500000US22123,22,123,West Carroll Parish,4141,3690,451,4745,10.9
0500000US22103,22,103,St. Tammany Parish,124831,117537,7294,72329,5.8
0500000US22111,22,111,Union Parish,8636,8090,546,9432,6.3
0500000US22021,22,021,Caldwell Parish,3686,3385,301,4177,8.2
0500000US22017,22,017,Caddo Parish,113171,105145,8026,81277,7.1
0500000US22035,22,035,East Carroll Parish,1507,1389,118,4434,7.8
0500000US22005,22,005,Ascension Parish,62573,58813,3760,29448,6.0
0500000US22055,22,055,Lafayette Parish,125541,119459,6082,63674,4.8
0500000US22045,22,045,Iberia Parish,34022,30536,3486,21710,10.2
0500000US22087,22,087,St. Bernard Parish,21002,18846,2156,13566,10.3
0500000US22091,22,091,St. Helena Parish,4217,3645,572,4116,13.6
0500000US22121,22,121,West Baton Rouge Parish,13119,12329,790,7021,6.0
0500000US22031,22,031,De Soto Parish,11907,10683,1224,9380,10.3
0500000US22081,22,081,Red River Parish,3310,3153,157,3434,4.7
0500000US22063,22,063,Livingston Parish,66292,63181,3111,39848,4.7
0500000US22069,22,069,Natchitoches Parish,14227,12249,1978,16273,13.9
0500000US22071,22,071,Orleans Parish,194755,178375,16380,123389,8.4
0500000US22025,22,025,Catahoula Parish,3735,3522,213,4207,5.7
0500000US22019,22,019,Calcasieu Parish,95570,90129,5441,59765,5.7
0500000US22041,22,041,Franklin Parish,7854,7087,767,7710,9.8
0500000US22007,22,007,Assumption Parish,10038,9306,732,8173,7.3
0500000US22049,22,049,Jackson Parish,5822,5470,352,6905,6.0
0500000US22083,22,083,Richland Parish,8192,7803,389,8013,4.7
0500000US22099,22,099,St. Martin Parish,25092,23380,1712,16931,6.8
0500000US22127,22,127,Winn Parish,5326,5083,243,6507,4.6
0500000US22033,22,033,East Baton Rouge Parish,231930,216944,14986,122195,6.5
0500000US22003,22,003,Allen Parish,9529,8618,911,10917,9.6
0500000US22065,22,065,Madison Parish,4069,3670,399,4946,9.8
0500000US23017,23,017,Oxford County,27480,25819,1661,20343,6.0
0500000US23027,23,027,Waldo County,19925,18818,1107,12873,5.6
0500000US23019,23,019,Penobscot County,76881,72687,4194,50151,5.5
0500000US23001,23,001,Androscoggin County,56644,54039,2605,29777,4.6
0500000US23003,23,003,Aroostook County,31338,29745,1593,26002,5.1
0500000US23005,23,005,Cumberland County,166952,161323,5629,74681,3.4
0500000US23013,23,013,Knox County,20976,20100,876,12469,4.2
0500000US23031,23,031,York County,111445,106832,4613,56730,4.1
0500000US23007,23,007,Franklin County,15156,14291,865,9998,5.7
0500000US23025,23,025,Somerset County,24001,21928,2073,18003,8.6
0500000US24047,24,047,Worcester County,25391,24042,1349,18246,5.3
0500000US24510,24,510,Baltimore city,306997,279034,27963,191429,9.1
0500000US24041,24,041,Talbot County,18520,17905,615,12599,3.3
0500000US24025,24,025,Harford County,135662,129104,6558,64204,4.8
0500000US24027,24,027,Howard County,175807,169065,6742,69516,3.8
0500000US24003,24,003,Anne Arundel County,306259,292038,14221,134810,4.6
0500000US24005,24,005,Baltimore County,442139,419089,23050,225903,5.2
0500000US24009,24,009,Calvert County,49309,46144,3165,22113,6.4
0500000US24023,24,023,Garrett County,14304,13734,570,10226,4.0
0500000US24031,24,031,Montgomery County,585038,556263,28775,234835,4.9
0500000US24013,24,013,Carroll County,91196,87999,3197,43955,3.5
0500000US24035,24,035,Queen Anne's County,26404,25639,765,13305,2.9
0500000US24037,24,037,St. Mary's County,56852,54788,2064,28422,3.6
0500000US24017,24,017,Charles County,82499,79180,3319,40126,4.0
0500000US24019,24,019,Dorchester County,16516,15209,1307,9694,7.9
0500000US24043,24,043,Washington County,71882,67191,4691,48442,6.5
0500000US24045,24,045,Wicomico County,53291,49229,4062,28907,7.6
0500000US24015,24,015,Cecil County,53450,50467,2983,28161,5.6
0500000US24011,24,011,Caroline County,16923,16036,887,8983,5.2
0500000US25025,25,025,Suffolk County,461751,429529,32222,209327,7.0
0500000US25001,25,001,Barnstable County,110282,105075,5207,74279,4.7
0500000US25007,25,007,Dukes County,8970,8684,286,5464,3.2
0500000US25017,25,017,Middlesex County,915319,876744,38575,395894,4.2
0500000US25003,25,003,Berkshire County,68314,64233,4081,40019,6.0
0500000US25005,25,005,Bristol County,300966,283422,17544,155299,5.8
0500000US25013,25,013,Hampden County,231939,216101,15838,146435,6.8
0500000US25023,25,023,Plymouth County,279842,264683,15159,134085,5.4
0500000US25009,25,009,Essex County,426401,403439,22962,206338,5.4
0500000US25011,25,011,Franklin County,38991,36982,2009,20975,5.2
0500000US25021,25,021,Norfolk County,391537,371989,19548,176264,5.0
0500000US25015,25,015,Hampshire County,89520,84200,5320,50543,5.9
0500000US25019,25,019,Nantucket County,6654,6471,183,2346,2.8
0500000US26115,26,115,Monroe County,73930,70306,3624,47473,4.9
0500000US26005,26,005,Allegan County,56729,54935,1794,33629,3.2
0500000US26059,26,059,Hillsdale County,20393,19370,1023,16552,5.0
0500000US26003,26,003,Alger County,3330,3112,218,4623,6.5
0500000US26127,26,127,Oceana County,11559,10708,851,9383,7.4
0500000US26089,26,089,Leelanau County,10323,9774,549,8260,5.3
0500000US26035,26,035,Clare County,12145,10915,1230,13149,10.1
0500000US26083,26,083,Keweenaw County,898,844,54,954,6.0
0500000US26073,26,073,Isabella County,36871,34086,2785,23085,7.6
0500000US26139,26,139,Ottawa County,153122,147178,5944,69792,3.9
0500000US26157,26,157,Tuscola County,24400,22830,1570,19076,6.4
0500000US26007,26,007,Alpena County,13322,12522,800,10529,6.0
0500000US26067,26,067,Ionia County,30037,28461,1576,20951,5.2
0500000US26111,26,111,Midland County,40684,38234,2450,26947,6.0
0500000US26021,26,021,Berrien County,76442,71586,4856,47998,6.4
0500000US26135,26,135,Oscoda County,3230,2839,391,3673,12.1
0500000US26039,26,039,Crawford County,5736,5267,469,5924,8.2
0500000US26037,26,037,Clinton County,39303,37744,1559,23086,4.0
0500000US26057,26,057,Gratiot County,17202,16042,1160,16611,6.7
0500000US26063,26,063,Huron County,14740,13946,794,11447,5.4
0500000US26091,26,091,Lenawee County,46739,44374,2365,33203,5.1
0500000US26105,26,105,Mason County,13396,12582,814,10221,6.1
0500000US26117,26,117,Montcalm County,28372,26929,1443,22177,5.1
0500000US26149,26,149,St. Joseph County,29551,28021,1530,18047,5.2
0500000US26147,26,147,St. Clair County,78473,73196,5277,51304,6.7
0500000US26161,26,161,Washtenaw County,196929,187609,9320,107859,4.7
0500000US26011,26,011,Arenac County,6354,5747,607,6402,9.6
0500000US26027,26,027,Cass County,25466,23766,1700,16638,6.7
0500000US26071,26,071,Iron County,4685,4402,283,4934,6.0
0500000US26143,26,143,Roscommon County,8565,7595,970,12150,11.3
0500000US26163,26,163,Wayne County,817808,734480,83328,570890,10.2
0500000US26023,26,023,Branch County,19736,18842,894,14887,4.5
0500000US26075,26,075,Jackson County,72782,67825,4957,55877,6.8
0500000US26097,26,097,Mackinac County,5092,4593,499,4175,9.8
0500000US26009,26,009,Antrim County,10360,9807,553,9084,5.3
0500000US26061,26,061,Houghton County,16308,15245,1063,13595,6.5
0500000US26069,26,069,Iosco County,10059,9238,821,11478,8.2
0500000US26085,26,085,Lake County,4057,3564,493,6015,12.2
0500000US26119,26,119,Montmorency County,3273,2894,379,4763,11.6
0500000US26141,26,141,Presque Isle County,5119,4664,455,5915,8.9
0500000US26077,26,077,Kalamazoo County,139824,131460,8364,70579,6.0
0500000US26107,26,107,Mecosta County,20039,18646,1393,16200,7.0
0500000US26103,26,103,Marquette County,31891,29934,1957,24117,6.1
0500000US26123,26,123,Newaygo County,21073,19795,1278,17372,6.1
0500000US26133,26,133,Osceola County,9671,9003,668,8970,6.9
0500000US26137,26,137,Otsego County,11564,10915,649,8331,5.6
0500000US26025,26,025,Calhoun County,63093,58671,4422,43685,7.0
0500000US26031,26,031,Cheboygan County,11439,10503,936,10209,8.2
0500000US26095,26,095,Luce County,2239,2111,128,3211,5.7
0500000US26081,26,081,Kent County,346056,329336,16720,156029,4.8
0500000US26099,26,099,Macomb County,448126,422419,25707,256704,5.7
0500000US26145,26,145,Saginaw County,89316,82611,6705,67135,7.5
0500000US26155,26,155,Shiawassee County,33497,31824,1673,22270,5.0
0500000US26013,26,013,Baraga County,2961,2772,189,4200,6.4
0500000US26017,26,017,Bay County,50224,46741,3483,35615,6.9
0500000US26029,26,029,Charlevoix County,12812,12240,572,8820,4.5
0500000US26045,26,045,Eaton County,55855,52908,2947,32904,5.3
0500000US26041,26,041,Delta County,16524,15640,884,13290,5.3
0500000US26053,26,053,Gogebic County,6366,6008,358,6989,5.6
0500000US26047,26,047,Emmet County,17445,16567,878,9883,5.0
0500000US05147,05,147,Woodruff County,2774,2526,248,2609,8.9
0500000US05023,05,023,Cleburne County,10737,10235,502,10317,4.7
0500000US05025,05,025,Cleveland County,3417,3230,187,3158,5.5
0500000US05067,05,067,Jackson County,5959,5563,396,8169,6.6
0500000US05057,05,057,Hempstead County,9352,8834,518,7533,5.5
0500000US05135,05,135,Sharp County,6182,5871,311,7625,5.0
0500000US05137,05,137,Stone County,4848,4540,308,5455,6.4
0500000US05143,05,143,Washington County,115108,110021,5087,62670,4.4
0500000US05005,05,005,Baxter County,16968,16232,736,17913,4.3
0500000US05003,05,003,Ashley County,8301,7728,573,7866,6.9
0500000US05031,05,031,Craighead County,51843,48814,3029,30515,5.8
0500000US05055,05,055,Greene County,20391,18971,1420,14581,7.0
0500000US05073,05,073,Lafayette County,2793,2630,163,2934,5.8
0500000US05105,05,105,Perry County,4038,3763,275,4179,6.8
0500000US05107,05,107,Phillips County,7652,6851,801,6942,10.5
0500000US05111,05,111,Poinsett County,10136,9539,597,8881,5.9
0500000US05133,05,133,Sevier County,7907,7498,409,4946,5.2
0500000US05149,05,149,Yell County,9511,8983,528,7270,5.6
0500000US05013,05,013,Calhoun County,2296,2155,141,1996,6.1
0500000US05019,05,019,Clark County,10765,10475,290,7846,2.7
0500000US05011,05,011,Bradley County,4577,4209,368,4015,8.0
0500000US05095,05,095,Monroe County,3202,2984,218,2749,6.8
0500000US05113,05,113,Polk County,8017,7292,725,8053,9.0
0500000US05103,05,103,Ouachita County,10608,9839,769,8548,7.2
0500000US05101,05,101,Newton County,3142,3080,62,3342,2.0
0500000US05081,05,081,Little River County,5386,4804,582,4597,10.8
0500000US05015,05,015,Carroll County,12457,11867,590,9954,4.7
0500000US05091,05,091,Miller County,19153,17600,1553,15542,8.1
0500000US06033,06,033,Lake County,26145,23589,2556,26171,9.8
0500000US06043,06,043,Mariposa County,7727,7051,676,7284,8.7
0500000US06115,06,115,Yuba County,31602,28954,2648,23343,8.4
0500000US06013,06,013,Contra Costa County,582886,547323,35563,318646,6.1
0500000US06035,06,035,Lassen County,9358,8788,570,17347,6.1
0500000US06083,06,083,Santa Barbara County,225612,211751,13861,128019,6.1
0500000US06097,06,097,Sonoma County,266964,253421,13543,144290,5.1
0500000US06025,06,025,Imperial County,70701,59919,10782,62868,15.3
0500000US06051,06,051,Mono County,8540,8278,262,3177,3.1
0500000US06001,06,001,Alameda County,892280,847170,45110,442149,5.1
0500000US06067,06,067,Sacramento County,740570,686019,54551,445040,7.4
0500000US06055,06,055,Napa County,74616,70888,3728,39796,5.0
0500000US06053,06,053,Monterey County,195500,185025,10475,130379,5.4
0500000US06091,06,091,Sierra County,1311,1251,60,1229,4.6
0500000US06073,06,073,San Diego County,1671892,1564930,106962,911554,6.4
0500000US06113,06,113,Yolo County,104096,97374,6722,70002,6.5
0500000US06023,06,023,Humboldt County,66297,60970,5327,45852,8.0
0500000US06003,06,003,Alpine County,445,366,79,489,17.8
0500000US06045,06,045,Mendocino County,41549,37712,3837,29429,9.2
0500000US06087,06,087,Santa Cruz County,143931,134904,9027,82182,6.3
0500000US06037,06,037,Los Angeles County,5226836,4869658,357178,2884764,6.8
0500000US06065,06,065,Riverside County,1102504,1007795,94709,735810,8.6
0500000US06085,06,085,Santa Clara County,1035436,985838,49598,501131,4.8
0500000US06041,06,041,Marin County,136574,131425,5149,76231,3.8
0500000US06093,06,093,Siskiyou County,18165,16725,1440,17660,7.9
0500000US06089,06,089,Shasta County,77216,72392,4824,67636,6.2
0500000US06015,06,015,Del Norte County,9619,8823,796,12373,8.3
0500000US06021,06,021,Glenn County,11800,10994,806,9539,6.8
0500000US06007,06,007,Butte County,103993,94908,9085,82599,8.7
0500000US06063,06,063,Plumas County,8052,7536,516,7933,6.4
0500000US06079,06,079,San Luis Obispo County,135533,129358,6175,99422,4.6
0500000US06029,06,029,Kern County,378440,339384,39056,272808,10.3
0500000US06059,06,059,Orange County,1662510,1578079,84431,874018,5.1
0500000US06009,06,009,Calaveras County,18230,17114,1116,20292,6.1
0500000US06101,06,101,Sutter County,42808,38664,4144,30333,9.7
0500000US06081,06,081,San Mateo County,427467,409911,17556,194669,4.1
0500000US06109,06,109,Tuolumne County,22446,20930,1516,23582,6.8
0500000US06077,06,077,San Joaquin County,334498,305509,28989,218838,8.7
0500000US06005,06,005,Amador County,14544,13289,1255,18101,8.6
0500000US08095,08,095,Phillips County,2064,2028,36,1263,1.7
0500000US08007,08,007,Archuleta County,6181,5823,358,4699,5.8
0500000US08031,08,031,Denver County,405269,389034,16235,159997,4.0
0500000US08061,08,061,Kiowa County,693,673,20,389,2.9
0500000US08055,08,055,Huerfano County,2705,2593,112,2871,4.1
0500000US08009,08,009,Baca County,1668,1627,41,1246,2.5
0500000US08015,08,015,Chaffee County,8920,8674,246,7586,2.8
0500000US08047,08,047,Gilpin County,3733,3645,88,1332,2.4
0500000US08063,08,063,Kit Carson County,3771,3587,184,2254,4.9
0500000US08045,08,045,Garfield County,32800,31397,1403,12328,4.3
0500000US08051,08,051,Gunnison County,10149,9560,589,3859,5.8
0500000US08059,08,059,Jefferson County,324838,312767,12071,143228,3.7
0500000US08079,08,079,Mineral County,429,422,7,321,1.6
0500000US08091,08,091,Ouray County,2466,2346,120,1644,4.9
0500000US08103,08,103,Rio Blanco County,3095,2935,160,1849,5.2
0500000US08115,08,115,Sedgwick County,1040,970,70,823,6.7
0500000US08021,08,021,Conejos County,3256,2882,374,2905,11.5
0500000US08023,08,023,Costilla County,1448,1287,161,1671,11.1
0500000US08001,08,001,Adams County,267457,255711,11746,107902,4.4
0500000US08037,08,037,Eagle County,34335,33571,764,9199,2.2
0500000US08065,08,065,Lake County,4369,4129,240,2151,5.5
0500000US08081,08,081,Moffat County,6531,6266,265,3578,4.1
0500000US08097,08,097,Pitkin County,12273,11742,531,3113,4.3
0500000US08017,08,017,Cheyenne County,903,835,68,520,7.5
0500000US08025,08,025,Crowley County,2170,1821,349,2820,16.1
0500000US08033,08,033,Dolores County,864,855,9,629,1.0
0500000US08057,08,057,Jackson County,687,672,15,369,2.2
0500000US08069,08,069,Larimer County,186774,177391,9383,91223,5.0
0500000US08083,08,083,Montezuma County,11780,11183,597,8899,5.1
0500000US08113,08,113,San Miguel County,5210,5075,135,1440,2.6
0500000US08013,08,013,Boulder County,182369,173653,8716,83376,4.8
0500000US08071,08,071,Las Animas County,6521,6021,500,5398,7.7
0500000US08125,08,125,Yuma County,5212,5078,134,2409,2.6
0500000US08107,08,107,Routt County,15082,14631,451,5783,3.0
0500000US08117,08,117,Summit County,20541,19827,714,5479,3.5
0500000US08019,08,019,Clear Creek County,5388,5287,101,2755,1.9
0500000US08029,08,029,Delta County,11922,10912,1010,12954,8.5
0500000US08101,08,101,Pueblo County,74061,67809,6252,56921,8.4
0500000US08087,08,087,Morgan County,13802,13191,611,7822,4.4
0500000US08093,08,093,Park County,9551,9038,513,5148,5.4
0500000US08077,08,077,Mesa County,75537,69681,5856,45169,7.8
0500000US08099,08,099,Prowers County,5793,5350,443,3540,7.6
0500000US08041,08,041,El Paso County,334686,314102,20584,173477,6.2
0500000US08121,08,121,Washington County,2361,2297,64,1516,2.7
0500000US08005,08,005,Arapahoe County,355395,339873,15522,143110,4.4
0500000US08014,08,014,Broomfield County,38164,36792,1372,14055,3.6
0500000US09009,09,009,New Haven County,459855,427791,32064,245027,7.0
0500000US09003,09,003,Hartford County,479254,447893,31361,248868,6.5
0500000US09015,09,015,Windham County,63387,59404,3983,32497,6.3
0500000US09007,09,007,Middlesex County,93406,89022,4384,43840,4.7
0500000US09013,09,013,Tolland County,84849,80396,4453,43100,5.2
0500000US10003,10,003,New Castle County,292654,274190,18464,155500,6.3
0500000US10005,10,005,Sussex County,102599,97523,5076,79759,4.9
0500000US11001,11,001,District of Columbia,398567,369194,29373,171535,7.4
0500000US12091,12,091,Okaloosa County,92723,87493,5230,58681,5.6
0500000US12123,12,123,Taylor County,6918,6486,432,11435,6.2
0500000US12133,12,133,Washington County,9342,8527,815,10879,8.7
0500000US12031,12,031,Duval County,471849,440797,31052,252622,6.6
0500000US12007,12,007,Bradford County,9910,9324,586,12232,5.9
0500000US12009,12,009,Brevard County,261578,245287,16291,220713,6.2
0500000US12019,12,019,Clay County,100946,93396,7550,61510,7.5
0500000US12067,12,067,Lafayette County,2839,2456,383,4283,13.5
0500000US12069,12,069,Lake County,145246,135768,9478,131697,6.5
0500000US12089,12,089,Nassau County,38196,36402,1794,27844,4.7
0500000US12103,12,103,Pinellas County,472955,446120,26835,343709,5.7
0500000US12105,12,105,Polk County,293895,273691,20204,241272,6.9
0500000US12111,12,111,St. Lucie County,135019,126185,8834,116067,6.5
0500000US12043,12,043,Glades County,4217,3763,454,7142,10.8
0500000US12051,12,051,Hendry County,18335,16808,1527,12324,8.3
0500000US12061,12,061,Indian River County,61303,56931,4372,66936,7.1
0500000US12063,12,063,Jackson County,18009,16418,1591,22606,8.8
0500000US12099,12,099,Palm Beach County,716569,669887,46682,482576,6.5
0500000US12109,12,109,St. Johns County,113569,108015,5554,76042,4.9
0500000US12117,12,117,Seminole County,240338,226769,13569,128871,5.6
0500000US12086,12,086,Miami-Dade County,1388666,1301540,87126,835191,6.3
0500000US12005,12,005,Bay County,86317,81102,5215,58034,6.0
0500000US12035,12,035,Flagler County,43037,40662,2375,47669,5.5
0500000US12037,12,037,Franklin County,4494,4158,336,5490,7.5
0500000US12047,12,047,Hamilton County,4284,3658,626,7577,14.6
0500000US12077,12,077,Liberty County,2735,2425,310,4432,11.3
0500000US12119,12,119,Sumter County,26701,25437,1264,86398,4.7
0500000US12039,12,039,Gadsden County,17763,16386,1377,18981,7.8
0500000US12059,12,059,Holmes County,7357,6567,790,8642,10.7
0500000US12071,12,071,Lee County,317948,299106,18842,285208,5.9
0500000US12083,12,083,Marion County,134735,122825,11910,155978,8.8
0500000US12021,12,021,Collier County,161981,154513,7468,144873,4.6
0500000US12095,12,095,Orange County,704100,661930,42170,352196,6.0
0500000US12101,12,101,Pasco County,223339,208871,14468,195489,6.5
0500000US12055,12,055,Highlands County,36778,32793,3985,49636,10.8
0500000US12121,12,121,Suwannee County,18140,16817,1323,17443,7.3
0500000US12027,12,027,DeSoto County,14011,13309,702,16069,5.0
0500000US12013,12,013,Calhoun County,5156,4799,357,6528,6.9
0500000US12023,12,023,Columbia County,28676,25965,2711,27027,9.5
0500000US12029,12,029,Dixie County,5046,4768,278,8738,5.5
0500000US12107,12,107,Putnam County,27904,24985,2919,30827,10.5
0500000US12125,12,125,Union County,4080,3724,356,8602,8.7
0500000US12081,12,081,Manatee County,166754,156850,9904,144668,5.9
0500000US12075,12,075,Levy County,16043,14954,1089,16761,6.8
0500000US12003,12,003,Baker County,11390,10762,628,10417,5.5
0500000US12127,12,127,Volusia County,233026,220015,13011,211748,5.6
0500000US12073,12,073,Leon County,157811,145442,12369,82453,7.8
0500000US12079,12,079,Madison County,6541,6169,372,8852,5.7
0500000US12033,12,033,Escambia County,144311,134938,9373,100322,6.5
0500000US12053,12,053,Hernando County,71502,66227,5275,81365,7.4
0500000US13037,13,037,Calhoun County,1908,1622,286,3525,15.0
0500000US13193,13,193,Macon County,5016,4416,600,6134,12.0
0500000US13021,13,021,Bibb County,68225,62200,6025,51815,8.8
0500000US13197,13,197,Marion County,3826,3432,394,3242,10.3
0500000US13249,13,249,Schley County,2488,2173,315,1691,12.7
0500000US13023,13,023,Bleckley County,4566,4230,336,5772,7.4
0500000US13093,13,093,Dooly County,5757,5038,719,5969,12.5
0500000US13119,13,119,Franklin County,9117,8644,473,9188,5.2
0500000US13103,13,103,Effingham County,29265,28083,1182,15032,4.0
0500000US13171,13,171,Lamar County,8026,7132,894,7198,11.1
0500000US13107,13,107,Emanuel County,9031,8340,691,8341,7.7
0500000US13239,13,239,Quitman County,899,799,100,993,11.1
0500000US13159,13,159,Jasper County,5724,5349,375,5090,6.6
0500000US13167,13,167,Johnson County,4628,4211,417,3400,9.0
0500000US13179,13,179,Liberty County,25617,22691,2926,14904,11.4
0500000US13205,13,205,Mitchell County,9524,8216,1308,8198,13.7
0500000US13253,13,253,Seminole County,3102,2864,238,3742,7.7
0500000US13277,13,277,Tift County,18663,18126,537,12730,2.9
0500000US13289,13,289,Twiggs County,2844,2647,197,4007,6.9
0500000US13233,13,233,Polk County,19189,18048,1141,13049,5.9
0500000US13263,13,263,Talbot County,2754,2536,218,2683,7.9
0500000US13269,13,269,Taylor County,3383,2987,396,3322,11.7
0500000US13273,13,273,Terrell County,3645,3332,313,3424,8.6
0500000US13275,13,275,Thomas County,20287,18645,1642,14776,8.1
0500000US13279,13,279,Toombs County,11752,10541,1211,8800,10.3
0500000US13319,13,319,Wilkinson County,3511,3258,253,3685,7.2
0500000US13017,13,017,Ben Hill County,6627,6313,314,6725,4.7
0500000US13033,13,033,Burke County,9505,9028,477,7850,5.0
0500000US13047,13,047,Catoosa County,33020,31719,1301,19843,3.9
0500000US13053,13,053,Chattahoochee County,2408,2177,231,1689,9.6
0500000US13055,13,055,Chattooga County,9744,8946,798,10149,8.2
0500000US13073,13,073,Columbia County,68979,65411,3568,41342,5.2
0500000US13087,13,087,Decatur County,10200,9645,555,10695,5.4
0500000US13115,13,115,Floyd County,44012,41259,2753,32585,6.3
0500000US13117,13,117,Forsyth County,113512,109504,4008,51457,3.5
0500000US13137,13,137,Habersham County,18831,18083,748,16627,4.0
0500000US13185,13,185,Lowndes County,50542,46705,3837,36644,7.6
0500000US13199,13,199,Meriwether County,8646,8133,513,8403,5.9
0500000US13207,13,207,Monroe County,12531,11536,995,9594,7.9
0500000US13261,13,261,Sumter County,13042,11841,1201,10957,9.2
0500000US13265,13,265,Taliaferro County,640,580,60,823,9.4
0500000US13007,13,007,Baker County,1303,1251,52,1330,4.0
0500000US13035,13,035,Butts County,9445,8915,530,9878,5.6
0500000US13043,13,043,Candler County,4560,4272,288,3870,6.3
0500000US13045,13,045,Carroll County,55303,50923,4380,36049,7.9
0500000US13079,13,079,Crawford County,5140,4644,496,4915,9.6
0500000US13081,13,081,Crisp County,10024,8798,1226,7759,12.2
0500000US13077,13,077,Coweta County,72087,68690,3397,37244,4.7
0500000US13067,13,067,Cobb County,410340,389803,20537,174168,5.0
0500000US13083,13,083,Dade County,7644,7331,313,5801,4.1
0500000US13297,13,297,Walton County,42998,40399,2599,26827,6.0
0500000US13027,13,027,Brooks County,6458,5800,658,6179,10.2
0500000US13091,13,091,Dodge County,8050,7467,583,9103,7.2
0500000US13105,13,105,Elbert County,8182,7626,556,7243,6.8
0500000US13113,13,113,Fayette County,55469,52689,2780,33739,5.0
0500000US13165,13,165,Jenkins County,3447,3309,138,3540,4.0
0500000US13217,13,217,Newton County,50867,46939,3928,30420,7.7
0500000US13227,13,227,Pickens County,14505,13613,892,10562,6.1
0500000US13071,13,071,Colquitt County,20108,18736,1372,14611,6.8
0500000US13085,13,085,Dawson County,11698,11230,468,7691,4.0
0500000US13063,13,063,Clayton County,138459,126643,11816,70267,8.5
0500000US13139,13,139,Hall County,95484,91959,3525,55549,3.7
0500000US13141,13,141,Hancock County,2060,1977,83,5330,4.0
0500000US13189,13,189,McDuffie County,9282,8513,769,7197,8.3
0500000US13211,13,211,Morgan County,8632,8139,493,5916,5.7
0500000US13149,13,149,Heard County,5317,4905,412,3897,7.7
0500000US13095,13,095,Dougherty County,40984,35167,5817,30082,14.2
0500000US13111,13,111,Fannin County,10221,9586,635,10951,6.2
0500000US13153,13,153,Houston County,73723,68567,5156,40640,7.0
0500000US13175,13,175,Laurens County,18201,17326,875,18710,4.8
0500000US13255,13,255,Spalding County,26908,25042,1866,23701,6.9
0500000US13271,13,271,Telfair County,5050,4919,131,8554,2.6
0500000US13291,13,291,Union County,8432,8119,313,10931,3.7
0500000US13303,13,303,Washington County,8100,7504,596,8322,7.4
0500000US13311,13,311,White County,12833,12294,539,11110,4.2
0500000US13223,13,223,Paulding County,80247,76827,3420,38934,4.3
0500000US13231,13,231,Pike County,8303,7774,529,6114,6.4
0500000US13245,13,245,Richmond County,90180,80890,9290,63848,10.3
0500000US13267,13,267,Tattnall County,8111,7801,310,12610,3.8
0500000US13019,13,019,Berrien County,7748,7085,663,7116,8.6
0500000US13295,13,295,Walker County,31391,29376,2015,23962,6.4
0500000US13135,13,135,Gwinnett County,473052,450670,22382,211040,4.7
0500000US13013,13,013,Barrow County,37566,35632,1934,21125,5.1
0500000US13049,13,049,Charlton County,4781,4199,582,5874,12.2
0500000US13065,13,065,Clinch County,2417,2257,160,2701,6.6
0500000US13015,13,015,Bartow County,50852,47997,2855,30139,5.6
0500000US13097,13,097,Douglas County,72898,67891,5007,36482,6.9
0500000US13131,13,131,Grady County,11030,10303,727,8307,6.6
0500000US13161,13,161,Jeff Davis County,5879,5530,349,5438,5.9
0500000US13209,13,209,Montgomery County,3793,3519,274,3566,7.2
0500000US13221,13,221,Oglethorpe County,7015,6684,331,4963,4.7
0500000US13243,13,243,Randolph County,2611,2408,203,2710,7.8
0500000US13247,13,247,Rockdale County,42506,39286,3220,26730,7.6
0500000US13299,13,299,Ware County,13672,13200,472,14299,3.5
0500000US13305,13,305,Wayne County,11482,10612,870,11660,7.6
0500000US13309,13,309,Wheeler County,2167,1928,239,4572,11.0
0500000US13315,13,315,Wilcox County,2601,2418,183,4721,7.0
0500000US13009,13,009,Baldwin County,19544,17708,1836,17954,9.4
0500000US13031,13,031,Bulloch County,36373,33249,3124,24883,8.6
0500000US13059,13,059,Clarke County,62797,58766,4031,42177,6.4
0500000US13101,13,101,Echols County,1765,1675,90,1486,5.1
0500000US13127,13,127,Glynn County,40794,38572,2222,26206,5.4
0500000US13143,13,143,Haralson County,12911,12285,626,9868,4.8
0500000US13163,13,163,Jefferson County,6374,5933,441,6071,6.9
0500000US13169,13,169,Jones County,13080,12114,966,9519,7.4
0500000US13213,13,213,Murray County,18372,16935,1437,12368,7.8
0500000US13215,13,215,Muscogee County,87749,79636,8113,58663,9.2
0500000US13241,13,241,Rabun County,6412,6142,270,7633,4.2
0500000US13259,13,259,Stewart County,1644,1498,146,3700,8.9
0500000US13283,13,283,Treutlen County,2676,2523,153,2700,5.7
0500000US13155,13,155,Irwin County,3608,3277,331,3909,9.2
0500000US13003,13,003,Atkinson County,3488,3168,320,2760,9.2
0500000US13005,13,005,Bacon County,4376,4146,230,4252,5.3
0500000US13025,13,025,Brantley County,7143,6729,414,7377,5.8
0500000US16087,16,087,Washington County,4254,4024,230,3658,5.4
0500000US16031,16,031,Cassia County,10477,10138,339,6295,3.2
0500000US16045,16,045,Gem County,6967,6654,313,6613,4.5
0500000US16085,16,085,Valley County,4305,4118,187,4390,4.3
0500000US16003,16,003,Adams County,1707,1517,190,1680,11.1
0500000US16069,16,069,Nez Perce County,19814,18892,922,12606,4.7
0500000US16055,16,055,Kootenai County,74284,70446,3838,47335,5.2
0500000US16061,16,061,Lewis County,1609,1515,94,1448,5.8
0500000US16083,16,083,Twin Falls County,41073,39657,1416,21798,3.4
0500000US16073,16,073,Owyhee County,5198,4964,234,3546,4.5
0500000US16015,16,015,Boise County,3054,2858,196,3046,6.4
0500000US16023,16,023,Butte County,1027,967,60,1049,5.8
0500000US16029,16,029,Caribou County,3075,3011,64,2019,2.1
0500000US16001,16,001,Ada County,230101,221254,8847,119192,3.8
0500000US16005,16,005,Bannock County,39410,36974,2436,25486,6.2
0500000US16011,16,011,Bingham County,20567,19674,893,12159,4.3
0500000US16025,16,025,Camas County,394,382,12,287,3.0
0500000US16027,16,027,Canyon County,98012,91663,6349,58501,6.5
0500000US16051,16,051,Jefferson County,13086,12485,601,6439,4.6
0500000US16057,16,057,Latah County,20630,19601,1029,12043,5.0
0500000US16075,16,075,Payette County,10435,9859,576,7017,5.5
0500000US16009,16,009,Benewah County,3759,3429,330,3447,8.8
0500000US16033,16,033,Clark County,502,463,39,288,7.8
0500000US16039,16,039,Elmore County,10462,9733,729,7569,7.0
0500000US16043,16,043,Fremont County,5567,5212,355,4346,6.4
0500000US16079,16,079,Shoshone County,5326,4866,460,5026,8.6
0500000US16049,16,049,Idaho County,6613,6291,322,6878,4.9
0500000US15001,15,001,Hawaii County,91970,86515,5455,67155,5.9
0500000US15009,15,009,Maui County,87898,83997,3901,43955,4.4
0500000US15007,15,007,Kauai County,37621,36129,1492,19550,4.0
0500000US15005,15,005,Kalawao County,57,57,0,14,0.0
0500000US17083,17,083,Jersey County,11126,10675,451,6952,4.1
0500000US17155,17,155,Putnam County,3105,2993,112,1670,3.6
0500000US17039,17,039,De Witt County,8591,8119,472,4410,5.5
0500000US17051,17,051,Fayette County,9274,8627,647,8438,7.0
0500000US17103,17,103,Lee County,16166,15455,711,12331,4.4
0500000US17107,17,107,Logan County,13200,12456,744,11058,5.6
0500000US17117,17,117,Macoupin County,22223,20652,1571,14903,7.1
0500000US17159,17,159,Richland County,7706,7257,449,4977,5.8
0500000US17165,17,165,Saline County,10796,9736,1060,8790,9.8
0500000US17189,17,189,Washington County,7437,7121,316,3973,4.2
0500000US17135,17,135,Montgomery County,11819,11245,574,12168,4.9
0500000US17195,17,195,Whiteside County,27864,26393,1471,17474,5.3
0500000US17001,17,001,Adams County,34121,32501,1620,18944,4.7
0500000US17027,17,027,Clinton County,19359,18709,650,11290,3.4
0500000US17037,17,037,DeKalb County,56668,52449,4219,27403,7.4
0500000US17047,17,047,Edwards County,3239,3043,196,1989,6.1
0500000US17079,17,079,Jasper County,4626,4438,188,3015,4.1
0500000US17081,17,081,Jefferson County,17434,16150,1284,13104,7.4
0500000US17197,17,197,Will County,367506,348560,18946,165669,5.2
0500000US17199,17,199,Williamson County,30704,28899,1805,23275,5.9
0500000US17041,17,041,Douglas County,9805,9382,423,5498,4.3
0500000US17057,17,057,Fulton County,16162,15077,1085,13029,6.7
0500000US17061,17,061,Greene County,6275,6026,249,4565,4.0
0500000US17069,17,069,Hardin County,1640,1379,261,1759,15.9
0500000US17073,17,073,Henry County,24147,22904,1243,15474,5.1
0500000US17095,17,095,Knox County,22512,21236,1276,19490,5.7
0500000US17097,17,097,Lake County,371346,350731,20615,169972,5.6
0500000US17127,17,127,Massac County,5949,5617,332,5606,5.6
0500000US17171,17,171,Scott County,2512,2343,169,1555,6.7
0500000US17017,17,017,Cass County,6544,6130,414,3451,6.3
0500000US17099,17,099,LaSalle County,55099,51365,3734,34334,6.8
0500000US17067,17,067,Hancock County,8663,8127,536,6100,6.2
0500000US17063,17,063,Grundy County,26379,25041,1338,12624,5.1
0500000US17091,17,091,Kankakee County,53770,50539,3231,34356,6.0
0500000US17043,17,043,DuPage County,513180,489858,23322,229101,4.5
0500000US17167,17,167,Sangamon County,101709,95308,6401,56453,6.3
0500000US17129,17,129,Menard County,6392,6077,315,3536,4.9
0500000US17031,17,031,Cook County,2763828,2548996,214832,1427266,7.8
0500000US17141,17,141,Ogle County,26444,24879,1565,14666,5.9
0500000US17137,17,137,Morgan County,16643,15653,990,12008,5.9
0500000US17177,17,177,Stephenson County,22853,21222,1631,13872,7.1
0500000US17193,17,193,White County,6433,5926,507,4821,7.9
0500000US17203,17,203,Woodford County,19603,18800,803,10870,4.1
0500000US17071,17,071,Henderson County,3457,3262,195,2318,5.6
0500000US17111,17,111,McHenry County,171036,163471,7565,72112,4.4
0500000US17113,17,113,McLean County,93704,90407,3297,46124,3.5
0500000US17145,17,145,Perry County,8572,7988,584,9205,6.8
0500000US17149,17,149,Pike County,7330,6935,395,5262,5.4
0500000US17161,17,161,Rock Island County,72903,68166,4737,43391,6.5
0500000US17163,17,163,St. Clair County,127720,118602,9118,77253,7.1
0500000US17185,17,185,Wabash County,5657,5325,332,3635,5.9
0500000US17013,17,013,Calhoun County,2157,2047,110,1813,5.1
0500000US17035,17,035,Cumberland County,5454,5270,184,3211,3.4
0500000US17085,17,085,Jo Daviess County,11225,10723,502,6946,4.5
0500000US17089,17,089,Kane County,281637,266113,15524,126860,5.5
0500000US17101,17,101,Lawrence County,6760,6333,427,6628,6.3
0500000US17009,17,009,Brown County,2559,2448,111,3177,4.3
0500000US17123,17,123,Marshall County,5752,5404,348,3981,6.1
0500000US17075,17,075,Iroquois County,14045,13260,785,8745,5.6
0500000US17021,17,021,Christian County,15495,14965,530,11646,3.4
0500000US17025,17,025,Clay County,6448,6093,355,4192,5.5
0500000US17059,17,059,Gallatin County,2240,2139,101,1969,4.5
0500000US17077,17,077,Jackson County,27672,25059,2613,21363,9.4
0500000US17133,17,133,Monroe County,18485,17910,575,8681,3.1
0500000US17143,17,143,Peoria County,90385,83236,7149,54778,7.9
0500000US17181,17,181,Union County,7657,7148,509,6299,6.6
0500000US17201,17,201,Winnebago County,146055,132751,13304,80400,9.1
0500000US17147,17,147,Piatt County,8947,8575,372,4256,4.2
0500000US17153,17,153,Pulaski County,2055,1863,192,2490,9.3
0500000US17169,17,169,Schuyler County,3039,2872,167,2854,5.5
0500000US17175,17,175,Stark County,2598,2508,90,1855,3.5
0500000US17045,17,045,Edgar County,8839,8306,533,5542,6.0
0500000US17005,17,005,Bond County,7782,7481,301,6185,3.9
0500000US17007,17,007,Boone County,27636,25748,1888,13851,6.8
0500000US17011,17,011,Bureau County,16929,16029,900,10040,5.3
0500000US17015,17,015,Carroll County,7062,6595,467,4993,6.6
0500000US17029,17,029,Coles County,26506,24987,1519,17015,5.7
0500000US17033,17,033,Crawford County,8457,8000,457,7196,5.4
0500000US18105,18,105,Monroe County,77560,72599,4961,47257,6.4
0500000US18045,18,045,Fountain County,7965,7506,459,5301,5.8
0500000US18039,18,039,Elkhart County,100940,96156,4784,52135,4.7
0500000US18025,18,025,Crawford County,4536,4361,175,4000,3.9
0500000US18017,18,017,Cass County,18199,17098,1101,12159,6.0
0500000US18097,18,097,Marion County,491738,457060,34678,241731,7.1
0500000US18021,18,021,Clay County,12904,12218,686,7871,5.3
0500000US18063,18,063,Hendricks County,87543,84103,3440,37142,3.9
0500000US18047,18,047,Franklin County,11534,11080,454,6559,3.9
0500000US18053,18,053,Grant County,31356,29052,2304,23183,7.3
0500000US18071,18,071,Jackson County,21518,20533,985,12799,4.6
0500000US18067,18,067,Howard County,39197,36898,2299,26805,5.9
0500000US18119,18,119,Owen County,9963,9411,552,6983,5.5
0500000US18135,18,135,Randolph County,11869,11271,598,8133,5.0
0500000US18183,18,183,Whitley County,17484,16976,508,9238,2.9
0500000US18013,18,013,Brown County,7371,7022,349,5342,4.7
0500000US18023,18,023,Clinton County,15895,15129,766,8828,4.8
0500000US18161,18,161,Union County,3462,3368,94,2363,2.7
0500000US18027,18,027,Daviess County,15137,14513,624,9137,4.1
0500000US18029,18,029,Dearborn County,26062,24790,1272,13505,4.9
0500000US18083,18,083,Knox County,19030,18068,962,11318,5.1
0500000US18093,18,093,Lawrence County,21510,20460,1050,15182,4.9
0500000US18123,18,123,Perry County,8588,8351,237,6864,2.8
0500000US18131,18,131,Pulaski County,5874,5536,338,4238,5.8
0500000US18129,18,129,Posey County,12945,12398,547,7744,4.2
0500000US18171,18,171,Warren County,4106,3948,158,2488,3.8
0500000US18165,18,165,Vermillion County,6898,6549,349,5636,5.1
0500000US18003,18,003,Allen County,189682,179102,10580,94889,5.6
0500000US18031,18,031,Decatur County,13718,13121,597,7210,4.4
0500000US18043,18,043,Floyd County,40436,38611,1825,20666,4.5
0500000US18079,18,079,Jennings County,13789,13225,564,8136,4.1
0500000US18081,18,081,Johnson County,79759,76397,3362,37677,4.2
0500000US18109,18,109,Morgan County,35084,33028,2056,20422,5.9
0500000US18051,18,051,Gibson County,16812,16281,531,9925,3.2
0500000US18117,18,117,Orange County,8815,8424,391,6755,4.4
0500000US18085,18,085,Kosciusko County,40893,39265,1628,20841,4.0
0500000US18099,18,099,Marshall County,22650,21365,1285,13510,5.7
0500000US18163,18,163,Vanderburgh County,92143,87595,4548,53996,4.9
0500000US18009,18,009,Blackford County,5713,5348,365,4165,6.4
0500000US18143,18,143,Scott County,10574,10004,570,8366,5.4
0500000US18061,18,061,Harrison County,18938,17765,1173,12840,6.2
0500000US18091,18,091,LaPorte County,50965,47006,3959,38365,7.8
0500000US18169,18,169,Wabash County,15484,14813,671,10303,4.3
0500000US18073,18,073,Jasper County,16188,15493,695,10313,4.3
0500000US18101,18,101,Martin County,4855,4705,150,3231,3.1
0500000US18127,18,127,Porter County,84116,80189,3927,50835,4.7
0500000US18145,18,145,Shelby County,23125,22158,967,12234,4.2
0500000US18137,18,137,Ripley County,14698,13884,814,7917,5.5
0500000US18147,18,147,Spencer County,10370,9947,423,6082,4.1
0500000US18153,18,153,Sullivan County,8833,8286,547,8286,6.2
0500000US18159,18,159,Tipton County,7698,7450,248,4874,3.2
0500000US18157,18,157,Tippecanoe County,99042,94285,4757,55302,4.8
0500000US18167,18,167,Vigo County,52723,48565,4158,35454,7.9
0500000US18173,18,173,Warrick County,32642,31570,1072,16127,3.3
0500000US18057,18,057,Hamilton County,173825,168749,5076,63521,2.9
0500000US18033,18,033,DeKalb County,22395,21374,1021,11203,4.6
0500000US18087,18,087,LaGrange County,17333,16906,427,10171,2.5
0500000US18005,18,005,Bartholomew County,42234,40192,2042,22144,4.8
0500000US18139,18,139,Rush County,7835,7440,395,5537,5.0
0500000US18011,18,011,Boone County,34553,33689,864,14346,2.5
0500000US18049,18,049,Fulton County,10014,9557,457,5967,4.6
0500000US18089,18,089,Lake County,236341,217505,18836,148715,8.0
0500000US18107,18,107,Montgomery County,19647,18836,811,10795,4.1
0500000US18113,18,113,Noble County,24059,22947,1112,12846,4.6
0500000US18001,18,001,Adams County,16122,15536,586,9149,3.6
0500000US18041,18,041,Fayette County,10380,9858,522,8349,5.0
0500000US19055,19,055,Delaware County,9558,9334,224,4082,2.3
0500000US19185,19,185,Wayne County,2884,2817,67,2129,2.3
0500000US19113,19,113,Linn County,122865,118580,4285,52773,3.5
0500000US19163,19,163,Scott County,88536,84812,3724,46741,4.2
0500000US19141,19,141,O'Brien County,7548,7379,169,3479,2.2
0500000US19011,19,011,Benton County,13716,13323,393,6610,2.9
0500000US19061,19,061,Dubuque County,52528,50388,2140,24538,4.1
0500000US19079,19,079,Hamilton County,7845,7607,238,4114,3.0
0500000US19151,19,151,Pocahontas County,3507,3396,111,2071,3.2
0500000US19175,19,175,Union County,6402,6071,331,3573,5.2
0500000US19177,19,177,Van Buren County,3293,3138,155,2388,4.7
0500000US19159,19,159,Ringgold County,2218,2121,97,1696,4.4
0500000US19001,19,001,Adair County,3708,3580,128,2017,3.5
0500000US19009,19,009,Audubon County,2982,2908,74,1701,2.5
0500000US19039,19,039,Clarke County,4765,4612,153,2451,3.2
0500000US19051,19,051,Davis County,4279,4158,121,2274,2.8
0500000US19093,19,093,Ida County,3593,3443,150,1904,4.2
0500000US19107,19,107,Keokuk County,5255,4996,259,2903,4.9
0500000US19135,19,135,Monroe County,3892,3662,230,2148,5.9
0500000US19179,19,179,Wapello County,17527,16399,1128,10636,6.4
0500000US19167,19,167,Sioux County,19328,18820,508,6982,2.6
0500000US19025,19,025,Calhoun County,4514,4416,98,3412,2.2
0500000US19031,19,031,Cedar County,10199,9920,279,4532,2.7
0500000US19033,19,033,Cerro Gordo County,22840,21912,928,12410,4.1
0500000US19073,19,073,Greene County,4749,4498,251,2449,5.3
0500000US19083,19,083,Hardin County,8874,8713,161,5150,1.8
0500000US19117,19,117,Lucas County,4184,3981,203,2668,4.9
0500000US19189,19,189,Winnebago County,5551,5296,255,3020,4.6
0500000US19147,19,147,Palo Alto County,4834,4781,53,2404,1.1
0500000US19007,19,007,Appanoose County,5834,5520,314,4225,5.4
0500000US19095,19,095,Iowa County,8589,8353,236,4282,2.7
0500000US19099,19,099,Jasper County,18484,17587,897,11039,4.9
0500000US19191,19,191,Winneshiek County,12035,11802,233,5088,1.9
0500000US19157,19,157,Poweshiek County,10328,9850,478,5056,4.6
0500000US19127,19,127,Marshall County,20104,19085,1019,11084,5.1
0500000US19015,19,015,Boone County,14429,13879,550,7030,3.8
0500000US19017,19,017,Bremer County,13386,12957,429,6604,3.2
0500000US19089,19,089,Howard County,4906,4783,123,2283,2.5
0500000US19063,19,063,Emmet County,4967,4802,165,2843,3.3
0500000US19081,19,081,Hancock County,5764,5653,111,3023,1.9
0500000US19121,19,121,Madison County,8707,8363,344,3628,4.0
0500000US19125,19,125,Marion County,17478,16957,521,8693,3.0
0500000US19197,19,197,Wright County,6057,5729,328,3997,5.4
0500000US39097,39,097,Madison County,20315,19346,969,15693,4.8
0500000US39119,39,119,Muskingum County,40765,38058,2707,28094,6.6
0500000US27037,27,037,Dakota County,241542,232877,8665,85120,3.6
0500000US27083,27,083,Lyon County,14247,13760,487,5688,3.4
0500000US27129,27,129,Renville County,7546,7327,219,4148,2.9
0500000US27031,27,031,Cook County,2688,2614,74,1939,2.8
0500000US27093,27,093,Meeker County,11880,11563,317,6245,2.7
0500000US27113,27,113,Pennington County,7895,7658,237,3305,3.0
0500000US27167,27,167,Wilkin County,3272,3226,46,1857,1.4
0500000US27027,27,027,Clay County,35067,34144,923,14074,2.6
0500000US27045,27,045,Fillmore County,10958,10666,292,5364,2.7
0500000US27119,27,119,Polk County,16421,15861,560,8391,3.4
0500000US27135,27,135,Roseau County,8462,8239,223,3671,2.6
0500000US27165,27,165,Watonwan County,5743,5591,152,2927,2.6
0500000US27011,27,011,Big Stone County,2454,2398,56,1625,2.3
0500000US27021,27,021,Cass County,12989,12283,706,10479,5.4
0500000US27049,27,049,Goodhue County,24922,24004,918,12189,3.7
0500000US27063,27,063,Jackson County,5490,5320,170,2570,3.1
0500000US27105,27,105,Nobles County,11200,10632,568,5309,5.1
0500000US27141,27,141,Sherburne County,52074,50434,1640,19344,3.1
0500000US27019,27,019,Carver County,57474,56258,1216,18914,2.1
0500000US27061,27,061,Itasca County,21303,20192,1111,15613,5.2
0500000US27123,27,123,Ramsey County,295458,281029,14429,132498,4.9
0500000US27169,27,169,Winona County,29733,28612,1121,12911,3.8
0500000US28089,28,089,Madison County,54756,52097,2659,25232,4.9
0500000US28091,28,091,Marion County,9450,8786,664,10424,7.0
0500000US48449,48,449,Titus County,15025,14108,917,9149,6.1
0500000US48291,48,291,Liberty County,32245,30006,2239,30991,6.9
0500000US48497,48,497,Wise County,30663,29107,1556,19815,5.1
0500000US48249,48,249,Jim Wells County,17082,16190,892,13712,5.2
0500000US48127,48,127,Dimmit County,4227,3533,694,3683,16.4
0500000US48157,48,157,Fort Bend County,372869,353205,19664,184571,5.3
0500000US48235,48,235,Irion County,687,642,45,495,6.6
0500000US48097,48,097,Cooke County,20106,19101,1005,11080,5.0
0500000US48115,48,115,Dawson County,5147,4863,284,5091,5.5
0500000US48051,48,051,Burleson County,8229,7731,498,6102,6.1
0500000US48245,48,245,Jefferson County,112354,105903,6451,88391,5.7
0500000US48359,48,359,Oldham County,830,800,30,625,3.6
0500000US48141,48,141,El Paso County,372771,348062,24709,241401,6.6
0500000US48443,48,443,Terrell County,380,344,36,381,9.5
0500000US48463,48,463,Uvalde County,11985,11308,677,8752,5.6
0500000US48009,48,009,Archer County,4542,4385,157,2628,3.5
0500000US48215,48,215,Hidalgo County,347471,321626,25845,249943,7.4
0500000US48425,48,425,Somervell County,3854,3782,72,3097,1.9
0500000US48207,48,207,Haskell County,2522,2268,254,2340,10.1
0500000US48333,48,333,Mills County,1939,1903,36,1980,1.9
0500000US48351,48,351,Newton County,5397,4965,432,6271,8.0
0500000US49045,49,045,Tooele County,31239,29272,1967,14522,6.3
0500000US49043,49,043,Summit County,22650,22237,413,8727,1.8
0500000US49031,49,031,Piute County,634,612,22,881,3.5
0500000US49001,49,001,Beaver County,2845,2726,119,1747,4.2
0500000US49039,49,039,Sanpete County,12118,11243,875,10571,7.2
0500000US49049,49,049,Utah County,279962,269203,10759,128533,3.8
0500000US50011,50,011,Franklin County,27140,25988,1152,12109,4.2
0500000US50003,50,003,Bennington County,18315,17534,781,11532,4.3
0500000US50009,50,009,Essex County,2897,2767,130,2334,4.5
0500000US51530,51,530,Buena Vista city,3065,2991,74,2192,2.4
0500000US51730,51,730,Petersburg city,15088,13387,1701,10067,11.3
0500000US51600,51,600,Fairfax city,13252,12717,535,5677,4.0
0500000US51683,51,683,Manassas city,23394,22051,1343,8014,5.7
0500000US51800,51,800,Suffolk city,44729,41944,2785,23028,6.2
0500000US51041,51,041,Chesterfield County,182469,173467,9002,84514,4.9
0500000US51093,51,093,Isle of Wight County,18918,17425,1493,10523,7.9
0500000US51620,51,620,Franklin city,4001,3402,599,2317,15.0
0500000US51540,51,540,Charlottesville city,25650,24605,1045,14667,4.1
0500000US51087,51,087,Henrico County,180541,171012,9529,78225,5.3
0500000US51101,51,101,King William County,8545,8292,253,4585,3.0
0500000US51109,51,109,Louisa County,17577,16475,1102,11236,6.3
0500000US51147,51,147,Prince Edward County,9112,8531,581,10549,6.4
0500000US51159,51,159,Richmond County,3557,3489,68,3914,1.9
0500000US51177,51,177,Spotsylvania County,69084,65438,3646,32835,5.3
0500000US51043,51,043,Clarke County,7463,7182,281,4351,3.8
0500000US51117,51,117,Mecklenburg County,12885,12329,556,12860,4.3
0500000US51015,51,015,Augusta County,36494,35166,1328,25328,3.6
0500000US51051,51,051,Dickenson County,4698,4433,265,7656,5.6
0500000US51107,51,107,Loudoun County,215393,207877,7516,69206,3.5
0500000US51161,51,161,Roanoke County,47435,45700,1735,29546,3.7
0500000US51570,51,570,Colonial Heights city,8391,7624,767,5482,9.1
0500000US51021,51,021,Bland County,2751,2555,196,2809,7.1
0500000US51029,51,029,Buckingham County,7163,6671,492,6990,6.9
0500000US51580,51,580,Covington city,2580,2454,126,1993,4.9
0500000US51810,51,810,Virginia Beach city,231348,220127,11221,106215,4.9
0500000US51640,51,640,Galax city,2980,2788,192,2403,6.4
0500000US51193,51,193,Westmoreland County,8241,7610,631,6235,7.7
0500000US51155,51,155,Pulaski County,16444,15441,1003,12431,6.1
0500000US51590,51,590,Danville city,18326,16636,1690,14910,9.2
0500000US51009,51,009,Amherst County,15455,14513,942,10898,6.1
0500000US51017,51,017,Bath County,2293,2092,201,1458,8.8
0500000US51700,51,700,Newport News city,87670,81765,5905,46328,6.7
0500000US51680,51,680,Lynchburg city,38571,36191,2380,27773,6.2
0500000US51690,51,690,Martinsville city,5796,5345,451,4387,7.8
0500000US51057,51,057,Essex County,5511,5231,280,3495,5.1
0500000US51790,51,790,Staunton city,12170,11775,395,8127,3.2
0500000US51750,51,750,Radford city,8315,7822,493,7692,5.9
0500000US51045,51,045,Craig County,2239,2207,32,2063,1.4
0500000US51071,51,071,Giles County,7750,7392,358,5947,4.6
0500000US51157,51,157,Rappahannock County,3641,3499,142,2597,3.9
0500000US54085,54,085,Ritchie County,4041,3723,318,4133,7.9
0500000US54043,54,043,Lincoln County,7359,6861,498,9445,6.8
0500000US54079,54,079,Putnam County,26783,25912,871,18629,3.3
0500000US54005,54,005,Boone County,7383,6691,692,11052,9.4
0500000US54051,54,051,Marshall County,13152,12509,643,12808,4.9
0500000US54093,54,093,Tucker County,3211,3002,209,2839,6.5
0500000US54087,54,087,Roane County,5022,4534,488,6387,9.7
0500000US54107,54,107,Wood County,38516,36541,1975,31066,5.1
0500000US54053,54,053,Mason County,9939,9341,598,12129,6.0
0500000US54073,54,073,Pleasants County,3325,3026,299,2965,9.0
0500000US54037,54,037,Jefferson County,29228,27210,2018,15821,6.9
0500000US54045,54,045,Logan County,11936,10356,1580,15724,13.2
0500000US53031,53,031,Jefferson County,12351,11569,782,14993,6.3
0500000US53049,53,049,Pacific County,7522,7012,510,10584,6.8
0500000US53059,53,059,Skamania County,5422,5162,260,4229,4.8
0500000US53009,53,009,Clallam County,31029,28644,2385,31881,7.7
0500000US53039,53,039,Klickitat County,8877,8329,548,8804,6.2
0500000US53017,53,017,Douglas County,19749,18962,787,11780,4.0
0500000US53053,53,053,Pierce County,421669,397125,24544,240019,5.8
0500000US53071,53,071,Walla Walla County,28132,26674,1458,20628,5.2
0500000US53061,53,061,Snohomish County,420918,401702,19216,202877,4.6
0500000US53067,53,067,Thurston County,135904,126581,9323,82271,6.9
0500000US53011,53,011,Clark County,233844,221205,12639,130178,5.4
0500000US53001,53,001,Adams County,8420,7890,530,4903,6.3
0500000US53057,53,057,Skagit County,58907,55506,3401,40219,5.8
0500000US53043,53,043,Lincoln County,4349,4160,189,4164,4.3
0500000US55119,55,119,Taylor County,10631,10235,396,5391,3.7
0500000US55099,55,099,Price County,6650,6505,145,4891,2.2
0500000US55079,55,079,Milwaukee County,489050,458805,30245,258015,6.2
0500000US55033,55,033,Dunn County,24180,23300,880,12399,3.6
0500000US55045,55,045,Green County,20792,20344,448,8670,2.2
0500000US55115,55,115,Shawano County,20732,20214,518,12358,2.5
0500000US55078,55,078,Menominee County,1725,1624,101,1593,5.9
0500000US55011,55,011,Buffalo County,6991,6847,144,3819,2.1
0500000US55063,55,063,La Crosse County,65229,62604,2625,31514,4.0
0500000US55035,55,035,Eau Claire County,58101,55948,2153,26130,3.7
0500000US55095,55,095,Polk County,22392,21468,924,12764,4.1
0500000US55133,55,133,Waukesha County,220296,213895,6401,102363,2.9
0500000US55125,55,125,Vilas County,9907,9182,725,8511,7.3
0500000US55057,55,057,Juneau County,12614,12143,471,8997,3.7
0500000US55131,55,131,Washington County,75708,73521,2187,32440,2.9
0500000US55025,55,025,Dane County,312183,302391,9792,119239,3.1
0500000US55039,55,039,Fond du Lac County,55520,53443,2077,27081,3.7
0500000US55091,55,091,Pepin County,3828,3730,98,2068,2.6
0500000US55097,55,097,Portage County,39277,37825,1452,19012,3.7
0500000US56023,56,023,Lincoln County,9558,9134,424,4784,4.4
0500000US56021,56,021,Laramie County,49621,46993,2628,25362,5.3
0500000US01093,01,093,Marion County,12688,11980,708,11623,5.6
0500000US01073,01,073,Jefferson County,326091,302428,23663,198736,7.3
0500000US01059,01,059,Franklin County,13689,12849,840,10907,6.1
0500000US01019,01,019,Cherokee County,10386,9805,581,10963,5.6
0500000US01047,01,047,Dallas County,16201,14295,1906,15187,11.8
0500000US01087,01,087,Macon County,8295,7289,1006,7749,12.1
0500000US01117,01,117,Shelby County,110135,105724,4411,56389,4.0
0500000US01003,01,003,Baldwin County,97722,93379,4343,69682,4.4
0500000US01069,01,069,Houston County,47645,44291,3354,35036,7.0
0500000US01125,01,125,Tuscaloosa County,99707,93450,6257,67781,6.3
0500000US01027,01,027,Clay County,5920,5542,378,4923,6.4
0500000US01109,01,109,Pike County,15319,14093,1226,12351,8.0
0500000US01037,01,037,Coosa County,4363,4110,253,4864,5.8
0500000US01065,01,065,Hale County,5769,5083,686,6044,11.9
0500000US01053,01,053,Escambia County,14077,12182,1895,15904,13.5
0500000US01013,01,013,Butler County,8452,7885,567,7506,6.7
0500000US01105,01,105,Perry County,2651,2325,326,5041,12.3
0500000US01035,01,035,Conecuh County,4397,3892,505,5755,11.5
0500000US01007,01,007,Bibb County,8757,8099,658,9713,7.5
0500000US01017,01,017,Chambers County,15559,14786,773,12085,5.0
0500000US01057,01,057,Fayette County,6863,6380,483,6615,7.0
0500000US01009,01,009,Blount County,22255,21346,909,23609,4.1
0500000US01001,01,001,Autauga County,25189,24124,1065,17632,4.2
0500000US01061,01,061,Geneva County,10992,10047,945,10295,8.6
0500000US02261,02,261,Valdez-Cordova Census Area,5079,4744,335,2011,6.6
0500000US02105,02,105,Hoonah-Angoon Census Area,1198,1068,130,624,10.9
0500000US02275,02,275,Wrangell City and Borough,1195,1128,67,875,5.6
0500000US04019,04,019,Pima County,476815,440596,36219,344067,7.6
0500000US04007,04,007,Gila County,20214,18162,2052,23355,10.2
0500000US04003,04,003,Cochise County,46439,43097,3342,51235,7.2
0500000US04001,04,001,Apache County,20870,18365,2505,33174,12.0
0500000US04025,04,025,Yavapai County,90218,84142,6076,101230,6.7
0500000US04017,04,017,Navajo County,39063,33272,5791,43080,14.8
0500000US05119,05,119,Pulaski County,194471,184451,10020,114029,5.2
0500000US05021,05,021,Clay County,6581,6249,332,5523,5.0
0500000US05039,05,039,Dallas County,3096,2944,152,2917,4.9
0500000US05121,05,121,Randolph County,7131,6831,300,6782,4.2
0500000US05009,05,009,Boone County,16885,16145,740,12769,4.4
0500000US05063,05,063,Independence County,16340,15547,793,12971,4.9
0500000US05053,05,053,Grant County,8173,7594,579,6314,7.1
0500000US05045,05,045,Faulkner County,60044,57226,2818,36490,4.7
0500000US05089,05,089,Marion County,5777,5322,455,7978,7.9
0500000US05129,05,129,Searcy County,3227,3129,98,3290,3.0
0500000US05033,05,033,Crawford County,27371,25985,1386,21313,5.1
0500000US05059,05,059,Hot Spring County,14301,13232,1069,13045,7.5
0500000US05087,05,087,Madison County,7021,6574,447,5819,6.4
0500000US05061,05,061,Howard County,5938,5559,379,4351,6.4
0500000US05093,05,093,Mississippi County,19118,17337,1781,13806,9.3
0500000US05139,05,139,Union County,17059,15821,1238,14039,7.3
0500000US39055,39,055,Geauga County,49306,47853,1453,25639,2.9
0500000US39085,39,085,Lake County,123735,118286,5449,65036,4.4
0500000US39023,39,023,Clark County,65431,60663,4768,42635,7.3
0500000US39075,39,075,Holmes County,20580,20133,447,10873,2.2
0500000US39111,39,111,Monroe County,5590,5226,364,5958,6.5
0500000US39165,39,165,Warren County,115837,111724,4113,59996,3.6
0500000US39005,39,005,Ashland County,26338,25271,1067,16474,4.1
0500000US40133,40,133,Seminole County,10202,9418,784,9294,7.7
0500000US40011,40,011,Blaine County,3729,3618,111,4031,3.0
0500000US40029,40,029,Coal County,2339,2186,153,2031,6.5
0500000US40073,40,073,Kingfisher County,7591,7205,386,4289,5.1
0500000US40095,40,095,Marshall County,6813,6534,279,6159,4.1
0500000US40105,40,105,Nowata County,4693,4347,346,3596,7.4
0500000US40131,40,131,Rogers County,45671,43485,2186,25952,4.8
0500000US40003,40,003,Alfalfa County,2283,2205,78,2534,3.4
0500000US40027,40,027,Cleveland County,146558,140468,6090,74929,4.2
0500000US40005,40,005,Atoka County,5000,4702,298,6090,6.0
0500000US40043,40,043,Dewey County,2161,2125,36,1555,1.7
0500000US40083,40,083,Logan County,22700,21580,1120,13664,4.9
0500000US40147,40,147,Washington County,23884,22712,1172,17022,4.9
0500000US40061,40,061,Haskell County,5080,4612,468,4929,9.2
0500000US40111,40,111,Okmulgee County,16691,15107,1584,14002,9.5
0500000US40067,40,067,Jefferson County,2448,2272,176,2467,7.2
0500000US40049,40,049,Garvin County,11204,10798,406,10456,3.6
0500000US40123,40,123,Pontotoc County,18177,17251,926,11945,5.1
0500000US40063,40,063,Hughes County,4549,4164,385,6356,8.5
0500000US40031,40,031,Comanche County,52694,48797,3897,34626,7.4
0500000US40117,40,117,Pawnee County,6886,6587,299,6046,4.3
0500000US41019,41,019,Douglas County,45542,41847,3695,44525,8.1
0500000US41053,41,053,Polk County,38810,35904,2906,25874,7.5
0500000US41017,41,017,Deschutes County,92849,88057,4792,54409,5.2
0500000US41071,41,071,Yamhill County,49782,47108,2674,33210,5.4
0500000US41035,41,035,Klamath County,28022,25596,2426,25045,8.7
0500000US41003,41,003,Benton County,45927,43093,2834,30964,6.2
0500000US41013,41,013,Crook County,9618,8797,821,8865,8.5
0500000US41025,41,025,Harney County,3333,2898,435,2602,13.1
0500000US41063,41,063,Wallowa County,3167,3025,142,2620,4.5
0500000US41069,41,069,Wheeler County,531,490,41,692,7.7
0500000US41011,41,011,Coos County,26971,24890,2081,25771,7.7
0500000US41027,41,027,Hood River County,12060,11557,503,6036,4.2
0500000US41051,41,051,Multnomah County,456019,430606,25413,202884,5.6
0500000US42055,42,055,Franklin County,77349,73248,4101,45777,5.3
0500000US42009,42,009,Bedford County,23143,22017,1126,17005,4.9
0500000US42111,42,111,Somerset County,34480,32603,1877,28488,5.4
0500000US42133,42,133,York County,234271,222484,11787,122401,5.0
0500000US42015,42,015,Bradford County,28057,26708,1349,21287,4.8
0500000US42029,42,029,Chester County,282460,270154,12306,129082,4.4
0500000US42063,42,063,Indiana County,40423,37489,2934,31460,7.3
0500000US42125,42,125,Washington County,105164,99783,5381,66483,5.1
0500000US42103,42,103,Pike County,26851,24860,1991,19948,7.4
0500000US42077,42,077,Lehigh County,189176,176888,12288,100536,6.5
0500000US42031,42,031,Clarion County,18876,17636,1240,13538,6.6
0500000US42033,42,033,Clearfield County,36482,33904,2578,30730,7.1
0500000US42081,42,081,Lycoming County,56683,53722,2961,37316,5.2
0500000US42123,42,123,Warren County,19191,18202,989,14039,5.2
0500000US42047,42,047,Elk County,15829,15225,604,9426,3.8
0500000US42085,42,085,Mercer County,52355,49595,2760,41139,5.3
0500000US42113,42,113,Sullivan County,2933,2698,235,2646,8.0
0500000US44003,44,003,Kent County,91700,86754,4946,44717,5.4
0500000US44009,44,009,Washington County,68755,64575,4180,38488,6.1
0500000US45005,45,005,Allendale County,3346,2796,550,4258,16.4
0500000US45023,45,023,Chester County,14107,13094,1013,11677,7.2
0500000US45067,45,067,Marion County,12794,11497,1297,12273,10.1
0500000US45073,45,073,Oconee County,33248,31132,2116,29665,6.4
0500000US45019,45,019,Charleston County,209236,200094,9142,112222,4.4
0500000US45069,45,069,Marlboro County,11047,9616,1431,11343,13.0
0500000US45021,45,021,Cherokee County,23664,22272,1392,21358,5.9
0500000US45053,45,053,Jasper County,13408,12182,1226,8948,9.1
0500000US45061,45,061,Lee County,6393,5850,543,8025,8.5
0500000US45083,45,083,Spartanburg County,147236,138787,8449,92347,5.7
0500000US45013,45,013,Beaufort County,79063,74418,4645,65898,5.9
0500000US45081,45,081,Saluda County,9299,8745,554,6911,6.0
0500000US46067,46,067,Hutchinson County,3818,3669,149,1929,3.9
0500000US46017,46,017,Buffalo County,803,658,145,565,18.1
0500000US46041,46,041,Dewey County,2614,2036,578,1242,22.1
0500000US46065,46,065,Hughes County,9524,9323,201,4359,2.1
0500000US46111,46,111,Sanborn County,1325,1283,42,578,3.2
0500000US46059,46,059,Hand County,1780,1767,13,879,0.7
0500000US46135,46,135,Yankton County,11750,11387,363,6618,3.1
0500000US46005,46,005,Beadle County,9460,9298,162,4489,1.7
0500000US46035,46,035,Davison County,10893,10568,325,4950,3.0
0500000US46073,46,073,Jerauld County,976,973,3,654,0.3
0500000US46117,46,117,Stanley County,1730,1702,28,546,1.6
0500000US46107,46,107,Potter County,1137,1128,9,729,0.8
0500000US46023,46,023,Charles Mix County,4180,3894,286,2730,6.8
0500000US46091,46,091,Marshall County,2527,2488,39,1208,1.5
0500000US46101,46,101,Moody County,3417,3263,154,1615,4.5
0500000US46121,46,121,Todd County,2967,2576,391,3507,13.2
0500000US46085,46,085,Lyman County,1885,1759,126,996,6.7
0500000US46115,46,115,Spink County,3320,3247,73,1864,2.2
0500000US46011,46,011,Brookings County,20053,19359,694,7983,3.5
0500000US46057,46,057,Hamlin County,2914,2855,59,1395,2.0
0500000US47083,47,083,Houston County,3175,2990,185,3442,5.8
0500000US47071,47,071,Hardin County,10600,9760,840,10472,7.9
0500000US47069,47,069,Hardeman County,9250,8021,1229,11857,13.3
0500000US47139,47,139,Polk County,7466,6859,607,6379,8.1
0500000US47185,47,185,White County,10957,10087,870,10261,7.9
0500000US47171,47,171,Unicoi County,7781,7063,718,7224,9.2
0500000US47183,47,183,Weakley County,15217,14302,915,12685,6.0
0500000US47007,47,007,Bledsoe County,6325,5739,586,6181,9.3
0500000US47031,47,031,Coffee County,25179,23796,1383,17776,5.5
0500000US47073,47,073,Hawkins County,23670,22014,1656,22467,7.0
0500000US47111,47,111,Macon County,10687,10215,472,7728,4.4
0500000US47147,47,147,Robertson County,35653,33524,2129,18744,6.0
0500000US47021,47,021,Cheatham County,20547,19619,928,11436,4.5
0500000US47055,47,055,Giles County,13095,12294,801,10663,6.1
0500000US47113,47,113,Madison County,45881,43519,2362,32278,5.1
0500000US47137,47,137,Pickett County,2130,2042,88,2137,4.1
0500000US47181,47,181,Wayne County,6201,5753,448,7640,7.2
0500000US47003,47,003,Bedford County,22856,21679,1177,13744,5.1
0500000US47035,47,035,Cumberland County,22932,21382,1550,26356,6.8
0500000US47025,47,025,Claiborne County,12984,11877,1107,13300,8.5
0500000US47085,47,085,Humphreys County,7628,7140,488,7330,6.4
0500000US47141,47,141,Putnam County,35821,33590,2231,26496,6.2
0500000US47161,47,161,Stewart County,5625,5222,403,5178,7.2
0500000US47039,47,039,Decatur County,4925,4486,439,4478,8.9
0500000US47109,47,109,McNairy County,10582,9278,1304,10330,12.3
0500000US47011,47,011,Bradley County,50875,47838,3037,33136,6.0
0500000US48267,48,267,Kimble County,2192,2124,68,1457,3.1
0500000US48467,48,467,Van Zandt County,23393,22207,1186,20021,5.1
0500000US48317,48,317,Martin County,2595,2527,68,1433,2.6
0500000US48501,48,501,Yoakum County,4004,3762,242,1971,6.0
0500000US48387,48,387,Red River County,5327,4910,417,4867,7.8
0500000US48435,48,435,Sutton County,2054,1938,116,961,5.6
0500000US48459,48,459,Upshur County,18320,16963,1357,13844,7.4
0500000US48481,48,481,Wharton County,19849,18808,1041,12082,5.2
0500000US48033,48,033,Borden County,284,278,6,238,2.1
0500000US48315,48,315,Marion County,4061,3612,449,4371,11.1
0500000US48181,48,181,Grayson County,62559,59160,3399,38636,5.4
0500000US48363,48,363,Palo Pinto County,12889,11903,986,9479,7.6
0500000US48123,48,123,DeWitt County,8490,7957,533,7676,6.3
0500000US48059,48,059,Callahan County,5878,5684,194,5065,3.3
0500000US48183,48,183,Gregg County,58384,55553,2831,36617,4.8
0500000US48303,48,303,Lubbock County,154094,147651,6443,81971,4.2
0500000US48257,48,257,Kaufman County,59090,55103,3987,30234,6.7
0500000US48153,48,153,Floyd County,2564,2400,164,1895,6.4
0500000US48071,48,071,Chambers County,18976,17821,1155,11222,6.1
0500000US48027,48,027,Bell County,150793,139158,11635,87400,7.7
0500000US48233,48,233,Hutchinson County,9568,8995,573,7151,6.0
0500000US48361,48,361,Orange County,39223,37083,2140,26261,5.5
0500000US48495,48,495,Winkler County,3421,3273,148,2346,4.3
0500000US48053,48,053,Burnet County,21262,20303,959,15591,4.5
0500000US48113,48,113,Dallas County,1353911,1282839,71072,615836,5.2
0500000US48311,48,311,McMullen County,280,230,50,227,17.9
0500000US48251,48,251,Johnson County,78205,74845,3360,47419,4.3
0500000US48205,48,205,Hartley County,2032,2013,19,2633,0.9
0500000US48293,48,293,Limestone County,9784,8902,882,8940,9.0
0500000US48367,48,367,Parker County,63428,60252,3176,37972,5.0
0500000US48109,48,109,Culberson County,1051,983,68,721,6.5
0500000US48169,48,169,Garza County,2205,2134,71,3233,3.2
0500000US48453,48,453,Travis County,694369,666484,27885,266017,4.0
0500000US48087,48,087,Collingsworth County,1446,1322,124,871,8.6
0500000US48279,48,279,Lamb County,5818,5647,171,4107,2.9
0500000US48301,48,301,Loving County,36,36,0,42,0.0
0500000US28117,28,117,Prentiss County,10414,9661,753,9781,7.2
0500000US28059,28,059,Jackson County,66876,61405,5471,44800,8.2
0500000US28143,28,143,Tunica County,4645,4156,489,2877,10.5
0500000US28021,28,021,Claiborne County,3008,2538,470,4368,15.6
0500000US28075,28,075,Lauderdale County,33351,31112,2239,26690,6.7
0500000US28127,28,127,Simpson County,11597,10649,948,9714,8.2
0500000US28007,28,007,Attala County,7412,6634,778,6937,10.5
0500000US28027,28,027,Coahoma County,10227,8393,1834,7773,17.9
0500000US28147,28,147,Walthall County,5820,5459,361,5698,6.2
0500000US28115,28,115,Pontotoc County,14203,13183,1020,9578,7.2
0500000US28003,28,003,Alcorn County,16277,14849,1428,13080,8.8
0500000US28033,28,033,DeSoto County,92974,87555,5419,42672,5.8
0500000US29129,29,129,Mercer County,1703,1660,43,1123,2.5
0500000US29047,29,047,Clay County,130797,125517,5280,56202,4.0
0500000US29065,29,065,Dent County,6655,6230,425,5708,6.4
0500000US29227,29,227,Worth County,961,924,37,689,3.9
0500000US29510,29,510,St. Louis city,167581,153691,13890,88209,8.3
0500000US29023,29,023,Butler County,18812,17067,1745,15170,9.3
0500000US29087,29,087,Holt County,2148,2063,85,1483,4.0
0500000US29139,29,139,Montgomery County,5240,5031,209,3965,4.0
0500000US29207,29,207,Stoddard County,13376,12599,777,10439,5.8
0500000US29221,29,221,Washington County,9921,9032,889,10034,9.0
0500000US29063,29,063,DeKalb County,4402,4276,126,6377,2.9
0500000US29107,29,107,Lafayette County,16024,15313,711,10056,4.4
0500000US29197,29,197,Schuyler County,1975,1896,79,1471,4.0
0500000US29029,29,029,Camden County,19493,18231,1262,18563,6.5
0500000US29097,29,097,Jasper County,59930,56742,3188,32567,5.3
0500000US29119,29,119,McDonald County,9842,9408,434,7743,4.4
0500000US29167,29,167,Polk County,14858,14135,723,10225,4.9
0500000US29179,29,179,Reynolds County,2660,2483,177,2577,6.7
0500000US29201,29,201,Scott County,17710,16789,921,12818,5.2
0500000US29011,29,011,Barton County,5513,5195,318,3913,5.8
0500000US29051,29,051,Cole County,39055,37467,1588,22099,4.1
0500000US29073,29,073,Gasconade County,7063,6891,172,4897,2.4
0500000US29121,29,121,Macon County,6683,6363,320,5377,4.8
0500000US29155,29,155,Pemiscot County,6763,6101,662,6300,9.8
0500000US29203,29,203,Shannon County,3099,2903,196,3528,6.3
0500000US29067,29,067,Douglas County,5118,4802,316,5710,6.2
0500000US29083,29,083,Henry County,9440,8831,609,8032,6.5
0500000US29109,29,109,Lawrence County,17947,16841,1106,11572,6.2
0500000US30015,30,015,Chouteau County,2592,2516,76,1998,2.9
0500000US30053,30,053,Lincoln County,7588,6802,786,8652,10.4
0500000US30103,30,103,Treasure County,379,379,0,267,0.0
0500000US30097,30,097,Sweet Grass County,1641,1628,13,1354,0.8
0500000US30079,30,079,Prairie County,634,604,30,423,4.7
0500000US30035,30,035,Glacier County,5021,4646,375,4630,7.5
0500000US30037,30,037,Golden Valley County,366,353,13,249,3.6
0500000US30095,30,095,Stillwater County,4656,4475,181,2976,3.9
0500000US30039,30,039,Granite County,1288,1231,57,1485,4.4
0500000US30057,30,057,Madison County,4159,4023,136,2943,3.3
0500000US30091,30,091,Sheridan County,1909,1855,54,961,2.8
0500000US30003,30,003,Big Horn County,5459,4725,734,3801,13.4
0500000US30049,30,049,Lewis and Clark County,35562,34454,1108,18312,3.1
0500000US30063,30,063,Missoula County,67057,64178,2879,29003,4.3
0500000US30013,30,013,Cascade County,38479,36909,1570,24130,4.1
0500000US30033,30,033,Garfield County,617,617,0,308,0.0
0500000US30077,30,077,Powell County,2618,2594,24,3382,0.9
0500000US30031,30,031,Gallatin County,61751,59736,2015,23786,3.3
0500000US30001,30,001,Beaverhead County,4890,4706,184,3070,3.8
0500000US30065,30,065,Musselshell County,1899,1781,118,1976,6.2
0500000US31161,31,161,Sheridan County,2679,2614,65,1476,2.4
0500000US31129,31,129,Nuckolls County,2256,2224,32,1259,1.4
0500000US31063,31,063,Frontier County,1303,1254,49,867,3.8
0500000US31055,31,055,Douglas County,301643,288884,12759,124626,4.2
0500000US31029,31,029,Chase County,2069,2018,51,966,2.5
0500000US31005,31,005,Arthur County,198,196,2,119,1.0
0500000US31061,31,061,Franklin County,1522,1498,24,995,1.6
0500000US31095,31,095,Jefferson County,3620,3558,62,2149,1.7
0500000US31115,31,115,Loup County,307,305,2,201,0.7
0500000US31137,31,137,Phelps County,4824,4788,36,2393,0.7
0500000US31157,31,157,Scotts Bluff County,18451,17505,946,9677,5.1
0500000US31105,31,105,Kimball County,1871,1734,137,1079,7.3
0500000US31121,31,121,Merrick County,4204,4091,113,2104,2.7
0500000US31021,31,021,Burt County,3120,3028,92,2090,2.9
0500000US31039,31,039,Cuming County,4859,4687,172,2146,3.5
0500000US31075,31,075,Grant County,375,359,16,203,4.3
0500000US31085,31,085,Hayes County,499,494,5,258,1.0
0500000US31027,31,027,Cedar County,4595,4538,57,2038,1.2
0500000US31097,31,097,Johnson County,2161,2117,44,2190,2.0
0500000US31071,31,071,Garfield County,1020,1018,2,597,0.2
0500000US31133,31,133,Pawnee County,1255,1213,42,917,3.3
0500000US31183,31,183,Wheeler County,463,461,2,232,0.4
0500000US31185,31,185,York County,7096,6888,208,3870,2.9
0500000US31037,31,037,Colfax County,5511,5337,174,2233,3.2
0500000US31113,31,113,Logan County,451,451,0,217,0.0
0500000US31143,31,143,Polk County,2778,2630,148,1427,5.3
0500000US31017,31,017,Brown County,1526,1517,9,921,0.6
0500000US32015,32,015,Lander County,2863,2597,266,1424,9.3
0500000US32011,32,011,Eureka County,961,961,0,495,0.0
0500000US34021,34,021,Mercer County,193804,180710,13094,105023,6.8
0500000US34035,34,035,Somerset County,181508,173381,8127,83573,4.5
0500000US34001,34,001,Atlantic County,140914,127434,13480,76347,9.6
0500000US34023,34,023,Middlesex County,429780,405537,24243,236688,5.6
0500000US34009,34,009,Cape May County,45083,41593,3490,33289,7.7
0500000US34039,34,039,Union County,298724,279881,18843,138473,6.3
0500000US34019,34,019,Hunterdon County,69109,66375,2734,34508,4.0
0500000US35028,35,028,Los Alamos County,9857,9516,341,4772,3.5
0500000US35061,35,061,Valencia County,31705,29040,2665,28287,8.4
0500000US35001,35,001,Bernalillo County,336358,315193,21165,204486,6.3
0500000US35011,35,011,De Baca County,776,748,28,842,3.6
0500000US35023,35,023,Hidalgo County,1697,1541,156,1738,9.2
0500000US35043,35,043,Sandoval County,65544,60468,5076,45330,7.7
0500000US35009,35,009,Curry County,22180,20673,1507,13734,6.8
0500000US35021,35,021,Harding County,164,154,10,226,6.1
0500000US35045,35,045,San Juan County,55718,50732,4986,40799,8.9
0500000US35005,35,005,Chaves County,28288,26629,1659,21860,5.9
0500000US35059,35,059,Union County,1613,1588,25,1823,1.5
0500000US35041,35,041,Roosevelt County,8752,7957,795,5739,9.1
0500000US36005,36,005,Bronx County,665907,595657,70250,449575,10.5
0500000US36035,36,035,Fulton County,25934,24360,1574,18121,6.1
0500000US36083,36,083,Rensselaer County,85360,81001,4359,45790,5.1
0500000US36043,36,043,Herkimer County,30834,28627,2207,20201,7.2
0500000US36089,36,089,St. Lawrence County,47838,44275,3563,41776,7.4
0500000US36113,36,113,Warren County,33416,31937,1479,20758,4.4
0500000US36027,36,027,Dutchess County,153039,144058,8981,91349,5.9
0500000US36055,36,055,Monroe County,390058,367045,23013,214918,5.9
0500000US36111,36,111,Ulster County,92456,86733,5723,58376,6.2
0500000US36051,36,051,Livingston County,30079,28822,1257,23804,4.2
0500000US36039,36,039,Greene County,21273,20292,981,19283,4.6
0500000US36003,36,003,Allegany County,21325,20029,1296,17259,6.1
0500000US36009,36,009,Cattaraugus County,35878,33610,2268,26419,6.3
0500000US36093,36,093,Schenectady County,78761,73563,5198,46497,6.6
0500000US36123,36,123,Yates County,11733,11181,552,8290,4.7
0500000US37087,37,087,Haywood County,27879,26560,1319,22955,4.7
0500000US37005,37,005,Alleghany County,4839,4555,284,4480,5.9
0500000US37045,37,045,Cleveland County,43705,39701,4004,34712,9.2
0500000US37077,37,077,Granville County,27980,26285,1695,20164,6.1
0500000US37093,37,093,Hoke County,20849,18961,1888,16231,9.1
0500000US37097,37,097,Iredell County,88727,83378,5349,48238,6.0
0500000US37147,37,147,Pitt County,91627,83183,8444,51278,9.2
0500000US37039,37,039,Cherokee County,11002,10300,702,12430,6.4
0500000US37193,37,193,Wilkes County,31051,29252,1799,24777,5.8
0500000US37003,37,003,Alexander County,17434,16264,1170,13039,6.7
0500000US37031,37,031,Carteret County,32757,30598,2159,24630,6.6
0500000US37139,37,139,Pasquotank County,17476,16289,1187,13415,6.8
0500000US37173,37,173,Swain County,6113,5693,420,5318,6.9
0500000US37007,37,007,Anson County,11493,10354,1139,9493,9.9
0500000US37069,37,069,Franklin County,31541,29810,1731,20541,5.5
0500000US37113,37,113,Macon County,14605,13955,650,14114,4.5
0500000US37175,37,175,Transylvania County,14340,13511,829,14340,5.8
0500000US37047,37,047,Columbus County,21227,19740,1487,24239,7.0
0500000US37123,37,123,Montgomery County,11078,10551,527,10685,4.8
0500000US37153,37,153,Richmond County,19230,17389,1841,16473,9.6
0500000US37171,37,171,Surry County,32109,30687,1422,26279,4.4
0500000US37021,37,021,Buncombe County,130047,124844,5203,81138,4.0
0500000US37025,37,025,Cabarrus County,105902,99553,6349,49225,6.0
0500000US37057,37,057,Davidson County,79919,74174,5745,52322,7.2
0500000US37091,37,091,Hertford County,10428,9283,1145,9599,11.0
0500000US37141,37,141,Pender County,27332,25316,2016,19747,7.4
0500000US37189,37,189,Watauga County,26975,24966,2009,20962,7.4
0500000US37177,37,177,Tyrrell County,1648,1560,88,1975,5.3
0500000US38097,38,097,Traill County,4182,4056,126,2239,3.0
0500000US38021,38,021,Dickey County,2679,2606,73,1297,2.7
0500000US38101,38,101,Ward County,36818,35738,1080,13867,2.9
0500000US38049,38,049,McHenry County,2972,2923,49,1673,1.6
0500000US38005,38,005,Benson County,2517,2372,145,2190,5.8
0500000US38075,38,075,Renville County,1237,1214,23,700,1.9
0500000US38015,38,015,Burleigh County,52495,51500,995,21498,1.9
0500000US38065,38,065,Oliver County,850,813,37,579,4.4
0500000US38071,38,071,Ramsey County,6072,6025,47,2970,0.8
0500000US38039,38,039,Griggs County,1197,1182,15,673,1.3
0500000US38083,38,083,Sheridan County,613,597,16,594,2.6
0500000US38103,38,103,Wells County,1994,1941,53,1295,2.7
0500000US39099,39,099,Mahoning County,114014,104885,9129,76034,8.0
0500000US39145,39,145,Scioto County,30496,28093,2403,31139,7.9
0500000US39105,39,105,Meigs County,9866,9046,820,8917,8.3
0500000US39131,39,131,Pike County,11265,10316,949,11129,8.4
0500000US39061,39,061,Hamilton County,428852,402685,26167,215309,6.1
0500000US39087,39,087,Lawrence County,25888,24286,1602,22891,6.2
0500000US39157,39,157,Tuscarawas County,45839,43937,1902,27855,4.1
0500000US39015,39,015,Brown County,20648,19494,1154,14160,5.6
0500000US39043,39,043,Erie County,38085,36035,2050,23681,5.4
0500000US39089,39,089,Licking County,87830,83490,4340,48789,4.9
0500000US39019,39,019,Carroll County,13143,12532,611,9469,4.6
0500000US39025,39,025,Clermont County,105619,101146,4473,54982,4.2
0500000US39071,39,071,Highland County,18896,17659,1237,14976,6.5
0500000US39133,39,133,Portage County,88961,83366,5595,46776,6.3
0500000US39013,39,013,Belmont County,30874,28992,1882,26104,6.1
0500000US39127,39,127,Perry County,16404,15170,1234,12038,7.5
0500000US48395,48,395,Robertson County,7907,7401,506,5316,6.4
0500000US48441,48,441,Taylor County,65740,62890,2850,36547,4.3
0500000US48455,48,455,Trinity County,5389,4938,451,6558,8.4
0500000US48019,48,019,Bandera County,9850,9243,607,8585,6.2
0500000US48079,48,079,Cochran County,1290,1207,83,899,6.4
0500000US48091,48,091,Comal County,64339,61977,2362,43183,3.7
0500000US48225,48,225,Houston County,8378,8197,181,10550,2.2
0500000US48375,48,375,Potter County,54756,52637,2119,35999,3.9
0500000US48415,48,415,Scurry County,7032,6740,292,6226,4.2
0500000US48433,48,433,Stonewall County,600,586,14,498,2.3
0500000US48049,48,049,Brown County,16635,15974,661,13659,4.0
0500000US48025,48,025,Bee County,10374,9449,925,16258,8.9
0500000US48103,48,103,Crane County,2056,2029,27,1425,1.3
0500000US48307,48,307,McCulloch County,3878,3781,97,2637,2.5
0500000US48287,48,287,Lee County,8253,8019,234,5459,2.8
0500000US48139,48,139,Ellis County,85034,81964,3070,43358,3.6
0500000US48265,48,265,Kerr County,23104,21870,1234,19434,5.3
0500000US48145,48,145,Falls County,6195,5809,386,7854,6.2
0500000US19137,19,137,Montgomery County,5125,4779,346,2992,6.8
0500000US19123,19,123,Mahaska County,11384,10783,601,6110,5.3
0500000US19019,19,019,Buchanan County,10725,10407,318,5259,3.0
0500000US19053,19,053,Decatur County,3892,3720,172,2588,4.4
0500000US20085,20,085,Jackson County,6580,6199,381,3800,5.8
0500000US20109,20,109,Logan County,1448,1422,26,764,1.8
0500000US20209,20,209,Wyandotte County,80722,74707,6015,42018,7.5
0500000US20027,20,027,Clay County,4121,4016,105,2189,2.5
0500000US20169,20,169,Saline County,28425,27342,1083,14900,3.8
0500000US20197,20,197,Wabaunsee County,3477,3368,109,1986,3.1
0500000US20123,20,123,Mitchell County,2840,2753,87,2138,3.1
0500000US20005,20,005,Atchison County,8097,7721,376,4738,4.6
0500000US20055,20,055,Finney County,19559,18631,928,7205,4.7
0500000US20103,20,103,Leavenworth County,36765,35313,1452,24315,3.9
0500000US20187,20,187,Stanton County,1046,1030,16,536,1.5
0500000US20119,20,119,Meade County,2145,2084,61,1136,2.8
0500000US20151,20,151,Pratt County,4695,4515,180,2600,3.8
0500000US20003,20,003,Anderson County,3630,3524,106,2377,2.9
0500000US20061,20,061,Geary County,12626,11798,828,6828,6.6
0500000US20057,20,057,Ford County,17691,16646,1045,7320,5.9
0500000US20117,20,117,Marshall County,4967,4759,208,2751,4.2
0500000US20023,20,023,Cheyenne County,1281,1243,38,894,3.0
0500000US20035,20,035,Cowley County,16342,15544,798,11667,4.9
0500000US20059,20,059,Franklin County,13385,12787,598,6670,4.5
0500000US20089,20,089,Jewell County,1261,1228,33,1179,2.6
0500000US20159,20,159,Rice County,5017,4753,264,2780,5.3
0500000US20017,20,017,Chase County,1168,1116,52,938,4.5
0500000US20203,20,203,Wichita County,1111,1084,27,568,2.4
0500000US20137,20,137,Norton County,2469,2440,29,2057,1.2
0500000US20009,20,009,Barton County,14020,13479,541,7006,3.9
0500000US20047,20,047,Edwards County,1477,1444,33,848,2.2
0500000US20165,20,165,Rush County,1541,1489,52,989,3.4
0500000US20115,20,115,Marion County,5891,5632,259,3823,4.4
0500000US20143,20,143,Ottawa County,3029,2949,80,1718,2.6
0500000US20007,20,007,Barber County,2210,2172,38,1499,1.7
0500000US20041,20,041,Dickinson County,9143,8617,526,5736,5.8
0500000US21223,21,223,Trimble County,4246,3809,437,2751,10.3
0500000US21105,21,105,Hickman County,1712,1613,99,2084,5.8
0500000US21179,21,179,Nelson County,23132,21821,1311,12454,5.7
0500000US21081,21,081,Grant County,11082,10685,397,7612,3.6
0500000US21141,21,141,Logan County,11395,10758,637,9741,5.6
0500000US21191,21,191,Pendleton County,6633,6375,258,4960,3.9
0500000US21215,21,215,Spencer County,10175,9673,502,4540,4.9
0500000US21011,21,011,Bath County,5115,4750,365,4365,7.1
0500000US21021,21,021,Boyle County,12973,12357,616,11695,4.7
0500000US21095,21,095,Harlan County,8277,7489,788,13269,9.5
0500000US21137,21,137,Lincoln County,10467,9763,704,8864,6.7
0500000US21171,21,171,Monroe County,4689,4397,292,3857,6.2
0500000US21225,21,225,Union County,6785,6230,555,5395,8.2
0500000US21035,21,035,Calloway County,18748,17816,932,13757,5.0
0500000US21059,21,059,Daviess County,47976,45375,2601,29983,5.4
0500000US21101,21,101,Henderson County,21413,20402,1011,15380,4.7
0500000US21119,21,119,Knott County,5281,4626,655,7379,12.4
0500000US21177,21,177,Muhlenberg County,12921,11770,1151,12643,8.9
0500000US21199,21,199,Pulaski County,27508,25191,2317,24014,8.4
0500000US21001,21,001,Adair County,8549,8020,529,7374,6.2
0500000US21057,21,057,Cumberland County,2586,2440,146,2887,5.6
0500000US21129,21,129,Lee County,2012,1838,174,3500,8.6
0500000US21135,21,135,Lewis County,4932,4590,342,5990,6.9
0500000US21239,21,239,Woodford County,13483,13046,437,7352,3.2
0500000US21113,21,113,Jessamine County,25679,24081,1598,15346,6.2
0500000US21133,21,133,Letcher County,8021,6993,1028,10319,12.8
0500000US21145,21,145,McCracken County,30146,28879,1267,22297,4.2
0500000US21235,21,235,Whitley County,13786,12639,1147,14239,8.3
0500000US21071,21,071,Floyd County,11989,10592,1397,17997,11.7
0500000US21147,21,147,McCreary County,5243,4407,836,9070,15.9
0500000US21169,21,169,Metcalfe County,4144,3920,224,3820,5.4
0500000US21205,21,205,Rowan County,10567,10065,502,9715,4.8
0500000US21049,21,049,Clark County,17270,16231,1039,11454,6.0
0500000US21041,21,041,Carroll County,4888,4446,442,3339,9.0
0500000US21065,21,065,Estill County,5257,4625,632,6422,12.0
0500000US21089,21,089,Greenup County,15264,14012,1252,13734,8.2
0500000US21043,21,043,Carter County,9509,8769,740,12401,7.8
0500000US22057,22,057,Lafourche Parish,46489,43293,3196,30737,6.9
0500000US22053,22,053,Jefferson Davis Parish,13426,12222,1204,10911,9.0
0500000US22125,22,125,West Feliciana Parish,6211,5731,480,6921,7.7
0500000US22011,22,011,Beauregard Parish,15479,14252,1227,13006,7.9
0500000US22039,22,039,Evangeline Parish,13428,11610,1818,12482,13.5
0500000US22061,22,061,Lincoln Parish,22480,20890,1590,16527,7.1
0500000US22119,22,119,Webster Parish,16194,15292,902,15468,5.6
0500000US22047,22,047,Iberville Parish,13689,12798,891,13006,6.5
0500000US22067,22,067,Morehouse Parish,9813,9279,534,10638,5.4
0500000US22109,22,109,Terrebonne Parish,50039,46729,3310,36932,6.6
0500000US22027,22,027,Claiborne Parish,5801,5253,548,7759,9.4
0500000US22009,22,009,Avoyelles Parish,16176,15018,1158,16036,7.2
0500000US22077,22,077,Pointe Coupee Parish,10072,9243,829,7645,8.2
0500000US22115,22,115,Vernon Parish,18825,17127,1698,14909,9.0
0500000US22085,22,085,Sabine Parish,9031,8103,928,9931,10.3
0500000US22059,22,059,LaSalle Parish,5137,4941,196,6729,3.8
0500000US23015,23,015,Lincoln County,16942,16304,638,12164,3.8
0500000US23021,23,021,Piscataquis County,6864,6334,530,7575,7.7
0500000US23029,23,029,Washington County,13840,12876,964,12540,7.0
0500000US23023,23,023,Sagadahoc County,18938,18442,496,10392,2.6
0500000US23011,23,011,Kennebec County,61956,58919,3037,38549,4.9
0500000US23009,23,009,Hancock County,28053,26731,1322,17930,4.7
0500000US24039,24,039,Somerset County,9560,8707,853,12320,8.9
0500000US24001,24,001,Allegany County,31505,28820,2685,29312,8.5
0500000US24033,24,033,Prince George's County,515391,480863,34528,206497,6.7
0500000US24021,24,021,Frederick County,137863,131548,6315,58519,4.6
0500000US24029,24,029,Kent County,9664,9239,425,7031,4.4
0500000US25027,25,027,Worcester County,443235,418705,24530,224081,5.5
0500000US26033,26,033,Chippewa County,16729,15179,1550,14822,9.3
0500000US26125,26,125,Oakland County,671024,638789,32235,343926,4.8
0500000US26121,26,121,Muskegon County,80025,74113,5912,57004,7.4
0500000US26087,26,087,Lapeer County,41843,39162,2681,29984,6.4
0500000US26151,26,151,Sanilac County,19150,17802,1348,14446,7.0
0500000US26131,26,131,Ontonagon County,2226,2066,160,3092,7.2
0500000US26001,26,001,Alcona County,3703,3372,331,5512,8.9
0500000US26079,26,079,Kalkaska County,7826,7236,590,6391,7.5
0500000US26129,26,129,Ogemaw County,8395,7720,675,9155,8.0
0500000US26165,26,165,Wexford County,14950,14045,905,11266,6.1
0500000US26043,26,043,Dickinson County,11788,11274,514,9317,4.4
0500000US26065,26,065,Ingham County,151734,140932,10802,86462,7.1
0500000US26109,26,109,Menominee County,11400,10902,498,7964,4.4
0500000US26113,26,113,Missaukee County,6633,6213,420,5300,6.3
0500000US26159,26,159,Van Buren County,36416,34169,2247,23221,6.2
0500000US26015,26,015,Barry County,29752,28209,1543,18481,5.2
0500000US26019,26,019,Benzie County,8288,7827,461,6406,5.6
0500000US26153,26,153,Schoolcraft County,3129,2807,322,3710,10.3
0500000US26055,26,055,Grand Traverse County,48479,46120,2359,26456,4.9
0500000US26049,26,049,Genesee County,188265,169798,18467,138278,9.8
0500000US26093,26,093,Livingston County,100618,96375,4243,51944,4.2
0500000US26101,26,101,Manistee County,10172,9444,728,10565,7.2
0500000US26051,26,051,Gladwin County,9415,8757,658,11662,7.0
0500000US05075,05,075,Lawrence County,7126,6613,513,6265,7.2
0500000US05029,05,029,Conway County,9429,8870,559,7074,5.9
0500000US05001,05,001,Arkansas County,8316,7796,520,6263,6.3
0500000US05085,05,085,Lonoke County,33753,32335,1418,20904,4.2
0500000US06047,06,047,Merced County,117550,102638,14912,80376,12.7
0500000US06049,06,049,Modoc County,3399,3125,274,4030,8.1
0500000US06027,06,027,Inyo County,8537,8090,447,6328,5.2
0500000US06099,06,099,Stanislaus County,248662,222532,26130,160004,10.5
0500000US06103,06,103,Tehama County,26749,24265,2484,23226,9.3
0500000US06069,06,069,San Benito County,31125,28831,2294,14516,7.4
0500000US06017,06,017,El Dorado County,88529,83049,5480,64709,6.2
0500000US06075,06,075,San Francisco County,540702,515382,25320,223550,4.7
0500000US06107,06,107,Tulare County,195557,177236,18321,136749,9.4
0500000US06057,06,057,Nevada County,46339,43368,2971,37730,6.4
0500000US06039,06,039,Madera County,63042,57799,5243,54108,8.3
0500000US06105,06,105,Trinity County,5204,4758,446,5811,8.6
0500000US06071,06,071,San Bernardino County,978082,892435,85647,639400,8.8
0500000US06061,06,061,Placer County,182498,173493,9005,121102,4.9
0500000US06095,06,095,Solano County,218059,202713,15346,129333,7.0
0500000US06011,06,011,Colusa County,10183,9663,520,6030,5.1
0500000US06031,06,031,Kings County,58072,53217,4855,51282,8.4
0500000US06019,06,019,Fresno County,441451,400175,41276,284911,9.4
0500000US06111,06,111,Ventura County,438081,412228,25853,230724,5.9
0500000US08123,08,123,Weld County,153007,146177,6830,71562,4.5
0500000US08027,08,027,Custer County,1503,1405,98,2416,6.5
0500000US08035,08,035,Douglas County,181993,176575,5418,67370,3.0
0500000US08067,08,067,La Plata County,30796,29546,1250,14884,4.1
0500000US08105,08,105,Rio Grande County,4949,4481,468,4162,9.5
0500000US08011,08,011,Bent County,1645,1526,119,3368,7.2
0500000US08111,08,111,San Juan County,319,310,9,166,2.8
0500000US08075,08,075,Logan County,11152,10690,462,6395,4.1
0500000US08119,08,119,Teller County,12470,11679,791,7698,6.3
0500000US08039,08,039,Elbert County,13829,13449,380,6402,2.7
0500000US08073,08,073,Lincoln County,1576,1529,47,2999,3.0
0500000US08003,08,003,Alamosa County,7602,6894,708,5326,9.3
0500000US08043,08,043,Fremont County,15101,14196,905,25009,6.0
0500000US08085,08,085,Montrose County,18643,17337,1306,14562,7.0
0500000US08109,08,109,Saguache County,2695,2510,185,2500,6.9
0500000US08053,08,053,Hinsdale County,420,404,16,334,3.8
0500000US08049,08,049,Grand County,9100,8630,470,3683,5.2
0500000US08089,08,089,Otero County,7637,6993,644,6980,8.4
0500000US09005,09,005,Litchfield County,102769,97390,5379,50457,5.2
0500000US09011,09,011,New London County,141776,133036,8740,73053,6.2
0500000US09001,09,001,Fairfield County,511058,475513,35545,242906,7.0
0500000US10001,10,001,Kent County,84194,79233,4961,51911,5.9
0500000US12057,12,057,Hillsborough County,708895,665406,43489,385470,6.1
0500000US12129,12,129,Wakulla County,14064,13328,736,11655,5.2
0500000US12045,12,045,Gulf County,6106,5654,452,7620,7.4
0500000US12097,12,097,Osceola County,165934,155492,10442,99107,6.3
0500000US12131,12,131,Walton County,31015,29404,1611,22679,5.2
0500000US12065,12,065,Jefferson County,5520,5247,273,6528,4.9
0500000US12049,12,049,Hardee County,10648,10011,637,10048,6.0
0500000US12093,12,093,Okeechobee County,15846,14722,1124,17124,7.1
0500000US12041,12,041,Gilchrist County,7215,6775,440,7375,6.1
0500000US12001,12,001,Alachua County,131825,123777,8048,88920,6.1
0500000US12015,12,015,Charlotte County,65669,60875,4794,91860,7.3
0500000US12085,12,085,Martin County,69251,65578,3673,64818,5.3
0500000US12115,12,115,Sarasota County,174578,166424,8154,185221,4.7
0500000US12017,12,017,Citrus County,50063,45771,4292,74501,8.6
0500000US12113,12,113,Santa Rosa County,77352,72986,4366,56876,5.6
0500000US12011,12,011,Broward County,1016959,949870,67089,530240,6.6
0500000US12087,12,087,Monroe County,41588,40392,1196,23413,2.9
0500000US13313,13,313,Whitfield County,50425,47247,3178,29462,6.3
0500000US13285,13,285,Troup County,32374,29824,2550,21833,7.9
0500000US13145,13,145,Harris County,16355,15186,1169,10541,7.1
0500000US13321,13,321,Worth County,9410,8801,609,7016,6.5
0500000US13109,13,109,Evans County,4662,4297,365,3477,7.8
0500000US13307,13,307,Webster County,1082,1058,24,961,2.2
0500000US13125,13,125,Glascock County,1411,1364,47,996,3.3
0500000US13051,13,051,Chatham County,147441,135574,11867,80815,8.0
0500000US13173,13,173,Lanier County,3990,3643,347,3699,8.7
0500000US13195,13,195,Madison County,13686,12522,1164,9154,8.5
0500000US13147,13,147,Hart County,10457,9948,509,10393,4.9
0500000US13191,13,191,McIntosh County,6405,5900,505,5490,7.9
0500000US13237,13,237,Putnam County,9677,9234,443,7947,4.6
0500000US13301,13,301,Warren County,2354,2165,189,1981,8.0
0500000US13029,13,029,Bryan County,16987,15755,1232,8582,7.3
0500000US13039,13,039,Camden County,23032,21340,1692,14292,7.3
0500000US13099,13,099,Early County,4069,3761,308,4086,7.6
0500000US13069,13,069,Coffee County,17428,16627,801,16145,4.6
0500000US13123,13,123,Gilmer County,13530,12787,743,11274,5.5
0500000US13317,13,317,Wilkes County,4217,4035,182,3808,4.3
0500000US13129,13,129,Gordon County,26898,25667,1231,17630,4.6
0500000US13057,13,057,Cherokee County,128026,122561,5465,59951,4.3
0500000US13177,13,177,Lee County,14330,13267,1063,8092,7.4
0500000US13133,13,133,Greene County,6633,6305,328,7360,4.9
0500000US13075,13,075,Cook County,7467,7078,389,5815,5.2
0500000US13121,13,121,Fulton County,552497,516732,35765,263571,6.5
0500000US13187,13,187,Lumpkin County,16397,15665,732,10367,4.5
0500000US13201,13,201,Miller County,2496,2371,125,2171,5.0
0500000US13219,13,219,Oconee County,18767,18115,652,9820,3.5
0500000US13151,13,151,Henry County,112198,104676,7522,58618,6.7
0500000US13183,13,183,Long County,7338,6232,1106,5474,15.1
0500000US13257,13,257,Stephens County,11335,10301,1034,9255,9.1
0500000US13293,13,293,Upson County,10895,10005,890,9980,8.2
0500000US13225,13,225,Peach County,11585,10524,1061,10134,9.2
0500000US13229,13,229,Pierce County,8161,7687,474,6731,5.8
0500000US13251,13,251,Screven County,5908,5539,369,5348,6.2
0500000US13011,13,011,Banks County,8231,7795,436,6561,5.3
0500000US13061,13,061,Clay County,1059,876,183,1403,17.3
0500000US13089,13,089,DeKalb County,405043,375217,29826,180836,7.4
0500000US13157,13,157,Jackson County,31056,29560,1496,19391,4.8
0500000US13181,13,181,Lincoln County,3415,3259,156,3035,4.6
0500000US13235,13,235,Pulaski County,3891,3704,187,5846,4.8
0500000US13281,13,281,Towns County,4513,4267,246,5612,5.5
0500000US13287,13,287,Turner County,3324,3120,204,2902,6.1
0500000US13001,13,001,Appling County,7756,7296,460,6617,5.9
0500000US16077,16,077,Power County,3349,3218,131,2321,3.9
0500000US16071,16,071,Oneida County,1791,1700,91,1428,5.1
0500000US16063,16,063,Lincoln County,2573,2494,79,1317,3.1
0500000US16041,16,041,Franklin County,5943,5861,82,3481,1.4
0500000US16053,16,053,Jerome County,11051,10607,444,5772,4.0
0500000US16067,16,067,Minidoka County,9675,9339,336,5634,3.5
0500000US16013,16,013,Blaine County,12682,12435,247,5062,1.9
0500000US16021,16,021,Boundary County,4581,4401,180,4619,3.9
0500000US16047,16,047,Gooding County,7293,6970,323,4170,4.4
0500000US16007,16,007,Bear Lake County,2595,2514,81,1956,3.1
0500000US16019,16,019,Bonneville County,51326,49395,1931,29649,3.8
0500000US16035,16,035,Clearwater County,3110,2939,171,4309,5.5
0500000US16059,16,059,Lemhi County,3328,3212,116,3202,3.5
0500000US16017,16,017,Bonner County,18371,17690,681,16901,3.7
0500000US16037,16,037,Custer County,1699,1619,80,1876,4.7
0500000US16065,16,065,Madison County,19239,17962,1277,9926,6.6
0500000US16081,16,081,Teton County,6059,5698,361,2323,6.0
0500000US15003,15,003,Honolulu County,491936,470748,21188,267244,4.3
0500000US17183,17,183,Vermilion County,34118,31575,2543,27733,7.5
0500000US17023,17,023,Clark County,8299,7773,526,4276,6.3
0500000US17049,17,049,Effingham County,18053,17344,709,8905,3.9
0500000US17065,17,065,Hamilton County,3754,3635,119,2833,3.2
0500000US17087,17,087,Johnson County,4113,3878,235,6475,5.7
0500000US17105,17,105,Livingston County,17214,16284,930,12349,5.4
0500000US17179,17,179,Tazewell County,66159,63328,2831,40191,4.3
0500000US17187,17,187,Warren County,8663,8086,577,5255,6.7
0500000US17119,17,119,Madison County,134969,125733,9236,78757,6.8
0500000US17131,17,131,Mercer County,7821,7392,429,4857,5.5
0500000US17003,17,003,Alexander County,2385,2218,167,2692,7.0
0500000US17157,17,157,Randolph County,13633,12944,689,13175,5.1
0500000US17115,17,115,Macon County,52138,47876,4262,33187,8.2
0500000US17191,17,191,Wayne County,7779,7507,272,5345,3.5
0500000US17055,17,055,Franklin County,16966,15528,1438,14397,8.5
0500000US17109,17,109,McDonough County,14577,13464,1113,11707,7.6
0500000US17139,17,139,Moultrie County,7155,6925,230,4203,3.2
0500000US17151,17,151,Pope County,1501,1267,234,2168,15.6
0500000US17173,17,173,Shelby County,10848,10347,501,6917,4.6
0500000US17019,17,019,Champaign County,108722,103515,5207,65589,4.8
0500000US17053,17,053,Ford County,6617,6264,353,4118,5.3
0500000US17093,17,093,Kendall County,67354,64083,3271,24779,4.9
0500000US17121,17,121,Marion County,18470,16723,1747,11680,9.5
0500000US17125,17,125,Mason County,6688,6162,526,4584,7.9
0500000US18149,18,149,Starke County,10393,9661,732,7883,7.0
0500000US18055,18,055,Greene County,14966,14124,842,11166,5.6
0500000US18177,18,177,Wayne County,31575,29728,1847,22034,5.8
0500000US18037,18,037,Dubois County,22545,22194,351,10495,1.6
0500000US18059,18,059,Hancock County,39727,38632,1095,18962,2.8
0500000US18115,18,115,Ohio County,3076,3004,72,1772,2.3
0500000US18121,18,121,Parke County,7146,6748,398,6464,5.6
0500000US18007,18,007,Benton County,4253,4073,180,2536,4.2
0500000US18133,18,133,Putnam County,16958,16250,708,14262,4.2
0500000US18175,18,175,Washington County,12808,12021,787,9296,6.1
0500000US18065,18,065,Henry County,21353,20056,1297,18391,6.1
0500000US18095,18,095,Madison County,60053,56373,3680,44486,6.1
0500000US18125,18,125,Pike County,5978,5726,252,3941,4.2
0500000US18151,18,151,Steuben County,17930,17250,680,10187,3.8
0500000US18179,18,179,Wells County,14084,13750,334,7627,2.4
0500000US18035,18,035,Delaware County,56883,53067,3816,39861,6.7
0500000US18077,18,077,Jefferson County,15377,14454,923,11263,6.0
0500000US18103,18,103,Miami County,16357,15271,1086,12775,6.6
0500000US18111,18,111,Newton County,6594,6161,433,4790,6.6
0500000US18141,18,141,St. Joseph County,135582,128360,7222,76284,5.3
0500000US18155,18,155,Switzerland County,4619,4355,264,3661,5.7
0500000US18015,18,015,Carroll County,9644,9242,402,6345,4.2
0500000US18069,18,069,Huntington County,19012,18366,646,10350,3.4
0500000US18181,18,181,White County,11961,11453,508,7173,4.2
0500000US18075,18,075,Jay County,10031,9491,540,6157,5.4
0500000US18019,18,019,Clark County,60811,57679,3132,31475,5.2
0500000US19101,19,101,Jefferson County,8824,8235,589,6221,6.7
0500000US19005,19,005,Allamakee County,7101,6923,178,3990,2.5
0500000US19049,19,049,Dallas County,47154,46027,1127,15662,2.4
0500000US19023,19,023,Butler County,7537,7287,250,4145,3.3
0500000US19071,19,071,Fremont County,3501,3373,128,2122,3.7
0500000US19173,19,173,Taylor County,3107,2993,114,1785,3.7
0500000US19195,19,195,Worth County,4046,3854,192,2048,4.7
0500000US19003,19,003,Adams County,1807,1756,51,1213,2.8
0500000US19037,19,037,Chickasaw County,6583,6457,126,3056,1.9
0500000US19059,19,059,Dickinson County,9454,9189,265,4809,2.8
0500000US19103,19,103,Johnson County,85489,82627,2862,34759,3.3
0500000US19171,19,171,Tama County,8849,8512,337,4685,3.8
0500000US19069,19,069,Franklin County,5042,4845,197,3017,3.9
0500000US19027,19,027,Carroll County,10855,10632,223,4991,2.1
0500000US19067,19,067,Floyd County,8125,7920,205,4533,2.5
0500000US19115,19,115,Louisa County,5805,5510,295,3151,5.1
0500000US19119,19,119,Lyon County,6216,6089,127,2562,2.0
0500000US19165,19,165,Shelby County,6204,6006,198,3215,3.2
0500000US19087,19,087,Henry County,9848,9335,513,6145,5.2
0500000US19145,19,145,Page County,7462,7143,319,5245,4.3
0500000US19155,19,155,Pottawattamie County,49341,47226,2115,24521,4.3
0500000US19043,19,043,Clayton County,9379,9181,198,4864,2.1
0500000US19021,19,021,Buena Vista County,11113,10523,590,4527,5.3
0500000US19077,19,077,Guthrie County,5459,5275,184,3063,3.4
0500000US19091,19,091,Humboldt County,4852,4672,180,2716,3.7
0500000US19183,19,183,Washington County,11597,11115,482,5689,4.2
