geo_id,state_id,county_id,county_name,race_total_population,race_hispanic_or_latino,race_not_hispanic_or_latino,race_american_indian_and_alaska_native,race_asian,race_black_or_african_american,race_native_hawaiian_and_other_pacific_islander,race_some_other_race,race_two_or_more,race_two_or_more_excluding_some_ther_and_three_or_more,race_two_or_more_including_some_other,race_white_alone
0500000US28151,28,151,Washington County,47086,729,46357,56,282,33893,0,38,167,167,0,11921
0500000US28111,28,111,Perry County,12028,181,11847,0,17,2368,0,16,147,147,0,9299
0500000US28019,28,019,Choctaw County,8321,33,8288,23,15,2594,8,0,35,35,0,5613
0500000US28057,28,057,Itawamba County,23480,360,23120,75,57,1658,7,2,132,132,0,21189
0500000US28015,28,015,Carroll County,10129,29,10100,6,0,3501,0,0,82,82,0,6511
0500000US28043,28,043,Grenada County,21278,140,21138,135,0,9205,0,0,115,115,0,11683
0500000US28063,28,063,Jefferson County,7346,28,7318,11,33,6310,0,0,6,6,0,958
0500000US28041,28,041,Greene County,13714,162,13552,53,0,3496,0,0,107,105,2,9896
0500000US28093,28,093,Marshall County,35787,1281,34506,15,24,17118,0,0,281,281,0,17068
0500000US28119,28,119,Quitman County,7372,107,7265,0,5,5282,0,0,13,13,0,1965
0500000US28011,28,011,Bolivar County,32592,701,31891,41,213,20869,0,0,189,189,0,10579
0500000US28073,28,073,Lamar County,61223,1601,59622,49,780,12240,0,0,1002,963,39,45551
0500000US28081,28,081,Lee County,84915,2228,82687,206,720,24653,6,381,753,733,20,55968
0500000US28113,28,113,Pike County,39737,686,39051,153,239,21177,4,0,144,144,0,17334
0500000US28135,28,135,Tallahatchie County,14361,1978,12383,22,206,7078,13,11,16,4,12,5037
0500000US28129,28,129,Smith County,16063,270,15793,0,69,3706,30,0,72,72,0,11916
0500000US28131,28,131,Stone County,18375,373,18002,66,0,3539,20,0,372,362,10,14005
0500000US28149,28,149,Warren County,47075,1023,46052,54,241,23124,9,6,332,332,0,22286
0500000US28023,28,023,Clarke County,15928,66,15862,10,0,5696,0,19,54,54,0,10083
0500000US28069,28,069,Kemper County,10107,132,9975,370,0,6156,0,0,10,10,0,3439
0500000US28097,28,097,Montgomery County,10198,135,10063,0,34,4414,0,0,293,291,2,5322
0500000US28105,28,105,Oktibbeha County,49481,818,48663,36,1502,18298,20,58,717,717,0,28032
0500000US28109,28,109,Pearl River County,55149,1673,53476,87,183,7037,0,62,962,945,17,45145
0500000US28079,28,079,Leake County,22870,1035,21835,1289,85,9550,0,0,117,117,0,10794
0500000US28103,28,103,Noxubee County,10828,148,10680,9,4,7820,0,0,48,48,0,2799
0500000US28099,28,099,Neshoba County,29376,599,28777,4666,136,6183,8,0,565,556,9,17219
0500000US28121,28,121,Rankin County,151240,4141,147099,206,1738,30917,41,145,1605,1597,8,112447
0500000US28137,28,137,Tate County,28493,760,27733,40,52,8352,51,0,853,826,27,18385
0500000US28077,28,077,Lawrence County,12630,79,12551,10,16,4193,0,0,97,97,0,8235
0500000US28107,28,107,Panola County,34243,693,33550,59,6,17021,11,87,271,271,0,16095
0500000US28161,28,161,Yalobusha County,12421,198,12223,5,8,4970,0,0,25,25,0,7215
0500000US28017,28,017,Chickasaw County,17279,815,16464,21,12,7505,0,18,281,261,20,8627
0500000US28029,28,029,Copiah County,28721,910,27811,9,92,14895,0,18,144,144,0,12653
0500000US28039,28,039,George County,23710,652,23058,227,98,1908,0,0,109,109,0,20716
0500000US28049,28,049,Hinds County,241774,3741,238033,239,1890,173948,53,296,1392,1343,49,60215
0500000US28101,28,101,Newton County,21524,402,21122,1109,110,6519,0,2,233,209,24,13149
0500000US28145,28,145,Union County,28356,1208,27148,0,112,4145,49,0,600,581,19,22242
0500000US28125,28,125,Sharkey County,4511,5,4506,6,28,3337,0,3,0,0,0,1132
0500000US28139,28,139,Tippah County,21990,1023,20967,7,82,3679,12,5,214,214,0,16968
0500000US28035,28,035,Forrest County,75517,2246,73271,132,678,27895,0,12,1535,1523,12,43019
0500000US28045,28,045,Hancock County,46653,1792,44861,272,317,3776,0,73,886,886,0,39537
0500000US28071,28,071,Lafayette County,53459,1411,52048,82,1117,12622,17,209,576,537,39,37425
0500000US28055,28,055,Issaquena County,1328,16,1312,0,0,799,0,0,0,0,0,513
0500000US28087,28,087,Lowndes County,59437,1212,58225,113,539,25936,17,63,689,683,6,30868
0500000US28083,28,083,Leflore County,29804,786,29018,0,183,21859,0,18,251,251,0,6707
0500000US28157,28,157,Wilkinson County,8990,37,8953,0,7,6379,0,30,34,34,0,2503
0500000US28047,28,047,Harrison County,202626,11032,191594,1042,5707,49298,84,135,5164,5090,74,130164
0500000US28065,28,065,Jefferson Davis County,11495,34,11461,0,20,7036,0,0,68,68,0,4337
0500000US28085,28,085,Lincoln County,34432,375,34057,4,160,10700,0,0,40,40,0,23153
0500000US28123,28,123,Scott County,28415,3148,25267,119,84,10849,0,3,131,131,0,14081
0500000US28159,28,159,Winston County,18358,225,18133,112,6,8733,0,0,87,87,0,9195
0500000US28163,28,163,Yazoo County,27974,1805,26169,87,120,15733,0,0,400,391,9,9829
0500000US28009,28,009,Benton County,8253,213,8040,0,0,2938,0,0,116,114,2,4986
0500000US28037,28,037,Franklin County,7757,51,7706,0,3,2793,0,0,11,11,0,4899
0500000US28061,28,061,Jasper County,16529,64,16465,1,0,8933,0,57,66,66,0,7408
0500000US28067,28,067,Jones County,68454,2993,65461,150,231,19952,36,48,715,715,0,44329
0500000US28095,28,095,Monroe County,35840,438,35402,9,30,11044,0,0,312,312,0,24007
0500000US28133,28,133,Sunflower County,26532,457,26075,23,21,19595,0,17,77,77,0,6342
0500000US28155,28,155,Webster County,9828,144,9684,9,14,1895,0,0,94,93,1,7672
0500000US28001,28,001,Adams County,31547,1776,29771,61,183,17815,0,0,304,304,0,11408
0500000US28025,28,025,Clay County,19808,137,19671,59,26,11793,0,0,71,71,0,7722
0500000US28031,28,031,Covington County,19091,92,18999,0,28,7210,17,0,175,175,0,11569
0500000US28053,28,053,Humphreys County,8539,267,8272,14,6,6470,3,0,0,0,0,1779
0500000US29123,29,123,Madison County,12205,291,11914,34,30,123,0,0,166,166,0,11561
0500000US29229,29,229,Wright County,18293,324,17969,68,88,105,0,76,215,215,0,17417
0500000US29217,29,217,Vernon County,20691,434,20257,127,138,184,0,0,355,355,0,19453
0500000US29195,29,195,Saline County,23102,2296,20806,87,204,1086,247,24,537,536,1,18621
0500000US29147,29,147,Nodaway County,22547,374,22173,47,310,637,29,0,246,236,10,20904
0500000US29041,29,041,Chariton County,7546,38,7508,7,0,183,0,0,141,141,0,7177
0500000US29079,29,079,Grundy County,10039,235,9804,128,36,25,19,16,124,124,0,9456
0500000US29141,29,141,Morgan County,20137,446,19691,100,178,161,0,0,271,269,2,18981
0500000US29223,29,223,Wayne County,13308,230,13078,46,45,74,0,0,269,261,8,12644
0500000US29017,29,017,Bollinger County,12281,136,12145,100,41,68,0,0,102,102,0,11834
0500000US29031,29,031,Cape Girardeau County,78324,1788,76536,96,1236,5853,25,13,1808,1776,32,67505
0500000US29205,29,205,Shelby County,6061,116,5945,5,9,117,0,0,28,28,0,5786
0500000US29225,29,225,Webster County,38082,765,37317,174,142,394,71,0,601,555,46,35935
0500000US29005,29,005,Atchison County,5270,66,5204,26,21,20,0,0,38,38,0,5099
0500000US29013,29,013,Bates County,16374,352,16022,100,37,238,8,0,190,188,2,15449
0500000US29015,29,015,Benton County,18989,376,18613,109,13,54,10,0,381,376,5,18046
0500000US29035,29,035,Carter County,6197,148,6049,11,0,3,0,0,184,184,0,5851
0500000US29057,29,057,Dade County,7590,156,7434,67,11,21,5,0,203,203,0,7127
0500000US29115,29,115,Linn County,12186,270,11916,19,36,48,5,19,214,213,1,11575
0500000US29091,29,091,Howell County,40102,848,39254,207,178,188,0,0,843,843,0,37838
0500000US29101,29,101,Johnson County,53689,2260,51429,263,884,2309,168,43,1610,1609,1,46152
0500000US29105,29,105,Laclede County,35507,846,34661,195,117,196,6,0,977,887,90,33170
0500000US29125,29,125,Maries County,8884,233,8651,73,22,21,0,0,36,36,0,8499
0500000US29161,29,161,Phelps County,44789,1105,43684,335,1669,1115,0,57,726,726,0,39782
0500000US29165,29,165,Platte County,98824,5821,93003,241,2644,6516,49,141,2876,2837,39,80536
0500000US29187,29,187,St. Francois County,66342,1022,65320,153,342,2911,0,5,914,844,70,60995
0500000US29003,29,003,Andrew County,17403,413,16990,29,24,274,0,2,171,168,3,16490
0500000US29033,29,033,Carroll County,8843,138,8705,21,19,152,0,0,129,129,0,8384
0500000US29061,29,061,Daviess County,8302,129,8173,27,12,85,6,0,71,71,0,7972
0500000US29103,29,103,Knox County,3951,40,3911,0,18,21,18,0,48,48,0,3806
0500000US29127,29,127,Marion County,28672,495,28177,110,201,1167,54,34,774,774,0,25837
0500000US29151,29,151,Osage County,13619,108,13511,91,9,39,0,44,76,74,2,13252
0500000US29181,29,181,Ripley County,13693,184,13509,64,33,52,33,16,297,274,23,13014
0500000US29219,29,219,Warren County,33908,1118,32790,88,166,695,32,3,661,661,0,31145
0500000US29007,29,007,Audrain County,25735,767,24968,73,46,1569,23,15,889,723,166,22353
0500000US29043,29,043,Christian County,84275,2416,81859,301,497,568,44,4,1641,1634,7,78804
0500000US29077,29,077,Greene County,288429,10430,277999,1349,5559,9348,161,253,7950,7854,96,253379
0500000US29081,29,081,Harrison County,8554,185,8369,14,8,73,0,4,110,110,0,8160
0500000US29185,29,185,St. Clair County,9383,119,9264,69,19,70,0,0,242,242,0,8864
0500000US29001,29,001,Adair County,25325,337,24988,52,581,870,63,49,493,461,32,22880
0500000US29199,29,199,Scotland County,4898,0,4898,0,0,79,0,0,47,47,0,4772
0500000US29211,29,211,Sullivan County,6317,1150,5167,33,6,184,12,31,34,34,0,4867
0500000US29045,29,045,Clark County,6800,13,6787,24,28,23,0,0,114,114,0,6598
0500000US29099,29,099,Jefferson County,223302,4251,219051,631,1646,2023,34,218,3461,3397,64,211038
0500000US29111,29,111,Lewis County,10027,177,9850,77,2,330,11,0,142,138,4,9288
0500000US29143,29,143,New Madrid County,17811,319,17492,68,5,2780,0,0,393,388,5,14246
0500000US29157,29,157,Perry County,19146,428,18718,63,133,56,0,0,191,191,0,18275
0500000US29173,29,173,Ralls County,10217,126,10091,54,52,130,0,11,81,81,0,9763
0500000US29177,29,177,Ray County,22825,547,22278,114,38,394,0,25,292,292,0,21415
0500000US29189,29,189,St. Louis County,998684,28303,970381,1506,41418,239475,225,2629,21464,20881,583,663664
0500000US29209,29,209,Stone County,31527,694,30833,331,47,50,28,1,432,432,0,29944
0500000US29009,29,009,Barry County,35493,3262,32231,237,362,55,0,0,1011,1011,0,30566
0500000US29019,29,019,Boone County,176515,5950,170565,348,7878,15465,192,328,6901,6780,121,139453
0500000US29039,29,039,Cedar County,13938,300,13638,0,38,6,31,22,337,337,0,13204
0500000US29055,29,055,Crawford County,24280,472,23808,0,34,70,0,20,546,546,0,23138
0500000US29093,29,093,Iron County,10221,177,10044,65,19,124,8,0,175,173,2,9653
0500000US29117,29,117,Livingston County,15076,265,14811,81,80,401,22,0,256,256,0,13971
0500000US29135,29,135,Moniteau County,15958,736,15222,52,28,601,0,0,251,250,1,14290
0500000US29149,29,149,Oregon County,10699,184,10515,156,44,16,27,0,195,195,0,10077
0500000US29159,29,159,Pettis County,42371,3675,38696,46,193,1335,0,52,1056,1053,3,36014
0500000US29186,29,186,Ste. Genevieve County,17871,203,17668,0,102,316,0,2,156,156,0,17092
0500000US29175,29,175,Randolph County,24945,510,24435,132,120,1453,15,53,521,521,0,22141
0500000US29069,29,069,Dunklin County,30428,1985,28443,110,131,2961,0,20,648,648,0,24573
0500000US29071,29,071,Franklin County,102781,1748,101033,204,562,694,12,92,1692,1661,31,97777
0500000US29089,29,089,Howard County,10113,153,9960,51,18,531,0,0,190,190,0,9170
0500000US29095,29,095,Jackson County,692003,61310,630693,2215,12509,162022,1879,2506,18149,17799,350,431413
0500000US29131,29,131,Miller County,25049,470,24579,237,108,111,0,6,328,317,11,23789
0500000US29169,29,169,Pulaski County,52591,5769,46822,467,1379,6064,80,85,2191,2179,12,36556
0500000US29171,29,171,Putnam County,4815,7,4808,9,30,13,0,0,123,123,0,4633
0500000US29213,29,213,Taney County,54720,3153,51567,511,474,681,21,75,1087,1084,3,48718
0500000US29215,29,215,Texas County,25671,539,25132,573,121,579,0,0,453,453,0,23406
0500000US29021,29,021,Buchanan County,89076,5780,83296,196,918,4845,208,27,2784,2769,15,74318
0500000US29025,29,025,Caldwell County,9049,194,8855,54,46,47,0,0,139,139,0,8569
0500000US29027,29,027,Callaway County,44840,919,43921,232,370,1932,225,75,669,645,24,40418
0500000US29037,29,037,Cass County,102678,4418,98260,533,825,3650,29,68,2530,2525,5,90625
0500000US29049,29,049,Clinton County,20475,421,20054,166,49,380,5,4,238,229,9,19212
0500000US29053,29,053,Cooper County,17622,337,17285,46,41,1118,13,39,515,515,0,15513
0500000US29059,29,059,Dallas County,16499,334,16165,153,67,2,0,0,305,305,0,15638
0500000US29075,29,075,Gentry County,6665,99,6566,21,39,46,4,0,48,48,0,6408
0500000US29085,29,085,Hickory County,9368,151,9217,155,8,9,4,0,136,136,0,8905
0500000US29113,29,113,Lincoln County,55563,1330,54233,153,214,1052,15,0,1054,972,82,51745
0500000US29133,29,133,Mississippi County,13748,282,13466,126,7,3284,6,0,199,194,5,9844
0500000US29137,29,137,Monroe County,8654,142,8512,18,38,306,15,0,78,78,0,8057
0500000US29145,29,145,Newton County,58202,3059,55143,1315,807,530,553,38,1683,1666,17,50217
0500000US29153,29,153,Ozark County,9236,161,9075,39,32,3,0,0,181,181,0,8820
0500000US29163,29,163,Pike County,18489,415,18074,66,59,1327,12,0,304,303,1,16306
0500000US29183,29,183,St. Charles County,389985,12529,377456,533,9543,17052,29,462,8830,8569,261,341007
0500000US30017,30,017,Custer County,11845,391,11454,180,34,68,4,0,259,259,0,10909
0500000US30041,30,041,Hill County,16439,593,15846,3705,67,37,0,18,560,550,10,11459
0500000US30075,30,075,Powder River County,1619,44,1575,25,0,0,0,0,42,42,0,1508
0500000US30067,30,067,Park County,16246,484,15762,71,15,50,9,10,420,419,1,15187
0500000US30085,30,085,Roosevelt County,11228,414,10814,6236,41,35,0,0,563,559,4,3939
0500000US30005,30,005,Blaine County,6727,238,6489,3332,5,26,0,13,85,85,0,3028
0500000US30051,30,051,Liberty County,2280,49,2231,0,0,0,0,0,12,12,0,2219
0500000US30083,30,083,Richland County,11360,604,10756,338,0,0,0,29,268,268,0,10121
0500000US30099,30,099,Teton County,6080,95,5985,56,13,10,0,0,211,207,4,5695
0500000US30101,30,101,Toole County,4976,183,4793,204,126,8,0,0,96,96,0,4359
0500000US30025,30,025,Fallon County,2838,61,2777,23,20,40,0,0,39,39,0,2655
0500000US30019,30,019,Daniels County,1753,84,1669,14,11,0,0,0,5,5,0,1639
0500000US30045,30,045,Judith Basin County,1951,44,1907,29,0,0,0,0,17,17,0,1861
0500000US30093,30,093,Silver Bow County,34814,1597,33217,822,274,205,0,0,431,431,0,31485
0500000US30023,30,023,Deer Lodge County,9100,306,8794,157,61,63,0,0,299,299,0,8214
0500000US30043,30,043,Jefferson County,11778,285,11493,128,8,26,0,1,397,380,17,10933
0500000US30055,30,055,McCone County,1630,59,1571,30,6,0,0,0,4,0,4,1531
0500000US30107,30,107,Wheatland County,2149,57,2092,26,10,0,0,0,42,42,0,2014
0500000US30087,30,087,Rosebud County,9250,457,8793,3430,99,10,0,0,133,109,24,5121
0500000US30011,30,011,Carter County,1318,3,1315,7,0,0,0,0,26,26,0,1282
0500000US30021,30,021,Dawson County,9191,285,8906,192,18,114,0,0,95,94,1,8487
0500000US30007,30,007,Broadwater County,5834,161,5673,72,0,3,0,0,113,113,0,5485
0500000US30047,30,047,Lake County,29774,1314,28460,7064,107,81,50,11,1738,1702,36,19409
0500000US30073,30,073,Pondera County,6044,119,5925,871,5,26,0,0,104,104,0,4919
0500000US30111,30,111,Yellowstone County,157816,8671,149145,6376,977,900,211,105,3873,3816,57,136703
0500000US30081,30,081,Ravalli County,41902,1440,40462,386,234,34,0,0,808,808,0,39000
0500000US30105,30,105,Valley County,7532,199,7333,636,30,6,14,0,281,281,0,6366
0500000US30027,30,027,Fergus County,11273,258,11015,81,117,18,72,0,101,101,0,10626
0500000US30061,30,061,Mineral County,4211,81,4130,107,61,3,0,7,99,99,0,3853
0500000US30069,30,069,Petroleum County,432,0,432,0,8,0,0,0,0,0,0,424
0500000US30089,30,089,Sanders County,11521,327,11194,394,59,19,1,0,328,328,0,10393
0500000US30109,30,109,Wibaux County,1175,49,1126,4,4,0,0,0,0,0,0,1118
0500000US30059,30,059,Meagher County,1968,53,1915,31,0,0,0,0,27,27,0,1857
0500000US30009,30,009,Carbon County,10546,259,10287,140,21,41,0,18,108,104,4,9959
0500000US30029,30,029,Flathead County,98082,2652,95430,1450,624,296,45,127,1746,1668,78,91142
0500000US30071,30,071,Phillips County,4124,102,4022,419,18,0,0,0,108,108,0,3477
0500000US31001,31,001,Adams County,31583,3141,28442,77,395,178,9,6,515,507,8,27262
0500000US31109,31,109,Lancaster County,310094,21280,288814,1346,13171,12061,210,343,8618,8543,75,253065
0500000US31011,31,011,Boone County,5313,112,5201,1,6,22,5,0,39,39,0,5128
0500000US31149,31,149,Rock County,1350,17,1333,0,0,10,0,0,8,8,0,1315
0500000US31007,31,007,Banner County,696,42,654,0,0,0,0,0,14,14,0,640
0500000US31163,31,163,Sherman County,3042,66,2976,1,19,0,1,0,22,22,0,2933
0500000US31147,31,147,Richardson County,8009,157,7852,171,17,17,0,0,250,250,0,7397
0500000US31093,31,093,Howard County,6405,165,6240,0,13,12,2,0,96,96,0,6117
0500000US31089,31,089,Holt County,10245,464,9781,80,51,12,3,0,34,34,0,9601
0500000US31065,31,065,Furnas County,4786,190,4596,4,19,7,0,2,74,74,0,4490
0500000US31073,31,073,Gosper County,2015,46,1969,1,11,9,0,0,18,18,0,1930
0500000US31151,31,151,Saline County,14288,3517,10771,38,449,129,0,22,151,132,19,9982
0500000US31153,31,153,Sarpy County,178351,16120,162231,543,4489,6384,183,145,5334,5294,40,145153
0500000US31173,31,173,Thurston County,7140,398,6742,4008,51,19,0,0,78,78,0,2586
0500000US31177,31,177,Washington County,20219,584,19635,7,62,170,8,15,242,242,0,19131
0500000US31015,31,015,Boyd County,2042,15,2027,24,17,9,0,0,36,36,0,1941
0500000US31031,31,031,Cherry County,5790,182,5608,193,19,1,9,0,276,276,0,5110
0500000US31053,31,053,Dodge County,36683,4519,32164,137,158,261,60,31,579,579,0,30938
0500000US31059,31,059,Fillmore County,5574,220,5354,27,17,31,0,0,52,52,0,5227
0500000US31069,31,069,Garden County,1860,81,1779,8,0,4,0,0,12,12,0,1755
0500000US31091,31,091,Hooker County,691,21,670,0,0,6,0,0,0,0,0,664
0500000US31123,31,123,Morrill County,4841,752,4089,21,12,41,0,0,56,51,5,3959
0500000US31127,31,127,Nemaha County,7004,188,6816,36,52,104,1,0,36,36,0,6587
0500000US31159,31,159,Seward County,17127,457,16670,31,97,79,0,3,235,233,2,16225
0500000US31171,31,171,Thomas County,645,3,642,3,0,0,0,0,10,10,0,629
0500000US31043,31,043,Dakota County,20317,7824,12493,499,657,897,0,83,408,394,14,9949
0500000US31181,31,181,Webster County,3571,176,3395,0,0,9,5,6,99,91,8,3276
0500000US31003,31,003,Antelope County,6372,203,6169,9,10,45,0,0,34,34,0,6071
0500000US31023,31,023,Butler County,8067,261,7806,16,38,36,0,1,68,68,0,7647
0500000US31035,31,035,Clay County,6232,559,5673,12,10,4,0,0,91,91,0,5556
0500000US31041,31,041,Custer County,10830,328,10502,3,80,25,0,0,128,128,0,10266
0500000US31067,31,067,Gage County,21595,517,21078,150,125,160,23,0,165,144,21,20455
0500000US31081,31,081,Hamilton County,9178,298,8880,23,6,48,0,3,79,74,5,8721
0500000US31099,31,099,Kearney County,6552,399,6153,25,21,8,0,0,46,46,0,6053
0500000US31101,31,101,Keith County,8099,567,7532,62,56,70,16,0,32,24,8,7296
0500000US31119,31,119,Madison County,35164,5213,29951,449,527,480,0,24,347,347,0,28124
0500000US31135,31,135,Perkins County,2907,117,2790,0,0,8,0,0,15,15,0,2767
0500000US31155,31,155,Saunders County,21024,456,20568,59,71,64,0,0,306,306,0,20068
0500000US31179,31,179,Wayne County,9367,541,8826,53,48,166,0,0,108,108,0,8451
0500000US31103,31,103,Keya Paha County,792,8,784,0,0,0,0,0,4,4,0,780
0500000US31107,31,107,Knox County,8460,223,8237,790,27,23,11,0,110,108,2,7276
0500000US31111,31,111,Lincoln County,35433,2957,32476,100,110,404,11,4,624,601,23,31223
0500000US31139,31,139,Pierce County,7157,124,7033,8,30,17,6,0,68,68,0,6904
0500000US31165,31,165,Sioux County,1266,6,1260,3,3,6,0,0,90,90,0,1158
0500000US31025,31,025,Cass County,25702,811,24891,23,73,153,55,49,409,409,0,24129
0500000US31051,31,051,Dixon County,5746,762,4984,25,4,16,0,0,66,66,0,4873
0500000US31057,31,057,Dundy County,2023,317,1706,2,0,4,0,0,10,10,0,1690
0500000US31077,31,077,Greeley County,2410,50,2360,4,10,12,0,3,14,14,0,2317
0500000US31079,31,079,Hall County,61343,16704,44639,212,691,1493,157,163,696,680,16,41227
0500000US31131,31,131,Otoe County,15896,1236,14660,60,42,60,0,0,325,325,0,14173
0500000US31145,31,145,Red Willow County,10806,542,10264,2,21,80,0,4,219,219,0,9938
0500000US31045,31,045,Dawes County,8896,449,8447,400,51,142,0,10,271,271,0,7573
0500000US31033,31,033,Cheyenne County,9852,666,9186,43,126,10,2,0,159,159,0,8846
0500000US31047,31,047,Dawson County,23804,7883,15921,111,80,1431,19,10,99,99,0,14171
0500000US31117,31,117,McPherson County,454,9,445,0,0,0,0,0,15,15,0,430
0500000US31125,31,125,Nance County,3554,95,3459,11,2,16,0,0,0,0,0,3430
0500000US31167,31,167,Stanton County,5992,318,5674,0,28,85,0,0,43,43,0,5518
0500000US31175,31,175,Valley County,4224,132,4092,16,0,20,0,0,37,37,0,4019
0500000US31083,31,083,Harlan County,3438,135,3303,12,12,28,1,0,21,21,0,3229
0500000US31009,31,009,Blaine County,480,0,480,0,0,0,0,0,0,0,0,480
0500000US31019,31,019,Buffalo County,49030,4326,44704,62,693,496,0,22,716,716,0,42715
0500000US31049,31,049,Deuel County,1894,148,1746,29,13,4,0,0,17,17,0,1683
0500000US31087,31,087,Hitchcock County,2843,31,2812,2,0,3,0,0,3,3,0,2804
0500000US31141,31,141,Platte County,33063,6083,26980,123,254,160,3,27,282,237,45,26131
0500000US31169,31,169,Thayer County,5098,119,4979,13,0,23,0,2,83,83,0,4858
0500000US31013,31,013,Box Butte County,11089,1371,9718,382,33,42,0,0,189,189,0,9072
0500000US32001,32,001,Churchill County,24010,3260,20750,964,663,576,50,57,756,740,16,17684
0500000US32005,32,005,Douglas County,47828,5981,41847,904,626,304,87,63,1138,1138,0,38725
0500000US32027,32,027,Pershing County,6611,1597,5014,193,87,280,30,3,81,77,4,4340
0500000US32009,32,009,Esmeralda County,981,186,795,7,0,11,0,0,1,1,0,776
0500000US32013,32,013,Humboldt County,16904,4521,12383,887,84,70,0,147,222,222,0,10973
0500000US32021,32,021,Mineral County,4448,537,3911,909,129,110,0,3,149,104,45,2611
0500000US32033,32,033,White Pine County,9737,1522,8215,485,111,507,15,0,70,55,15,7027
0500000US32007,32,007,Elko County,52252,12667,39585,3123,593,239,119,84,469,445,24,34958
0500000US32017,32,017,Lincoln County,5174,442,4732,12,62,155,0,0,42,42,0,4461
0500000US32023,32,023,Nye County,43705,6286,37419,562,707,1033,166,0,1371,1356,15,33580
0500000US32029,32,029,Storey County,3941,203,3738,75,38,32,0,0,263,263,0,3330
0500000US32031,32,031,Washoe County,450486,108922,341564,5982,22955,9605,2604,843,13809,13369,440,285766
0500000US32003,32,003,Clark County,2141574,662081,1479493,9548,201846,235651,14480,7109,79448,77405,2043,931411
0500000US32510,32,510,Carson City,54467,12931,41536,1050,1431,908,20,145,1229,1216,13,36753
0500000US32019,32,019,Lyon County,53155,8843,44312,1320,589,479,82,239,1425,1425,0,40178
0500000US33005,33,005,Cheshire County,76263,1354,74909,133,1054,512,9,20,1325,1170,155,71856
0500000US33013,33,013,Merrimack County,149452,3104,146348,215,3103,1895,19,225,2508,2417,91,138383
0500000US33009,33,009,Grafton County,89811,2089,87722,312,3304,909,50,23,1459,1447,12,81665
0500000US33015,33,015,Rockingham County,305129,8713,296416,131,5961,2135,0,168,4934,4844,90,283087
0500000US33001,33,001,Belknap County,60640,990,59650,176,484,392,15,52,833,833,0,57698
0500000US33019,33,019,Sullivan County,43125,644,42481,217,328,291,0,1,597,597,0,41047
0500000US33011,33,011,Hillsborough County,411087,26843,384244,440,16626,9336,111,740,8169,7972,197,348822
0500000US33017,33,017,Strafford County,128237,3003,125234,67,4441,1060,26,85,2979,2755,224,116576
0500000US33007,33,007,Coos County,32038,938,31100,105,199,866,27,0,389,355,34,29514
0500000US33003,33,003,Carroll County,47840,678,47162,42,348,226,13,9,625,583,42,45899
0500000US34025,34,025,Monmouth County,623387,66528,556859,507,33587,41485,234,1490,9848,9006,842,469708
0500000US34037,34,037,Sussex County,142298,11109,131189,23,2863,2895,0,99,1775,1747,28,123534
0500000US34011,34,011,Cumberland County,153400,46254,107146,803,2040,27616,0,135,4519,4274,245,72033
0500000US34013,34,013,Essex County,793555,180241,613314,1201,41180,306647,156,7864,11576,10297,1279,244690
0500000US34029,34,029,Ocean County,591939,53964,537975,214,11251,16434,163,418,7301,7049,252,502194
0500000US34015,34,015,Gloucester County,290852,17292,273560,151,8753,28828,43,360,6129,5670,459,229296
0500000US34033,34,033,Salem County,63336,5475,57861,155,636,8172,0,102,1504,1474,30,47292
0500000US34031,34,031,Passaic County,504041,206100,297941,773,25950,52922,74,1521,5961,5258,703,210740
0500000US34007,34,007,Camden County,507367,83057,424310,541,28946,92935,167,1885,9807,9472,335,290029
0500000US34003,34,003,Bergen County,929999,180529,749470,1028,149328,49361,243,2693,14391,12885,1506,532426
0500000US34041,34,041,Warren County,106293,9411,96882,89,2849,4571,15,161,1569,1503,66,87628
0500000US34017,34,017,Hudson County,668631,288749,379882,874,99277,72198,442,3323,10863,8987,1876,192905
0500000US34005,34,005,Burlington County,446367,35026,411341,155,21512,71016,158,1478,13904,13392,512,303118
0500000US34027,34,027,Morris County,494383,64765,429618,302,50262,15554,69,622,7637,7040,597,355172
0500000US35039,35,039,Rio Arriba County,39307,28046,11261,5594,185,164,5,181,222,160,62,4910
0500000US35047,35,047,San Miguel County,28034,21757,6277,285,281,296,0,0,386,379,7,5029
0500000US35057,35,057,Torrance County,15595,6679,8916,163,57,273,0,14,393,393,0,8016
0500000US35035,35,035,Otero County,65745,24999,40746,3985,823,2137,76,32,1306,1267,39,32387
0500000US35006,35,006,Cibola County,26978,10319,16659,10531,85,250,6,82,419,401,18,5286
0500000US35019,35,019,Guadalupe County,4382,3434,948,52,0,50,0,0,16,8,8,830
0500000US35003,35,003,Catron County,3539,635,2904,2,6,0,0,0,11,11,0,2885
0500000US35029,35,029,Luna County,24264,16164,8100,198,168,271,9,0,153,153,0,7301
0500000US35031,35,031,McKinley County,72849,10434,62415,53659,711,421,30,50,1097,1060,37,6447
0500000US35055,35,055,Taos County,32888,18738,14150,2184,53,71,1,66,209,204,5,11566
0500000US35017,35,017,Grant County,28061,14127,13934,525,37,157,6,22,272,272,0,12915
0500000US35007,35,007,Colfax County,12353,6105,6248,115,42,60,0,10,244,244,0,5777
0500000US35015,35,015,Eddy County,57437,27799,29638,775,225,821,0,35,465,465,0,27317
0500000US35033,35,033,Mora County,4563,3701,862,0,0,1,0,149,0,0,0,712
0500000US35037,35,037,Quay County,8373,3781,4592,114,63,122,19,23,72,65,7,4179
0500000US35027,35,027,Lincoln County,19482,6362,13120,315,91,161,0,0,377,340,37,12176
0500000US35025,35,025,Lea County,70126,40594,29532,497,155,2543,17,190,819,784,35,25311
0500000US35049,35,049,Santa Fe County,148917,76404,72513,3689,1818,1283,115,180,1801,1673,128,63627
0500000US35051,35,051,Sierra County,11135,3369,7766,104,70,65,0,23,258,230,28,7246
0500000US35053,35,053,Socorro County,17000,8445,8555,1534,502,60,0,0,564,544,20,5895
0500000US35013,35,013,Do�a Ana County,215338,146485,68853,1473,2210,3598,42,185,2122,2023,99,59223
0500000US36095,36,095,Schoharie County,31364,972,30392,49,271,472,0,1,291,286,5,29308
0500000US36067,36,067,Onondaga County,464242,22258,441984,2274,17080,50528,105,810,13308,12961,347,357879
0500000US36019,36,019,Clinton County,80794,2310,78484,206,1183,3297,26,203,864,860,4,72705
0500000US36099,36,099,Seneca County,34612,1158,33454,135,242,1617,0,8,579,575,4,30873
0500000US36079,36,079,Putnam County,99070,14195,84875,66,1995,2548,24,241,1256,1206,50,78745
0500000US36033,36,033,Franklin County,50692,1759,48933,3618,254,2915,94,48,581,577,4,41423
0500000US36069,36,069,Ontario County,109472,5058,104414,224,1455,2503,37,219,1428,1299,129,98548
0500000US36081,36,081,Queens County,2298513,643563,1654950,5388,576353,396320,799,44832,49885,37699,12186,581373
0500000US36101,36,101,Steuben County,96927,1571,95356,102,1484,1472,12,117,1308,1265,43,90861
0500000US36041,36,041,Hamilton County,4575,71,4504,16,1,37,1,0,86,86,0,4363
0500000US36115,36,115,Washington County,61828,1642,60186,180,347,1706,0,48,727,691,36,57178
0500000US36013,36,013,Chautauqua County,129656,9585,120071,401,688,2975,55,85,2341,2293,48,113526
0500000US36047,36,047,Kings County,2600747,499279,2101468,3667,304870,787705,846,11136,52485,48177,4308,940759
0500000US36061,36,061,New York County,1632480,423683,1208797,1891,194346,203849,524,5961,36662,34126,2536,765564
0500000US36107,36,107,Tioga County,49045,927,48118,82,346,292,0,28,728,706,22,46642
0500000US36011,36,011,Cayuga County,77868,2232,75636,138,394,3241,0,104,1479,1457,22,70280
0500000US36073,36,073,Orleans County,41175,1961,39214,151,296,2457,21,9,658,653,5,35622
0500000US36091,36,091,Saratoga County,227377,7059,220318,423,6453,3489,21,313,3515,3365,150,206104
0500000US36087,36,087,Rockland County,323686,56383,267303,382,19077,36781,20,1215,4986,4592,394,204842
0500000US36021,36,021,Columbia County,60919,2827,58092,33,1095,2564,0,94,1535,1485,50,52771
0500000US36049,36,049,Lewis County,26719,456,26263,55,145,206,23,20,207,207,0,25607
0500000US36063,36,063,Niagara County,211704,6054,205650,2184,2263,14890,75,368,4355,4294,61,181515
0500000US36119,36,119,Westchester County,968815,235243,733572,1464,56806,130640,182,4203,16803,15521,1282,523474
0500000US36025,36,025,Delaware County,45502,1742,43760,70,363,720,8,39,602,589,13,41958
0500000US36031,36,031,Essex County,37751,1133,36618,78,134,1080,8,56,489,439,50,34773
0500000US36057,36,057,Montgomery County,49426,6766,42660,71,394,858,0,95,781,778,3,40461
0500000US36059,36,059,Nassau County,1356564,225581,1130983,1543,125198,151236,190,7143,21248,17377,3871,824425
0500000US36085,36,085,Richmond County,474101,86976,387125,595,40946,43906,132,1026,8160,7382,778,292360
0500000US36097,36,097,Schuyler County,17992,313,17679,31,107,162,0,10,236,228,8,17133
0500000US36109,36,109,Tompkins County,102962,5156,97806,150,10332,3808,31,365,3463,3323,140,79657
0500000US36017,36,017,Chenango County,48348,1038,47310,141,206,429,0,5,683,669,14,45846
0500000US36023,36,023,Cortland County,48123,1278,46845,111,343,693,0,93,1026,1005,21,44579
0500000US36045,36,045,Jefferson County,114448,8485,105963,427,1811,6452,208,70,3359,3317,42,93636
0500000US36065,36,065,Oneida County,230782,12892,217890,430,9134,13748,63,163,4250,4111,139,190102
0500000US36103,36,103,Suffolk County,1487901,281315,1206586,2145,56714,108250,305,6011,19770,17471,2299,1013391
0500000US36121,36,121,Wyoming County,40565,1320,39245,219,155,1710,0,0,690,664,26,36471
0500000US36015,36,015,Chemung County,85740,2595,83145,282,1240,4940,6,81,2519,2502,17,74077
0500000US36075,36,075,Oswego County,119104,2995,116109,166,767,1106,7,47,1802,1778,24,112214
0500000US36077,36,077,Otsego County,60244,2175,58069,49,816,1071,5,121,1025,909,116,54982
0500000US36117,36,117,Wayne County,90856,3878,86978,117,594,2594,78,44,1645,1608,37,81906
0500000US36001,36,001,Albany County,307426,17925,289501,322,19867,35930,131,562,9370,8847,523,223319
0500000US36007,36,007,Broome County,194402,7974,186428,339,8209,10047,56,89,4816,4678,138,162872
0500000US36029,36,029,Erie County,919866,49413,870453,4092,31615,119231,247,1276,17000,16382,618,696992
0500000US36053,36,053,Madison County,71359,1547,69812,459,630,1158,73,60,885,849,36,66547
0500000US36105,36,105,Sullivan County,75211,11836,63375,133,1176,5706,0,323,1927,1914,13,54110
0500000US36037,36,037,Genesee County,58112,1849,56263,501,477,1249,0,43,1296,1268,28,52697
0500000US36071,36,071,Orange County,378227,75705,302522,815,9913,37246,120,1546,7277,6823,454,245605
0500000US37079,37,079,Greene County,21008,3116,17892,96,20,7393,0,25,495,463,32,9863
0500000US37121,37,121,Mitchell County,15040,793,14247,64,45,50,0,0,191,191,0,13897
0500000US37041,37,041,Chowan County,14205,515,13690,62,0,4834,3,82,214,214,0,8495
0500000US37027,37,027,Caldwell County,81779,4315,77464,317,461,3919,41,167,947,947,0,71612
0500000US37035,37,035,Catawba County,156729,14810,141919,384,6550,12479,0,554,3088,2997,91,118864
0500000US37049,37,049,Craven County,103082,7404,95678,535,2828,21871,99,68,2315,2315,0,67962
0500000US37065,37,065,Edgecombe County,53332,2358,50974,95,55,30485,57,34,854,831,23,19394
0500000US37085,37,085,Harnett County,130361,16196,114165,1036,1328,26503,207,341,4220,4102,118,80530
0500000US37089,37,089,Henderson County,113625,11423,102202,323,1489,3563,151,371,1748,1632,116,94557
0500000US37095,37,095,Hyde County,5393,536,4857,6,0,1636,0,0,37,37,0,3178
0500000US37119,37,119,Mecklenburg County,1054314,137405,916909,2612,60609,324864,506,3324,26261,25293,968,498733
0500000US37131,37,131,Northampton County,20186,427,19759,70,45,11394,0,0,445,422,23,7805
0500000US37159,37,159,Rowan County,139605,11986,127619,356,1236,22176,22,148,2623,2595,28,101058
0500000US37181,37,181,Vance County,44482,3369,41113,123,288,22213,28,0,660,612,48,17801
0500000US37053,37,053,Currituck County,25796,981,24815,132,94,1452,6,143,496,490,6,22492
0500000US37179,37,179,Union County,226694,25045,201649,571,6062,25471,96,320,4567,4429,138,164562
0500000US37067,37,067,Forsyth County,371573,46913,324660,907,8340,95294,165,1389,6721,6484,237,211844
0500000US37127,37,127,Nash County,94003,6408,87595,574,832,36713,22,92,2006,1966,40,47356
0500000US37017,37,017,Bladen County,33778,2523,31255,812,35,11648,0,25,269,256,13,18466
0500000US37055,37,055,Dare County,35741,2567,33174,79,228,671,0,87,815,797,18,31294
0500000US37185,37,185,Warren County,20033,753,19280,1008,80,10121,10,33,352,352,0,7676
0500000US37195,37,195,Wilson County,81336,8310,73026,261,643,31763,1,364,1608,1547,61,38386
0500000US37015,37,015,Bertie County,19644,408,19236,206,125,11899,1,7,263,226,37,6735
0500000US37073,37,073,Gates County,11563,41,11522,108,55,3891,0,0,180,180,0,7288
0500000US37075,37,075,Graham County,8557,129,8428,898,0,13,1,0,88,88,0,7428
0500000US37117,37,117,Martin County,23054,895,22159,111,142,9662,0,0,241,231,10,12003
0500000US37115,37,115,Madison County,21405,514,20891,93,119,358,0,0,181,179,2,20140
0500000US37137,37,137,Pamlico County,12742,477,12265,22,75,2296,0,24,390,390,0,9458
0500000US37143,37,143,Perquimans County,13459,346,13113,54,39,3183,11,31,91,91,0,9704
0500000US37149,37,149,Polk County,20458,1184,19274,11,77,1050,0,449,144,144,0,17543
0500000US37151,37,151,Randolph County,142958,16069,126889,405,1661,8495,20,459,2403,2355,48,113446
0500000US37157,37,157,Rockingham County,91270,5496,85774,386,544,16759,59,187,1658,1633,25,66181
0500000US37169,37,169,Stokes County,45905,1314,44591,188,173,1957,13,18,359,315,44,41883
0500000US37187,37,187,Washington County,12156,641,11515,32,21,5755,0,31,272,266,6,5404
0500000US37029,37,029,Camden County,10447,296,10151,8,186,1462,0,0,95,95,0,8400
0500000US37043,37,043,Clay County,10813,340,10473,36,20,226,16,0,42,42,0,10133
0500000US37051,37,051,Cumberland County,332106,37826,294280,4104,7992,119158,820,632,15430,15142,288,146144
0500000US37071,37,071,Gaston County,216585,14642,201943,678,3332,34288,55,734,4692,4667,25,158164
0500000US37081,37,081,Guilford County,523582,40824,482758,1992,25574,175353,195,2019,11242,10649,593,266383
0500000US37099,37,099,Jackson County,42256,2376,39880,3273,277,897,0,57,1174,1164,10,34202
0500000US37125,37,125,Moore County,95629,6214,89415,778,1313,12083,100,58,1262,1236,26,73821
0500000US37155,37,155,Robeson County,133442,11566,121876,52256,820,31882,20,262,2624,2460,164,34012
0500000US37167,37,167,Stanly County,61114,2506,58608,160,1172,6751,9,88,1019,970,49,49409
0500000US37183,37,183,Wake County,1046558,105361,941197,2704,69780,207445,434,3282,26355,25272,1083,631197
0500000US37199,37,199,Yancey County,17667,899,16768,63,43,129,6,0,167,167,0,16360
0500000US37037,37,037,Chatham County,69791,8626,61165,144,1083,7909,30,384,1693,1683,10,49922
0500000US37111,37,111,McDowell County,45109,2700,42409,173,337,1614,14,195,614,602,12,39462
0500000US37101,37,101,Johnston County,191172,25735,165437,965,1150,28921,62,179,3678,3620,58,130482
0500000US37103,37,103,Jones County,9695,445,9250,35,19,3013,0,0,142,142,0,6041
0500000US37145,37,145,Person County,39305,1659,37646,173,152,10424,16,54,739,723,16,26088
0500000US37019,37,019,Brunswick County,126860,6028,120832,701,779,12966,36,82,2555,2465,90,103713
0500000US37009,37,009,Ashe County,26786,1336,25450,97,114,199,19,0,221,212,9,24800
0500000US37013,37,013,Beaufort County,47243,3609,43634,110,38,11826,0,17,549,535,14,31094
0500000US37107,37,107,Lenoir County,57227,4364,52863,161,266,22190,8,27,1917,1917,0,28294
0500000US37109,37,109,Lincoln County,81441,5755,75686,169,556,4048,34,243,1363,1349,14,69273
0500000US37133,37,133,Onslow County,193912,24094,169818,738,3916,26115,376,245,9610,9520,90,128818
0500000US37135,37,135,Orange County,142938,12014,130924,714,10984,16035,8,225,3834,3604,230,99124
0500000US37161,37,161,Rutherford County,66532,2817,63715,338,293,6404,13,1,1153,1122,31,55513
0500000US37163,37,163,Sampson County,63561,12297,51264,1027,374,15844,0,0,1450,1344,106,32569
0500000US37197,37,197,Yadkin County,37665,4120,33545,58,39,1308,26,16,291,291,0,31807
0500000US37011,37,011,Avery County,17501,896,16605,237,149,770,0,5,146,142,4,15298
0500000US37023,37,023,Burke County,89712,5342,84370,374,3251,5757,93,148,1478,1460,18,73269
0500000US37033,37,033,Caswell County,22746,867,21879,51,151,7492,47,0,225,225,0,13913
0500000US37059,37,059,Davie County,41991,2796,39195,156,292,2305,0,30,850,850,0,35562
0500000US37061,37,061,Duplin County,59062,12909,46153,206,164,14318,32,25,838,838,0,30570
0500000US37063,37,063,Durham County,306457,41189,265268,726,14981,111859,117,774,7377,7179,198,129434
0500000US37105,37,105,Lee County,60125,11556,48569,424,644,11642,23,106,829,805,24,34901
0500000US37129,37,129,New Hanover County,224231,12159,212072,394,2970,30738,185,250,4680,4556,124,172855
0500000US37191,37,191,Wayne County,124002,14320,109682,333,1587,37521,43,194,3364,3300,64,66640
0500000US37165,37,165,Scotland County,35262,1030,34232,4001,274,13727,8,0,846,808,38,15376
0500000US37083,37,083,Halifax County,51737,1440,50297,1836,395,27237,67,4,821,766,55,19937
0500000US37001,37,001,Alamance County,160576,19905,140671,409,2478,30569,64,266,3172,3128,44,103713
0500000US38013,38,013,Burke County,2213,69,2144,21,0,14,0,0,33,33,0,2076
0500000US38061,38,061,Mountrail County,10152,764,9388,2690,46,118,0,51,202,200,2,6281
0500000US38105,38,105,Williams County,34061,2306,31755,1010,220,1230,17,291,1406,1380,26,27581
0500000US38007,38,007,Billings County,946,57,889,5,0,11,0,0,0,0,0,873
0500000US38043,38,043,Kidder County,2460,108,2352,6,5,10,0,0,11,11,0,2320
0500000US38019,38,019,Cavalier County,3824,45,3779,48,0,4,0,1,89,89,0,3637
0500000US38037,38,037,Grant County,2380,12,2368,19,7,1,1,0,16,16,0,2324
0500000US38067,38,067,Pembina County,7016,244,6772,195,25,20,0,0,144,144,0,6388
0500000US38091,38,091,Steele County,1910,30,1880,0,0,11,0,0,0,0,0,1869
0500000US38041,38,041,Hettinger County,2576,83,2493,82,0,9,5,0,58,58,0,2339
0500000US38045,38,045,LaMoure County,4100,59,4041,8,0,22,0,0,64,64,0,3947
0500000US38059,38,059,Morton County,30544,960,29584,1176,138,133,0,0,556,554,2,27581
0500000US38017,38,017,Cass County,174202,4505,169697,1504,5228,8804,45,130,3987,3932,55,149999
0500000US38025,38,025,Dunn County,4387,119,4268,395,38,68,9,0,70,70,0,3688
0500000US38029,38,029,Emmons County,3352,26,3326,3,34,0,0,5,73,73,0,3211
0500000US38051,38,051,McIntosh County,2654,41,2613,20,27,24,0,0,27,27,0,2515
0500000US38063,38,063,Nelson County,2920,75,2845,6,1,0,0,0,21,18,3,2817
0500000US38077,38,077,Richland County,16288,484,15804,299,43,119,0,2,425,391,34,14916
0500000US38079,38,079,Rolette County,14603,93,14510,11363,23,91,0,19,317,317,0,2697
0500000US38099,38,099,Walsh County,10802,1227,9575,183,79,47,0,15,115,115,0,9136
0500000US38001,38,001,Adams County,2351,41,2310,28,78,48,0,0,7,7,0,2149
0500000US38009,38,009,Bottineau County,6589,148,6441,232,15,60,0,11,82,82,0,6041
0500000US38003,38,003,Barnes County,10836,213,10623,139,54,261,9,7,100,92,8,10053
0500000US38027,38,027,Eddy County,2313,0,2313,176,0,0,0,0,99,99,0,2038
0500000US38035,38,035,Grand Forks County,70400,2887,67513,1665,1891,2792,110,318,1536,1536,0,59201
0500000US38053,38,053,McKenzie County,12536,969,11567,1390,83,67,0,0,273,271,2,9754
0500000US38057,38,057,Mercer County,8570,249,8321,244,39,76,0,0,15,15,0,7947
0500000US38055,38,055,McLean County,9608,229,9379,600,10,59,2,0,113,112,1,8595
0500000US38069,38,069,Pierce County,4210,37,4173,130,30,32,0,0,25,25,0,3956
0500000US38073,38,073,Ransom County,5361,97,5264,12,42,38,0,0,97,97,0,5075
0500000US38085,38,085,Sioux County,4413,187,4226,3581,0,6,2,5,77,77,0,555
0500000US38011,38,011,Bowman County,3195,173,3022,23,0,1,0,0,17,17,0,2981
0500000US38033,38,033,Golden Valley County,1882,60,1822,15,0,0,0,0,31,31,0,1776
0500000US38047,38,047,Logan County,1927,24,1903,5,2,1,0,2,15,15,0,1878
0500000US38095,38,095,Towner County,2246,56,2190,79,12,0,0,0,95,91,4,2004
0500000US38093,38,093,Stutsman County,21064,507,20557,276,114,258,13,7,413,413,0,19476
0500000US38023,38,023,Divide County,2369,57,2312,32,60,26,0,0,21,19,2,2173
0500000US38031,38,031,Foster County,3290,51,3239,34,1,7,0,0,56,56,0,3141
0500000US38081,38,081,Sargent County,3883,116,3767,25,7,92,0,0,47,44,3,3596
0500000US38087,38,087,Slope County,704,0,704,0,0,39,0,0,6,6,0,659
0500000US38089,38,089,Stark County,30876,1638,29238,356,428,668,7,20,641,634,7,27118
0500000US39053,39,053,Gallia County,30195,399,29796,116,211,714,33,16,490,490,0,28216
0500000US39077,39,077,Huron County,58457,3764,54693,67,122,709,3,100,946,946,0,52746
0500000US39009,39,009,Athens County,65936,1251,64685,168,1781,1830,64,72,1758,1744,14,59012
0500000US39001,39,001,Adams County,27878,278,27600,87,41,109,0,6,484,473,11,26873
0500000US39103,39,103,Medina County,177257,3554,173703,145,2165,2482,17,112,2169,2095,74,166613
0500000US39159,39,159,Union County,55654,915,54739,152,2013,1447,49,226,842,768,74,50010
0500000US39021,39,021,Champaign County,38864,596,38268,92,217,711,12,25,903,901,2,36308
0500000US39125,39,125,Paulding County,18872,881,17991,39,48,141,22,66,259,259,0,17416
0500000US39057,39,057,Greene County,165811,4622,161189,180,4929,11531,17,256,5080,5044,36,139196
0500000US39049,39,049,Franklin County,1275333,69044,1206289,1707,64721,279711,411,3102,45316,43849,1467,811321
0500000US39101,39,101,Marion County,65344,1699,63645,62,393,3607,21,6,1730,1719,11,57826
0500000US39115,39,115,Morgan County,14702,49,14653,9,29,681,0,6,369,364,5,13559
0500000US39169,39,169,Wayne County,116208,2302,113906,248,1106,1695,12,119,1830,1806,24,108896
0500000US39175,39,175,Wyandot County,22107,630,21477,0,266,42,0,8,148,148,0,21013
0500000US39017,39,017,Butler County,378294,17487,360807,498,11658,29774,318,500,9564,9331,233,308495
0500000US39067,39,067,Harrison County,15307,153,15154,12,74,343,0,22,166,166,0,14537
0500000US39083,39,083,Knox County,61215,895,60320,65,241,602,12,23,946,936,10,58431
0500000US39139,39,139,Richland County,121324,2240,119084,203,965,9424,16,190,4386,4279,107,103900
0500000US39163,39,163,Vinton County,13111,76,13035,18,20,61,0,0,268,262,6,12668
0500000US39063,39,063,Hancock County,75690,4004,71686,15,1459,1089,0,131,1392,1372,20,67600
0500000US39045,39,045,Fairfield County,152910,3242,149668,87,2260,10698,63,180,3882,3801,81,132498
0500000US39039,39,039,Defiance County,38279,3764,34515,144,110,619,15,30,474,467,7,33123
0500000US39069,39,069,Henry County,27316,2072,25244,41,99,210,0,14,279,271,8,24601
0500000US39081,39,081,Jefferson County,66886,932,65954,82,304,3621,0,59,1401,1376,25,60487
0500000US39137,39,137,Putnam County,33969,2066,31903,8,65,115,0,172,262,262,0,31281
0500000US39027,39,027,Clinton County,41896,655,41241,24,190,849,11,43,997,974,23,39127
0500000US39047,39,047,Fayette County,28645,605,28040,7,261,583,9,30,626,587,39,26524
0500000US39129,39,129,Pickaway County,57420,781,56639,140,272,1880,0,7,1051,1051,0,53289
0500000US39091,39,091,Logan County,45307,681,44626,70,389,729,3,39,1055,1031,24,42341
0500000US39153,39,153,Summit County,541810,11168,530642,1053,17890,77474,71,729,14374,14088,286,419051
0500000US39143,39,143,Sandusky County,59299,5822,53477,154,165,1679,9,81,1183,1180,3,50206
0500000US39149,39,149,Shelby County,48797,749,48048,151,460,1298,0,17,757,658,99,45365
0500000US27033,27,033,Cottonwood County,11372,844,10528,32,387,76,26,4,162,162,0,9841
0500000US27139,27,139,Scott County,143372,7275,136097,1047,8804,5711,8,196,3086,3002,84,117245
0500000US27039,27,039,Dodge County,20582,1031,19551,87,164,49,2,8,251,251,0,18990
0500000US27157,27,157,Wabasha County,21500,613,20887,19,91,117,0,7,279,279,0,20374
0500000US27117,27,117,Pipestone County,9185,604,8581,115,85,115,0,0,130,128,2,8136
0500000US27035,27,035,Crow Wing County,63855,923,62932,538,262,462,0,15,972,966,6,60683
0500000US27107,27,107,Norman County,6559,329,6230,166,41,29,0,0,118,118,0,5876
0500000US27171,27,171,Wright County,132745,3807,128938,422,1494,1850,15,39,2068,2034,34,123050
0500000US27103,27,103,Nicollet County,33783,1503,32280,10,580,1040,0,24,545,544,1,30081
0500000US27041,27,041,Douglas County,37203,594,36609,86,111,166,0,41,467,465,2,35738
0500000US27051,27,051,Grant County,5938,134,5804,24,1,10,0,2,109,109,0,5658
0500000US27069,27,069,Kittson County,4337,91,4246,16,15,37,0,6,25,23,2,4147
0500000US27079,27,079,Le Sueur County,27983,1643,26340,54,138,235,3,19,295,295,0,25596
0500000US27087,27,087,Mahnomen County,5506,229,5277,2147,21,28,15,0,546,546,0,2520
0500000US27025,27,025,Chisago County,54727,1146,53581,250,552,693,16,3,835,835,0,51232
0500000US27127,27,127,Redwood County,15331,510,14821,692,439,115,0,12,181,181,0,13382
0500000US27173,27,173,Yellow Medicine County,9868,448,9420,237,62,62,0,0,196,184,12,8863
0500000US27153,27,153,Todd County,24440,1399,23041,52,117,145,12,2,361,361,0,22352
0500000US27007,27,007,Beltrami County,46117,1064,45053,9123,373,496,27,22,1729,1724,5,33283
0500000US27013,27,013,Blue Earth County,66322,2305,64017,226,1497,2287,24,48,1347,1345,2,58588
0500000US27055,27,055,Houston County,18663,202,18461,42,131,184,3,4,145,134,11,17952
0500000US27073,27,073,Lac qui Parle County,6773,149,6624,14,56,57,0,2,44,44,0,6451
0500000US27077,27,077,Lake of the Woods County,3809,64,3745,11,32,1,0,0,157,157,0,3544
0500000US27111,27,111,Otter Tail County,57992,1945,56047,292,349,739,9,11,849,841,8,53798
0500000US27161,27,161,Waseca County,18809,1109,17700,164,105,382,0,0,254,254,0,16795
0500000US27137,27,137,St. Louis County,200080,3284,196796,3582,2096,2957,94,65,5451,5428,23,182551
0500000US27003,27,003,Anoka County,347431,15330,332101,2007,14928,20216,97,388,9471,9305,166,284994
0500000US27145,27,145,Stearns County,156819,5168,151651,418,3361,9048,0,191,2332,2324,8,136301
0500000US27081,27,081,Lincoln County,5707,109,5598,41,9,15,0,0,30,30,0,5503
0500000US27089,27,089,Marshall County,9392,415,8977,25,31,36,2,0,106,106,0,8777
0500000US27095,27,095,Mille Lacs County,25728,604,25124,1246,156,109,0,11,674,671,3,22928
0500000US27163,27,163,Washington County,253317,10248,243069,829,13939,10930,49,223,6251,5791,460,210848
0500000US27017,27,017,Carlton County,35540,625,34915,1900,173,629,0,3,873,868,5,31337
0500000US27065,27,065,Kanabec County,16004,248,15756,133,86,56,0,0,270,270,0,15211
0500000US27071,27,071,Koochiching County,12644,41,12603,456,51,61,0,0,240,235,5,11795
0500000US27097,27,097,Morrison County,32949,547,32402,64,154,176,0,56,387,380,7,31565
0500000US27131,27,131,Rice County,65765,5222,60543,232,1388,3507,39,50,832,828,4,54495
0500000US27147,27,147,Steele County,36676,2806,33870,104,419,1112,7,9,381,361,20,31838
0500000US27125,27,125,Red Lake County,4008,149,3859,49,0,10,0,3,102,94,8,3695
0500000US27001,27,001,Aitkin County,15834,214,15620,338,54,84,14,3,249,249,0,14878
0500000US27043,27,043,Faribault County,13896,928,12968,32,39,25,0,0,196,196,0,12676
0500000US27101,27,101,Murray County,8353,320,8033,14,102,49,0,0,68,68,0,7800
0500000US27067,27,067,Kandiyohi County,42658,5077,37581,86,358,2014,0,36,550,528,22,34537
0500000US27075,27,075,Lake County,10569,162,10407,61,3,78,43,7,128,128,0,10087
0500000US27133,27,133,Rock County,9413,282,9131,64,97,107,0,0,33,33,0,8830
0500000US27143,27,143,Sibley County,14912,1326,13586,39,100,127,0,4,106,98,8,13210
0500000US27155,27,155,Traverse County,3337,91,3246,149,10,22,0,0,66,66,0,2999
0500000US27005,27,005,Becker County,33773,674,33099,2450,206,184,8,11,1050,1048,2,29190
0500000US27053,27,053,Hennepin County,1235478,85264,1150214,7075,86933,158822,422,2701,39767,38471,1296,854494
0500000US27015,27,015,Brown County,25211,1076,24135,39,141,179,0,8,168,168,0,23600
0500000US27023,27,023,Chippewa County,12010,825,11185,195,111,77,137,18,99,99,0,10548
0500000US27029,27,029,Clearwater County,8812,181,8631,726,39,34,2,1,355,354,1,7474
0500000US27057,27,057,Hubbard County,20862,429,20433,437,124,126,0,0,341,341,0,19405
0500000US27059,27,059,Isanti County,38974,751,38223,114,506,170,6,64,720,710,10,36643
0500000US27091,27,091,Martin County,19964,851,19113,23,75,55,13,5,319,318,1,18623
0500000US27099,27,099,Mower County,39602,4471,35131,60,1230,1421,156,81,640,628,12,31543
0500000US27115,27,115,Pine County,29129,836,28293,714,167,584,19,2,755,752,3,26052
0500000US27109,27,109,Olmsted County,153065,7402,145663,279,8902,8837,70,414,3862,3672,190,123299
0500000US27159,27,159,Wadena County,13646,257,13389,93,57,145,0,5,202,201,1,12887
0500000US27009,27,009,Benton County,39779,903,38876,29,438,1322,0,3,1023,1007,16,36061
0500000US27047,27,047,Freeborn County,30526,2938,27588,59,643,375,16,0,318,306,12,26177
0500000US27085,27,085,McLeod County,35825,2163,33662,68,224,197,0,85,426,424,2,32662
0500000US27121,27,121,Pope County,10980,149,10831,23,58,41,0,1,143,143,0,10565
0500000US27149,27,149,Stevens County,9784,554,9230,118,215,109,19,0,140,140,0,8629
0500000US27151,27,151,Swift County,9411,453,8958,2,30,210,39,0,36,36,0,8641
0500000US28051,28,051,Holmes County,18075,46,18029,9,8,15131,0,40,14,7,7,2827
0500000US28005,28,005,Amite County,12468,0,12468,3,38,5239,0,0,32,32,0,7156
0500000US28013,28,013,Calhoun County,14571,858,13713,0,33,3962,24,4,261,245,16,9429
0500000US28141,28,141,Tishomingo County,19478,614,18864,33,10,551,0,0,114,113,1,18156
0500000US28153,28,153,Wayne County,20422,54,20368,58,14,8401,0,0,147,147,0,11748
0500000US48015,48,015,Austin County,29565,7819,21746,48,89,2576,0,52,456,456,0,18525
0500000US48261,48,261,Kenedy County,595,522,73,0,1,0,0,0,0,0,0,72
0500000US48355,48,355,Nueces County,360486,228462,132024,919,7134,13071,242,226,2780,2635,145,107652
0500000US48089,48,089,Colorado County,21022,6200,14822,27,7,2655,0,0,278,205,73,11855
0500000US48409,48,409,San Patricio County,67046,38483,28563,101,671,1003,30,7,719,684,35,26032
0500000US48379,48,379,Rains County,11473,1019,10454,69,8,322,0,0,241,224,17,9814
0500000US48381,48,381,Randall County,132475,27678,104797,410,2162,3726,64,72,2349,2295,54,96014
0500000US48385,48,385,Real County,3389,672,2717,0,2,5,0,0,1,1,0,2709
0500000US48411,48,411,San Saba County,5962,1790,4172,0,3,134,0,0,189,189,0,3846
0500000US48413,48,413,Schleicher County,3061,1603,1458,0,0,13,0,0,1,1,0,1444
0500000US48431,48,431,Sterling County,1141,516,625,0,0,3,0,0,16,16,0,606
0500000US48507,48,507,Zavala County,12131,11372,759,0,4,60,0,0,93,93,0,602
0500000US48057,48,057,Calhoun County,21807,10564,11243,3,998,528,17,0,383,383,0,9314
0500000US48065,48,065,Carson County,6032,600,5432,79,31,78,0,0,58,58,0,5186
0500000US48155,48,155,Foard County,1408,288,1120,0,0,25,0,0,0,0,0,1095
0500000US48161,48,161,Freestone County,19709,2984,16725,12,113,3103,0,0,272,203,69,13225
0500000US48175,48,175,Goliad County,7531,2699,4832,0,43,372,0,0,21,21,0,4396
0500000US48193,48,193,Hamilton County,8269,1019,7250,62,24,42,0,0,118,98,20,7004
0500000US48197,48,197,Hardeman County,3952,851,3101,41,0,271,0,0,96,96,0,2693
0500000US48335,48,335,Mitchell County,8558,3381,5177,53,30,847,0,0,88,88,0,4159
0500000US48045,48,045,Briscoe County,1546,545,1001,0,0,38,17,0,61,61,0,885
0500000US48285,48,285,Lavaca County,19941,3694,16247,9,71,1255,0,2,176,163,13,14734
0500000US48445,48,445,Terry County,12615,6859,5756,28,0,584,0,0,73,73,0,5071
0500000US48243,48,243,Jeff Davis County,2234,727,1507,0,51,18,0,0,16,16,0,1422
0500000US48247,48,247,Jim Hogg County,5282,4890,392,0,0,2,0,0,19,19,0,371
0500000US48339,48,339,Montgomery County,554445,131147,423298,805,15610,25296,299,684,9942,9417,525,370662
0500000US48111,48,111,Dallam County,7243,3260,3983,85,107,63,0,0,73,73,0,3655
0500000US48479,48,479,Webb County,272053,259797,12256,118,1295,780,33,132,385,351,34,9513
0500000US48011,48,011,Armstrong County,1916,131,1785,29,0,7,0,0,12,12,0,1737
0500000US48069,48,069,Castro County,7787,5003,2784,11,92,70,1,4,83,83,0,2523
0500000US48273,48,273,Kleberg County,31425,22849,8576,16,695,907,0,64,475,475,0,6419
0500000US48489,48,489,Willacy County,21754,19170,2584,2,0,129,0,0,41,41,0,2412
0500000US48107,48,107,Crosby County,5861,3261,2600,0,14,210,0,3,43,43,0,2330
0500000US48151,48,151,Fisher County,3883,1185,2698,0,23,114,5,0,64,64,0,2492
0500000US48131,48,131,Duval County,11355,10135,1220,0,0,191,0,1,0,0,0,1028
0500000US48031,48,031,Blanco County,11279,2173,9106,0,165,2,39,0,188,180,8,8712
0500000US48241,48,241,Jasper County,35504,2360,33144,62,157,5833,26,97,498,498,0,26471
0500000US48271,48,271,Kinney County,3675,2297,1378,0,0,3,0,0,0,0,0,1375
0500000US48117,48,117,Deaf Smith County,18899,13659,5240,48,103,144,16,18,130,130,0,4781
0500000US48167,48,167,Galveston County,327089,79406,247683,747,10621,40398,203,348,6700,6294,406,188666
0500000US48283,48,283,La Salle County,7409,6104,1305,0,12,94,0,0,74,74,0,1125
0500000US48393,48,393,Roberts County,885,123,762,0,8,0,0,0,28,28,0,726
0500000US48457,48,457,Tyler County,21496,1621,19875,12,60,2411,0,9,340,338,2,17043
0500000US48483,48,483,Wheeler County,5482,1448,4034,13,5,142,17,0,117,117,0,3740
0500000US48037,48,037,Bowie County,93858,7098,86760,822,997,22765,17,49,2093,2070,23,60017
0500000US48043,48,043,Brewster County,9216,4099,5117,168,111,21,0,16,79,79,0,4722
0500000US48263,48,263,Kent County,749,122,627,6,0,8,0,0,0,0,0,613
0500000US48423,48,423,Smith County,225015,43377,181638,725,3865,38735,299,315,2810,2746,64,134889
0500000US48105,48,105,Crockett County,3633,2306,1327,0,0,32,0,0,0,0,0,1295
0500000US48199,48,199,Hardin County,56379,3142,53237,110,326,3169,0,76,660,617,43,48896
0500000US48227,48,227,Howard County,36667,15394,21273,259,299,2027,10,21,642,560,82,18015
0500000US48289,48,289,Leon County,17098,2457,14641,85,136,1174,52,0,146,133,13,13048
0500000US48337,48,337,Montague County,19409,2111,17298,32,0,120,0,0,452,452,0,16694
0500000US48365,48,365,Panola County,23440,2013,21427,29,21,4023,0,0,170,166,4,17184
0500000US49027,49,027,Millard County,12733,1662,11071,146,118,0,13,20,203,203,0,10571
0500000US49053,49,053,Washington County,160537,16435,144102,1792,1219,1042,1331,243,2584,2535,49,135891
0500000US49025,49,025,Kane County,7350,342,7008,105,30,16,10,0,123,123,0,6724
0500000US49019,49,019,Grand County,9616,1000,8616,297,186,51,62,0,87,87,0,7933
0500000US49033,49,033,Rich County,2350,256,2094,0,0,0,0,61,0,0,0,2033
0500000US49051,49,051,Wasatch County,30523,4082,26441,34,338,45,5,1,492,478,14,25526
0500000US49003,49,003,Box Elder County,53001,4912,48089,539,397,260,34,44,661,640,21,46154
0500000US49021,49,021,Iron County,49691,4265,45426,1127,277,264,27,122,887,887,0,42722
0500000US49041,49,041,Sevier County,21118,1076,20042,379,12,141,16,0,99,90,9,19395
0500000US49057,49,057,Weber County,247731,45034,202697,1365,2687,2509,626,98,6285,6182,103,189127
0500000US49013,49,013,Duchesne County,20219,1661,18558,752,104,85,52,0,328,323,5,17237
0500000US49037,49,037,San Juan County,15281,863,14418,7224,62,26,40,28,376,369,7,6662
0500000US49035,49,035,Salt Lake County,1120805,203140,917665,6571,44627,19465,16466,2453,26369,25164,1205,801714
0500000US49047,49,047,Uintah County,36323,3066,33257,2686,128,179,31,0,559,559,0,29674
0500000US49009,49,009,Daggett County,612,20,592,8,0,1,0,0,6,6,0,577
0500000US49011,49,011,Davis County,340621,32175,308446,1050,6007,4324,2076,304,8022,7749,273,286663
0500000US49055,49,055,Wayne County,2694,159,2535,8,13,9,34,0,15,14,1,2456
0500000US49007,49,007,Carbon County,20356,2702,17654,137,84,127,13,3,364,364,0,16926
0500000US49015,49,015,Emery County,10248,642,9606,75,66,17,2,0,97,97,0,9349
0500000US49029,49,029,Morgan County,11391,315,11076,1,49,77,18,0,102,102,0,10829
0500000US49005,49,005,Cache County,122336,13033,109303,487,2479,934,474,562,2346,2297,49,102021
0500000US49017,49,017,Garfield County,5017,297,4720,164,5,3,22,0,58,58,0,4468
0500000US49023,49,023,Juab County,10948,514,10434,110,0,18,10,33,167,167,0,10096
0500000US50021,50,021,Rutland County,59273,845,58428,237,581,489,0,47,510,486,24,56564
0500000US50019,50,019,Orleans County,26911,387,26524,144,64,120,0,33,528,528,0,25635
0500000US50013,50,013,Grand Isle County,6965,133,6832,29,34,55,0,9,232,232,0,6473
0500000US50017,50,017,Orange County,28937,392,28545,111,71,188,16,47,476,472,4,27636
0500000US50007,50,007,Chittenden County,162052,3685,158367,341,6747,3990,45,275,3031,2948,83,143938
0500000US50015,50,015,Lamoille County,25268,444,24824,196,158,225,0,0,315,313,2,23930
0500000US50027,50,027,Windsor County,55427,868,54559,62,465,389,34,111,988,988,0,52510
0500000US50005,50,005,Caledonia County,30425,481,29944,69,175,283,0,21,519,506,13,28877
0500000US50025,50,025,Windham County,43150,982,42168,71,483,479,33,0,870,853,17,40232
0500000US50001,50,001,Addison County,36939,849,36090,102,711,432,0,53,551,551,0,34241
0500000US50023,50,023,Washington County,58477,1111,57366,169,453,462,27,39,1096,1090,6,55120
0500000US51185,51,185,Tazewell County,42080,409,41671,103,272,1357,44,0,371,368,3,39524
0500000US51610,51,610,Falls Church city,14067,1501,12566,0,1421,640,0,0,412,388,24,10093
0500000US51685,51,685,Manassas Park city,16423,6359,10064,17,1779,2121,0,195,276,276,0,5676
0500000US51735,51,735,Poquoson city,12039,311,11728,27,236,141,0,0,258,247,11,11066
0500000US51183,51,183,Sussex County,11486,333,11153,31,50,6432,4,12,232,229,3,4392
0500000US51820,51,820,Waynesboro city,21926,1674,20252,90,207,2873,41,0,381,371,10,16660
0500000US51770,51,770,Roanoke city,99621,6104,93517,171,3043,28128,28,278,3061,3034,27,58808
0500000US51775,51,775,Salem city,25519,827,24692,34,453,1674,20,61,675,603,72,21775
0500000US51710,51,710,Norfolk city,245592,19359,226233,811,8765,100369,100,785,8670,8532,138,106733
0500000US51037,51,037,Charlotte County,12095,243,11852,10,45,3506,0,0,102,101,1,8189
0500000US51059,51,059,Fairfax County,1143529,185551,957978,1327,215975,107306,668,3398,43343,41420,1923,585961
0500000US51081,51,081,Greensville County,11659,267,11392,11,7,6908,0,0,180,180,0,4286
0500000US51095,51,095,James City County,74153,4138,70015,79,1746,9521,15,216,2229,2229,0,56209
0500000US51167,51,167,Russell County,27408,190,27218,18,0,358,0,0,313,313,0,26529
0500000US51173,51,173,Smyth County,31059,628,30431,0,141,714,36,0,297,289,8,29243
0500000US51678,51,678,Lexington city,7110,362,6748,0,264,447,0,0,199,180,19,5838
0500000US51031,51,031,Campbell County,55170,1298,53872,76,456,7898,0,57,1243,1230,13,44142
0500000US51089,51,089,Henry County,51588,2740,48848,49,373,11246,0,0,940,896,44,36240
0500000US51099,51,099,King George County,25890,1282,24608,73,322,4212,0,26,906,809,97,19069
0500000US51103,51,103,Lancaster County,10804,47,10757,0,60,3320,0,0,58,58,0,7319
0500000US51105,51,105,Lee County,24134,455,23679,71,70,984,0,26,118,118,0,22410
0500000US51115,51,115,Mathews County,8796,79,8717,0,25,906,3,0,249,249,0,7534
0500000US51119,51,119,Middlesex County,10700,79,10621,51,17,1653,16,313,285,265,20,8286
0500000US51149,51,149,Prince George County,37894,2979,34915,234,650,11599,147,114,1268,1204,64,20903
0500000US51165,51,165,Rockingham County,79444,5383,74061,215,565,1654,47,57,752,741,11,70771
0500000US51169,51,169,Scott County,22009,293,21716,57,92,162,0,0,114,114,0,21291
0500000US51181,51,181,Surry County,6600,50,6550,2,10,2983,0,8,90,90,0,3457
0500000US51011,51,011,Appomattox County,15577,228,15349,12,24,3079,0,0,289,274,15,11945
0500000US51067,51,067,Franklin County,56233,1548,54685,124,210,4362,0,242,824,824,0,48923
0500000US51097,51,097,King and Queen County,7052,223,6829,22,0,1785,0,0,367,367,0,4655
0500000US51121,51,121,Montgomery County,97997,3110,94887,354,6512,4302,29,433,1341,1299,42,81916
0500000US51127,51,127,New Kent County,21103,665,20438,204,224,2391,0,0,883,883,0,16736
0500000US51049,51,049,Cumberland County,9786,27,9759,77,93,3136,0,0,260,260,0,6193
0500000US51075,51,075,Goochland County,22482,611,21871,27,292,3576,0,48,470,470,0,17458
0500000US51083,51,083,Halifax County,34779,703,34076,93,268,12036,0,0,903,903,0,20776
0500000US51113,51,113,Madison County,13139,352,12787,0,110,910,0,7,620,620,0,11140
0500000US51153,51,153,Prince William County,456749,105050,351699,1145,36721,91650,552,1423,20679,19825,854,199529
0500000US51175,51,175,Southampton County,17939,277,17662,69,38,5888,0,35,698,698,0,10934
0500000US51091,51,091,Highland County,2214,0,2214,3,0,0,0,0,8,8,0,2203
0500000US51025,51,025,Brunswick County,16665,364,16301,26,99,9072,0,16,308,298,10,6780
0500000US51033,51,033,Caroline County,30184,1381,28803,47,259,8292,0,110,932,917,15,19163
0500000US51073,51,073,Gloucester County,37161,1287,35874,81,298,3003,0,17,919,869,50,31556
0500000US51131,51,131,Northampton County,11957,1037,10920,4,105,4001,13,0,328,328,0,6469
0500000US51141,51,141,Patrick County,17859,527,17332,31,71,1024,0,55,125,125,0,16026
0500000US51145,51,145,Powhatan County,28574,608,27966,85,90,3078,35,0,339,328,11,24339
0500000US51163,51,163,Rockbridge County,22509,407,22102,75,150,726,0,0,312,300,12,20839
0500000US51171,51,171,Shenandoah County,43045,3019,40026,38,352,810,0,41,913,901,12,37872
0500000US51061,51,061,Fauquier County,69115,5498,63617,221,1001,5022,27,63,1712,1694,18,55571
0500000US51036,51,036,Charles City County,6995,129,6866,448,23,3255,0,21,194,184,10,2925
0500000US51047,51,047,Culpeper County,50450,5180,45270,154,704,6642,68,182,1873,1866,7,35647
0500000US51053,51,053,Dinwiddie County,28308,956,27352,0,210,9061,24,152,407,407,0,17498
0500000US51079,51,079,Greene County,19410,1141,18269,45,293,1085,0,95,682,677,5,16069
0500000US51085,51,085,Hanover County,104449,3058,101391,170,1627,9395,66,167,2086,2080,6,87880
0500000US51111,51,111,Lunenburg County,12278,549,11729,14,397,3775,0,0,200,200,0,7343
0500000US51137,51,137,Orange County,35612,1695,33917,114,342,4403,0,95,1019,1005,14,27944
0500000US51595,51,595,Emporia city,5381,296,5085,3,15,3749,0,1,107,107,0,1210
0500000US51197,51,197,Wythe County,28940,347,28593,52,105,928,0,0,336,336,0,27172
0500000US51550,51,550,Chesapeake city,237820,14120,223700,417,7636,69494,204,828,7539,7496,43,137582
0500000US51660,51,660,Harrisonburg city,53391,10324,43067,14,2087,3527,0,283,1604,1584,20,35552
0500000US51003,51,003,Albemarle County,106355,6168,100187,186,5612,10314,30,126,2084,2019,65,81835
0500000US51019,51,019,Bedford County,77908,1646,76262,25,1069,5285,17,58,1322,1217,105,68486
0500000US51023,51,023,Botetourt County,33222,547,32675,97,273,981,0,53,423,417,6,30848
0500000US51195,51,195,Wise County,39025,481,38544,44,165,2162,15,0,414,411,3,35744
0500000US51520,51,520,Bristol city,16843,102,16741,0,9,1191,0,242,597,597,0,14702
0500000US51740,51,740,Portsmouth city,95311,4106,91205,434,1248,49759,131,224,3232,3201,31,36177
0500000US51830,51,830,Williamsburg city,14788,1044,13744,66,964,2077,0,27,550,550,0,10060
0500000US51005,51,005,Alleghany County,15286,218,15068,0,11,823,7,47,188,177,11,13992
0500000US51035,51,035,Carroll County,29738,996,28742,81,31,124,0,0,332,316,16,28174
0500000US51191,51,191,Washington County,54406,817,53589,12,293,737,12,94,587,587,0,51854
0500000US51133,51,133,Northumberland County,12223,91,12132,28,30,3340,0,0,208,208,0,8526
0500000US51139,51,139,Page County,23749,464,23285,26,101,364,0,79,335,335,0,22380
0500000US51187,51,187,Warren County,39449,1716,37733,83,417,1454,0,38,1370,1312,58,34371
0500000US51510,51,510,Alexandria city,156505,26247,130258,92,9446,33385,40,305,5940,5780,160,81050
0500000US51630,51,630,Fredericksburg city,28469,3062,25407,53,659,5873,46,40,1722,1578,144,17014
0500000US51650,51,650,Hampton city,135583,7599,127984,601,3423,66901,169,671,3822,3728,94,52397
0500000US51013,51,013,Arlington County,231803,36180,195623,606,23874,20048,202,978,6761,6379,382,143154
0500000US51670,51,670,Hopewell city,22408,1705,20703,24,323,9250,0,28,396,378,18,10682
0500000US51027,51,027,Buchanan County,22138,96,22042,36,186,638,0,25,98,86,12,21059
0500000US51069,51,069,Frederick County,85153,7003,78150,220,1126,3407,67,77,1805,1793,12,71448
0500000US51179,51,179,Stafford County,144012,17782,126230,406,4691,24073,93,256,6559,6494,65,90152
0500000US51199,51,199,York County,67587,4173,63414,116,3715,8569,147,173,2454,2260,194,48240
0500000US51760,51,760,Richmond city,223787,14950,208837,260,4764,106373,22,536,6543,6356,187,90339
0500000US51125,51,125,Nelson County,14812,607,14205,47,54,1887,0,0,130,130,0,12087
0500000US51143,51,143,Pittsylvania County,61676,1591,60085,40,251,12329,13,5,1737,1703,34,45710
0500000US51720,51,720,Norton city,3990,43,3947,3,134,185,0,0,71,71,0,3554
0500000US51065,51,065,Fluvanna County,26282,880,25402,45,190,3528,30,40,938,938,0,20631
0500000US51007,51,007,Amelia County,12854,383,12471,31,0,2737,0,0,277,277,0,9426
0500000US51840,51,840,Winchester city,27789,4842,22947,64,468,2740,0,11,1222,1208,14,18442
0500000US51001,51,001,Accomack County,32742,2934,29808,176,74,9569,0,56,242,242,0,19691
0500000US51063,51,063,Floyd County,15666,464,15202,54,28,289,0,10,196,196,0,14625
0500000US51077,51,077,Grayson County,15811,514,15297,39,51,706,0,0,280,280,0,14221
0500000US51135,51,135,Nottoway County,15500,657,14843,15,46,6197,40,0,103,103,0,8442
0500000US54033,54,033,Harrison County,68209,1099,67110,7,409,1130,8,17,1223,1223,0,64316
0500000US54069,54,069,Ohio County,42547,469,42078,78,318,1708,0,84,652,636,16,39238
0500000US54013,54,013,Calhoun County,7396,152,7244,11,0,2,0,0,40,40,0,7191
0500000US54065,54,065,Morgan County,17624,268,17356,105,17,126,0,24,258,258,0,16826
0500000US54081,54,081,Raleigh County,76232,1227,75005,290,654,5784,10,276,1589,1572,17,66402
0500000US54007,54,007,Braxton County,14282,153,14129,0,0,42,26,0,209,209,0,13852
0500000US54001,54,001,Barbour County,16730,85,16645,59,96,207,0,18,274,274,0,15991
0500000US54047,54,047,McDowell County,19217,251,18966,24,0,1616,0,0,290,290,0,17036
0500000US54099,54,099,Wayne County,40708,265,40443,60,112,222,0,2,399,395,4,39648
0500000US54109,54,109,Wyoming County,21711,44,21667,3,37,210,0,0,301,301,0,21116
0500000US54035,54,035,Jackson County,29018,142,28876,246,93,23,0,18,335,335,0,28161
0500000US54055,54,055,Mercer County,60486,690,59796,146,381,3682,0,16,927,908,19,54644
0500000US54097,54,097,Upshur County,24605,322,24283,30,54,396,0,0,167,158,9,23636
0500000US54101,54,101,Webster County,8518,6,8512,0,0,3,4,0,13,13,0,8492
0500000US54003,54,003,Berkeley County,113495,4795,108700,58,1162,8207,0,546,3126,3115,11,95601
0500000US54019,54,019,Fayette County,44126,493,43633,104,30,2232,18,20,432,418,14,40797
0500000US54023,54,023,Grant County,11641,92,11549,0,0,191,0,0,100,100,0,11258
0500000US54027,54,027,Hampshire County,23363,328,23035,80,63,322,0,5,181,181,0,22384
0500000US54089,54,089,Summers County,13018,223,12795,27,0,553,0,0,262,262,0,11953
0500000US54009,54,009,Brooke County,22772,199,22573,1,74,377,40,28,254,254,0,21799
0500000US54017,54,017,Doddridge County,8536,63,8473,22,26,115,0,0,161,154,7,8149
0500000US54025,54,025,Greenbrier County,35347,666,34681,15,231,862,0,120,789,789,0,32664
0500000US54031,54,031,Hardy County,13842,218,13624,77,225,762,0,3,79,79,0,12478
0500000US54049,54,049,Marion County,56497,716,55781,199,360,2043,0,272,570,564,6,52337
0500000US54057,54,057,Mineral County,27278,243,27035,3,111,944,0,69,253,253,0,25655
0500000US54059,54,059,Mingo County,24741,0,24741,16,22,655,0,134,200,200,0,23714
0500000US54029,54,029,Hancock County,29680,449,29231,73,149,532,8,0,611,611,0,27858
0500000US54041,54,041,Lewis County,16276,193,16083,38,50,43,0,0,251,124,127,15701
0500000US54067,54,067,Nicholas County,25324,138,25186,98,77,162,0,0,278,278,0,24571
0500000US54075,54,075,Pocahontas County,8531,45,8486,0,0,37,0,17,50,50,0,8382
0500000US54095,54,095,Tyler County,8909,24,8885,15,48,30,0,0,76,76,0,8716
0500000US54083,54,083,Randolph County,29065,266,28799,110,165,568,0,3,74,74,0,27879
0500000US54091,54,091,Taylor County,16951,169,16782,0,151,163,0,58,171,171,0,16239
0500000US54105,54,105,Wirt County,5797,64,5733,0,0,83,0,7,13,13,0,5630
0500000US54015,54,015,Clay County,8785,7,8778,12,0,1,22,0,29,29,0,8714
0500000US54021,54,021,Gilmer County,8205,328,7877,21,84,900,0,9,218,211,7,6645
0500000US54061,54,061,Monongalia County,105252,2182,103070,137,3770,3795,0,361,2425,2344,81,92582
0500000US54063,54,063,Monroe County,13467,121,13346,73,0,122,0,0,210,176,34,12941
0500000US54103,54,103,Wetzel County,15614,54,15560,0,65,158,0,47,138,138,0,15152
0500000US54011,54,011,Cabell County,95318,1327,93991,171,1275,4803,53,219,1791,1745,46,85679
0500000US54039,54,039,Kanawha County,185710,2025,183685,317,2050,13336,0,112,4867,4795,72,163003
0500000US54071,54,071,Pendleton County,7056,64,6992,0,8,239,0,27,37,37,0,6681
0500000US54077,54,077,Preston County,33837,842,32995,210,88,1563,6,10,359,273,86,30759
0500000US53035,53,035,Kitsap County,262475,19782,242693,2251,12456,6423,2087,191,17077,16892,185,202208
0500000US53033,53,033,King County,2163257,206735,1956522,11219,368796,132775,16357,4880,114984,112092,2892,1307511
0500000US53051,53,051,Pend Oreille County,13219,483,12736,494,136,30,30,14,324,307,17,11708
0500000US53055,53,055,San Juan County,16473,1024,15449,124,231,112,32,31,313,311,2,14606
0500000US53075,53,075,Whitman County,48593,3005,45588,171,4093,1041,91,78,1761,1734,27,38353
0500000US53077,53,077,Yakima County,249325,121944,127381,8962,2174,1935,173,107,5092,5027,65,108938
0500000US53015,53,015,Cowlitz County,105112,9248,95864,1049,1293,745,306,194,4146,4077,69,88131
0500000US53019,53,019,Ferry County,7576,347,7229,950,73,11,15,0,617,617,0,5563
0500000US53041,53,041,Lewis County,76947,7692,69255,464,877,376,126,46,2874,2858,16,64492
0500000US53027,53,027,Grays Harbor County,71967,7092,64875,2825,1124,700,205,41,2671,2622,49,57309
0500000US53029,53,029,Island County,81636,6112,75524,763,3763,2506,298,247,3052,2966,86,64895
0500000US53069,53,069,Wahkiakum County,4189,264,3925,51,65,54,1,44,59,33,26,3651
0500000US53021,53,021,Franklin County,90660,47907,42753,265,1973,1673,125,125,1695,1661,34,36897
0500000US53025,53,025,Grant County,94860,39171,55689,829,888,639,32,34,1790,1751,39,51477
0500000US53073,53,073,Whatcom County,216812,19977,196835,5874,8933,2065,585,248,7128,7039,89,172002
0500000US53047,53,047,Okanogan County,41638,8211,33427,3943,357,193,46,44,1619,1617,2,27225
0500000US53037,53,037,Kittitas County,44825,3922,40903,293,750,403,360,34,1348,1348,0,37715
0500000US53005,53,005,Benton County,194168,41336,152832,1072,4867,2955,140,493,5552,5518,34,137753
0500000US53013,53,013,Columbia County,4001,306,3695,1,98,30,38,2,87,87,0,3439
0500000US53003,53,003,Asotin County,22337,853,21484,155,196,98,35,0,698,655,43,20302
0500000US53023,53,023,Garfield County,2224,47,2177,9,71,0,0,0,104,104,0,1993
0500000US53045,53,045,Mason County,62627,6061,56566,1326,882,651,280,20,2766,2751,15,50641
0500000US53065,53,065,Stevens County,44214,1604,42610,2050,287,193,20,16,1707,1699,8,38337
0500000US53063,53,063,Spokane County,497875,27693,470182,5926,10889,7709,2448,306,20249,19957,292,422655
0500000US53007,53,007,Chelan County,75757,21074,54683,486,792,292,58,0,1463,1423,40,51592
0500000US55105,55,105,Rock County,161769,13782,147987,368,1955,6989,9,72,4213,4202,11,134381
0500000US55137,55,137,Waushara County,24116,1524,22592,96,86,430,9,26,349,344,5,21596
0500000US55001,55,001,Adams County,20073,781,19292,130,115,568,0,13,266,249,17,18200
0500000US55007,55,007,Bayfield County,14992,279,14713,1461,76,118,0,9,337,333,4,12712
0500000US55065,55,065,Lafayette County,16735,625,16110,70,65,107,0,3,78,72,6,15787
0500000US55081,55,081,Monroe County,45502,1983,43519,446,407,722,8,27,557,554,3,41352
0500000US55093,55,093,Pierce County,41603,826,40777,72,500,177,0,34,724,723,1,39270
0500000US55141,55,141,Wood County,73274,2122,71152,366,1517,444,14,88,977,975,2,67746
0500000US55003,55,003,Ashland County,15712,438,15274,1741,68,110,11,0,386,386,0,12958
0500000US55015,55,015,Calumet County,49807,2069,47738,281,1146,415,2,71,452,452,0,45371
0500000US55037,55,037,Florence County,4337,61,4276,9,0,13,0,0,31,31,0,4223
0500000US55055,55,055,Jefferson County,84652,5924,78728,93,567,669,0,7,1405,1350,55,75987
0500000US55059,55,059,Kenosha County,168330,21745,146585,514,2416,11908,34,222,3472,3342,130,128019
0500000US55051,55,051,Iron County,5715,73,5642,54,18,47,0,0,58,55,3,5465
0500000US55019,55,019,Clark County,34491,1530,32961,77,147,95,0,0,448,448,0,32194
0500000US55109,55,109,St. Croix County,87917,2023,85894,176,941,664,0,54,1355,1351,4,82704
0500000US55083,55,083,Oconto County,37556,650,36906,333,143,146,0,0,553,536,17,35731
0500000US55069,55,069,Lincoln County,27848,421,27427,92,91,169,0,3,455,453,2,26617
0500000US55135,55,135,Waupaca County,51444,1572,49872,238,173,216,5,43,626,616,10,48571
0500000US55005,55,005,Barron County,45252,1111,44141,338,323,627,0,7,491,489,2,42355
0500000US55113,55,113,Sawyer County,16370,427,15943,2755,91,89,5,6,438,438,0,12559
0500000US55047,55,047,Green Lake County,18757,898,17859,55,54,177,0,11,202,201,1,17360
0500000US55077,55,077,Marquette County,15207,495,14712,63,55,94,0,33,256,247,9,14211
0500000US55075,55,075,Marinette County,40537,669,39868,185,183,284,11,7,525,521,4,38673
0500000US55101,55,101,Racine County,195398,25142,170256,740,2449,21257,78,121,4198,4064,134,141413
0500000US55139,55,139,Winnebago County,169926,6789,163137,961,4582,3763,20,90,2562,2495,67,151159
0500000US55041,55,041,Forest County,9018,208,8810,1311,44,68,7,3,217,217,0,7160
0500000US55043,55,043,Grant County,51828,831,50997,65,494,703,12,12,398,396,2,49313
0500000US55107,55,107,Rusk County,14183,259,13924,54,14,138,22,1,244,242,2,13451
0500000US55117,55,117,Sheboygan County,115205,7168,108037,228,6429,2071,7,55,1758,1742,16,97489
0500000US55067,55,067,Langlade County,19164,368,18796,119,43,153,3,35,420,420,0,18023
0500000US55087,55,087,Outagamie County,184754,7789,176965,2818,6445,2431,31,177,2934,2810,124,162129
0500000US55123,55,123,Vernon County,30516,476,30040,58,157,79,10,7,344,339,5,29385
0500000US55021,55,021,Columbia County,56954,1837,55117,194,430,701,16,7,881,881,0,52888
0500000US55061,55,061,Kewaunee County,20360,572,19788,61,62,81,0,6,289,289,0,19289
0500000US55009,55,009,Brown County,259786,21835,237951,5895,8292,5859,26,301,6484,6324,160,211094
0500000US55073,55,073,Marathon County,135264,3636,131628,298,7808,856,38,72,2274,2255,19,120282
0500000US55085,55,085,Oneida County,35345,517,34828,463,157,215,10,62,335,315,20,33586
0500000US55121,55,121,Trempealeau County,29438,2340,27098,100,132,135,0,0,234,234,0,26497
0500000US55129,55,129,Washburn County,15689,279,15410,171,86,60,42,5,240,240,0,14806
0500000US55027,55,027,Dodge County,87776,4106,83670,237,531,2376,19,38,1404,1388,16,79065
0500000US55127,55,127,Walworth County,103013,11372,91641,167,1024,953,38,10,1364,1326,38,88085
0500000US55023,55,023,Crawford County,16288,230,16058,57,69,305,0,0,218,218,0,15409
0500000US55071,55,071,Manitowoc County,79407,3044,76363,382,2182,704,0,21,904,902,2,72170
0500000US55111,55,111,Sauk County,63596,3128,60468,655,416,503,0,28,866,853,13,58000
0500000US55013,55,013,Burnett County,15258,270,14988,610,59,81,0,4,426,422,4,13808
0500000US55017,55,017,Chippewa County,63635,1094,62541,102,837,777,0,2,1195,1195,0,59628
0500000US55029,55,029,Door County,27439,819,26620,199,137,143,0,34,295,295,0,25812
0500000US55031,55,031,Douglas County,43402,671,42731,657,465,556,3,12,1219,1204,15,39819
0500000US55053,55,053,Jackson County,20506,671,19835,1123,96,435,0,16,473,473,0,17692
0500000US55049,55,049,Iowa County,23620,411,23209,51,166,191,19,40,208,194,14,22534
0500000US55089,55,089,Ozaukee County,88284,2526,85758,195,1961,1191,67,22,1366,1312,54,80956
0500000US55103,55,103,Richland County,17539,393,17146,53,102,87,4,63,217,216,1,16620
0500000US56005,56,005,Campbell County,47708,4074,43634,342,164,127,0,10,1235,1235,0,41756
0500000US56019,56,019,Johnson County,8515,188,8327,381,0,45,0,0,101,85,16,7800
0500000US56025,56,025,Natrona County,80610,6723,73887,783,513,1008,43,33,1471,1439,32,70036
0500000US56009,56,009,Converse County,13997,1118,12879,8,24,1,0,0,420,420,0,12426
0500000US56027,56,027,Niobrara County,2448,113,2335,84,33,13,0,0,16,13,3,2189
0500000US56039,56,039,Teton County,23059,3433,19626,77,282,245,35,12,162,162,0,18813
0500000US56037,56,037,Sweetwater County,44117,7042,37075,472,279,336,194,11,676,676,0,35107
0500000US56031,56,031,Platte County,8673,698,7975,7,59,1,0,0,215,215,0,7693
0500000US56033,56,033,Sheridan County,30012,1252,28760,340,211,114,0,0,552,552,0,27543
0500000US56003,56,003,Big Horn County,11901,1065,10836,137,44,53,18,21,103,79,24,10460
0500000US56011,56,011,Crook County,7410,87,7323,137,25,12,0,0,152,152,0,6997
0500000US56029,56,029,Park County,29121,1582,27539,165,167,45,3,47,611,609,2,26501
0500000US56001,56,001,Albany County,38102,3600,34502,310,1130,397,10,36,1036,1036,0,31583
0500000US56007,56,007,Carbon County,15477,2780,12697,226,135,165,9,0,151,151,0,12011
0500000US56015,56,015,Goshen County,13438,1427,12011,133,72,10,0,0,241,234,7,11555
0500000US56041,56,041,Uinta County,20609,1884,18725,150,22,20,0,0,491,491,0,18042
0500000US56043,56,043,Washakie County,8129,1153,6976,29,0,1,0,13,267,246,21,6666
0500000US56017,56,017,Hot Springs County,4680,147,4533,113,0,0,0,0,32,32,0,4388
0500000US56013,56,013,Fremont County,40076,2753,37323,8010,39,235,8,0,1017,1017,0,28014
0500000US56035,56,035,Sublette County,9951,731,9220,43,12,0,0,0,282,282,0,8883
0500000US56045,56,045,Weston County,7100,107,6993,37,310,36,0,0,144,144,0,6466
0500000US01099,01,099,Monroe County,21512,302,21210,346,120,8774,0,0,281,281,0,11689
0500000US01079,01,079,Lawrence County,33171,707,32464,1878,44,3615,24,0,1513,1474,39,25390
0500000US01081,01,081,Lee County,159287,5865,153422,226,6475,36389,0,295,2642,2571,71,107395
0500000US01107,01,107,Pickens County,20298,932,19366,25,13,8148,8,8,239,239,0,10925
0500000US01119,01,119,Sumter County,12985,13,12972,8,338,9345,0,51,29,29,0,3201
0500000US01023,01,023,Choctaw County,13075,73,13002,9,13,5570,0,5,35,35,0,7370
0500000US01091,01,091,Marengo County,19538,115,19423,51,0,10518,0,7,56,56,0,8791
0500000US01113,01,113,Russell County,58213,3120,55093,160,451,24787,72,240,2029,2018,11,27354
0500000US01039,01,039,Covington County,37351,604,36747,58,144,4790,13,0,596,596,0,31146
0500000US01041,01,041,Crenshaw County,13865,275,13590,106,188,3147,0,0,280,280,0,9869
0500000US01077,01,077,Lauderdale County,92585,2412,90173,417,612,9183,61,109,1290,1280,10,78501
0500000US01085,01,085,Lowndes County,10236,70,10166,13,0,7586,0,0,62,62,0,2505
0500000US01083,01,083,Limestone County,93052,5479,87573,821,1163,12405,0,1,1629,1621,8,71554
0500000US01115,01,115,St. Clair County,87306,2089,85217,285,700,8212,8,0,903,887,16,75109
0500000US01133,01,133,Winston County,23875,734,23141,93,31,90,9,0,490,486,4,22428
0500000US01043,01,043,Cullman County,82313,3543,78770,348,334,954,0,9,1299,1228,71,75826
0500000US01051,01,051,Elmore County,81212,2347,78865,186,392,17148,0,197,1471,1450,21,59471
0500000US01071,01,071,Jackson County,52094,1505,50589,545,215,1799,77,50,1366,1361,5,46537
0500000US01121,01,121,Talladega County,80565,1818,78747,301,450,25992,28,70,1251,1225,26,50655
0500000US01129,01,129,Washington County,16643,182,16461,1218,62,4086,0,0,260,260,0,10835
0500000US01031,01,031,Coffee County,51288,3549,47739,581,666,8746,0,41,1482,1482,0,36223
0500000US01103,01,103,Morgan County,119122,9691,109431,713,775,15141,48,89,2168,2142,26,90497
0500000US01021,01,021,Chilton County,43930,3416,40514,39,190,4112,0,80,888,876,12,35205
0500000US01033,01,033,Colbert County,54495,1349,53146,367,244,8561,29,18,1062,1051,11,42865
0500000US01045,01,045,Dale County,49255,3070,46185,300,533,9611,4,244,1488,1456,32,34005
0500000US01055,01,055,Etowah County,102939,3880,99059,424,739,15816,66,80,1560,1560,0,80374
0500000US01049,01,049,DeKalb County,71200,10220,60980,910,140,979,99,11,1400,1392,8,57441
0500000US01075,01,075,Lamar County,13933,218,13715,0,0,1558,0,107,69,69,0,11981
0500000US01111,01,111,Randolph County,22574,665,21909,51,68,4413,51,13,322,315,7,16991
0500000US01097,01,097,Mobile County,414659,11973,402686,2872,8117,146600,62,1315,6733,6545,188,236987
0500000US01127,01,127,Walker County,64493,1545,62948,55,309,3954,0,80,1075,1075,0,57475
0500000US01029,01,029,Cleburne County,14938,362,14576,39,3,393,0,11,291,291,0,13839
0500000US01063,01,063,Greene County,8426,143,8283,48,0,6707,0,0,83,61,22,1445
0500000US01005,01,005,Barbour County,25782,1106,24676,63,85,12199,1,86,344,331,13,11898
0500000US01011,01,011,Bullock County,10352,51,10301,122,56,7893,0,2,0,0,0,2228
0500000US01015,01,015,Calhoun County,115098,4203,110895,227,1065,23618,9,38,2515,2455,60,83423
0500000US01025,01,025,Clarke County,24387,48,24339,25,123,11173,0,0,123,123,0,12895
0500000US01101,01,101,Montgomery County,226941,7749,219192,283,6059,130513,39,189,3716,3422,294,78393
0500000US01095,01,095,Marshall County,95145,12961,82184,334,570,2456,46,90,1391,1331,60,77297
0500000US01067,01,067,Henry County,17124,448,16676,4,0,4727,0,0,140,140,0,11805
0500000US01089,01,089,Madison County,357560,17294,340266,1847,8992,85293,307,1066,10646,10536,110,232115
0500000US01123,01,123,Tallapoosa County,40636,954,39682,130,155,11012,0,0,385,383,2,28000
0500000US01131,01,131,Wilcox County,10809,70,10739,11,0,7511,0,0,316,316,0,2901
0500000US02068,02,068,Denali Borough,2232,9,2223,44,101,18,0,5,245,245,0,1810
0500000US02122,02,122,Kenai Peninsula Borough,58220,2375,55845,4376,886,317,194,103,3015,3015,0,46954
0500000US02016,02,016,Aleutians West Census Area,5750,798,4952,634,2270,246,147,4,262,255,7,1389
0500000US02060,02,060,Bristol Bay Borough,890,32,858,291,3,4,2,0,78,78,0,480
0500000US02150,02,150,Kodiak Island Borough,13649,1219,12430,1767,3141,27,57,44,641,621,20,6753
0500000US02188,02,188,Northwest Arctic Borough,7734,89,7645,6379,76,77,0,0,271,270,1,842
0500000US02050,02,050,Bethel Census Area,18040,429,17611,14838,187,119,3,0,670,670,0,1794
0500000US02185,02,185,North Slope Borough,9797,207,9590,5068,540,75,169,0,695,690,5,3043
0500000US02220,02,220,Sitka City and Borough,8738,566,8172,1045,619,88,8,3,1000,963,37,5409
0500000US02090,02,090,Fairbanks North Star Borough,99653,7951,91702,6693,2924,4250,525,88,7034,6972,62,70188
0500000US02130,02,130,Ketchikan Gateway Borough,13804,701,13103,1934,1025,103,5,60,1138,1131,7,8838
0500000US02170,02,170,Matanuska-Susitna Borough,103464,4944,98520,5751,1433,1022,195,207,7692,7519,173,82220
0500000US02180,02,180,Nome Census Area,9925,253,9672,7322,155,83,43,0,605,604,1,1464
0500000US02070,02,070,Dillingham Census Area,4975,173,4802,3534,76,67,3,0,333,333,0,789
0500000US02100,02,100,Haines Borough,2518,97,2421,212,74,1,4,0,171,171,0,1959
0500000US02282,02,282,Yakutat City and Borough,689,50,639,189,57,2,16,0,83,83,0,292
0500000US02110,02,110,Juneau City and Borough,32330,2123,30207,3414,2129,321,320,102,2898,2887,11,21023
0500000US02164,02,164,Lake and Peninsula Borough,1375,19,1356,916,34,9,5,2,85,85,0,305
0500000US02240,02,240,Southeast Fairbanks Census Area,6876,381,6495,907,156,24,0,0,302,294,8,5106
0500000US02290,02,290,Yukon-Koyukuk Census Area,5415,131,5284,3782,33,7,0,0,302,302,0,1160
0500000US02020,02,020,Anchorage Municipality,296112,26847,269265,20443,27938,15671,6694,800,24510,24232,278,173209
0500000US02013,02,013,Aleutians East Borough,3425,346,3079,1322,878,117,25,0,222,222,0,515
0500000US02230,02,230,Skagway Municipality,1061,55,1006,45,19,7,0,3,45,38,7,887
0500000US02198,02,198,Prince of Wales-Hyder Census Area,6474,244,6230,2533,76,24,41,9,611,602,9,2936
0500000US02195,02,195,Petersburg Borough,3255,337,2918,221,299,23,17,1,307,305,2,2050
0500000US02158,02,158,Kusilvak Census Area,8198,81,8117,7457,32,23,2,3,302,302,0,298
0500000US04013,04,013,Maricopa County,4253913,1311091,2942822,67454,172890,220519,8337,6437,98309,94940,3369,2368876
0500000US04009,04,009,Graham County,37879,12453,25426,4745,246,683,51,0,415,415,0,19286
0500000US04023,04,023,Santa Cruz County,46584,38899,7685,99,392,100,0,18,148,148,0,6928
0500000US04012,04,012,La Paz County,20701,5614,15087,2346,158,168,8,0,434,434,0,11973
0500000US04015,04,015,Mohave County,206064,33481,172583,4344,2427,2030,446,159,3270,3221,49,159907
0500000US04005,04,005,Coconino County,140217,19666,120551,36365,2767,1704,176,267,3452,3312,140,75820
0500000US04027,04,027,Yuma County,207829,131670,76159,1887,2419,3569,99,61,2969,2904,65,65155
0500000US04011,04,011,Greenlee County,9504,4414,5090,369,29,203,0,0,15,15,0,4474
0500000US04021,04,021,Pinal County,419721,125373,294348,17488,7075,17529,1320,494,10573,10290,283,239869
0500000US05123,05,123,St. Francis County,26294,708,25586,108,152,14575,0,36,163,131,32,10552
0500000US05145,05,145,White County,78804,3382,75422,265,552,3140,21,33,1897,1897,0,69514
0500000US05099,05,099,Nevada County,8440,24,8416,6,26,2927,1,0,132,132,0,5324
0500000US05037,05,037,Cross County,16998,330,16668,24,10,3308,0,8,934,934,0,12384
0500000US05043,05,043,Drew County,18502,609,17893,16,43,5321,0,0,177,177,0,12336
0500000US05027,05,027,Columbia County,23892,650,23242,82,267,8291,0,249,202,202,0,14151
0500000US05125,05,125,Saline County,118009,5451,112558,359,1385,8277,49,115,1851,1851,0,100522
0500000US05141,05,141,Van Buren County,16684,508,16176,115,14,65,0,0,369,361,8,15613
0500000US05065,05,065,Izard County,13559,302,13257,139,18,254,0,0,207,202,5,12639
0500000US05079,05,079,Lincoln County,13695,516,13179,38,0,4268,0,0,64,62,2,8809
0500000US05083,05,083,Logan County,21757,642,21115,228,503,293,0,9,361,361,0,19721
0500000US05035,05,035,Crittenden County,49013,1210,47803,154,352,23706,76,24,2586,2586,0,20905
0500000US05047,05,047,Franklin County,17780,545,17235,183,105,169,31,0,373,373,0,16374
0500000US05109,05,109,Pike County,10808,703,10105,75,45,355,0,0,172,172,0,9458
0500000US05069,05,069,Jefferson County,70424,1432,68992,213,661,39852,0,87,548,548,0,27631
0500000US05097,05,097,Montgomery County,8993,383,8610,101,105,20,0,56,202,198,4,8126
0500000US05127,05,127,Scott County,10442,792,9650,248,94,28,0,15,459,454,5,8806
0500000US05131,05,131,Sebastian County,127461,17860,109601,1456,5590,8789,18,91,4479,4302,177,89178
0500000US05007,05,007,Benton County,258980,42577,216403,3374,9803,4236,1440,470,6227,6115,112,190853
0500000US05017,05,017,Chicot County,10826,580,10246,24,43,5856,0,0,101,85,16,4222
0500000US05071,05,071,Johnson County,26291,3627,22664,45,490,397,19,68,666,664,2,20979
0500000US05077,05,077,Lee County,9398,167,9231,20,13,5294,0,0,59,59,0,3845
0500000US05041,05,041,Desha County,11887,698,11189,23,39,5596,0,2,119,119,0,5410
0500000US05049,05,049,Fulton County,12139,183,11956,55,6,71,5,0,255,255,0,11564
0500000US05051,05,051,Garland County,98296,5434,92862,761,523,7989,6,364,2330,2273,57,80889
0500000US05115,05,115,Pope County,63644,5563,58081,335,654,1862,0,19,1516,1500,16,53695
0500000US05117,05,117,Prairie County,8244,61,8183,29,29,1073,0,0,54,45,9,6998
0500000US39161,39,161,Van Wert County,28281,913,27368,2,95,344,0,17,291,288,3,26619
0500000US39167,39,167,Washington County,60671,654,60017,292,391,744,10,51,808,803,5,57721
0500000US39171,39,171,Williams County,36936,1598,35338,99,209,371,6,0,357,357,0,34296
0500000US39011,39,011,Auglaize County,45784,772,45012,89,141,228,36,99,566,560,6,43853
0500000US39029,39,029,Columbiana County,104003,1793,102210,110,123,2239,3,54,1895,1828,67,97786
0500000US39037,39,037,Darke County,51734,792,50942,113,236,344,0,0,480,478,2,49769
0500000US39123,39,123,Ottawa County,40709,2046,38663,78,75,467,3,59,402,402,0,37579
0500000US39051,39,051,Fulton County,42305,3647,38658,142,170,162,14,16,427,427,0,37727
0500000US39065,39,065,Hardin County,31542,517,31025,3,242,207,0,9,554,516,38,30010
0500000US39079,39,079,Jackson County,32524,341,32183,13,38,192,29,0,673,654,19,31238
0500000US39095,39,095,Lucas County,432379,30210,402169,895,7355,80556,117,1108,14195,13913,282,297943
0500000US39117,39,117,Morrow County,34976,504,34472,41,22,363,0,15,443,440,3,33588
0500000US39121,39,121,Noble County,14443,103,14340,5,13,816,0,0,173,173,0,13333
0500000US39135,39,135,Preble County,41207,339,40868,107,189,228,0,3,570,570,0,39771
0500000US39147,39,147,Seneca County,55475,2794,52681,167,317,1407,0,13,858,858,0,49919
0500000US39151,39,151,Stark County,373475,7493,365982,471,3181,27264,66,851,10952,10699,253,323197
0500000US39003,39,003,Allen County,103642,3077,100565,220,753,12206,0,177,3248,3213,35,83961
0500000US39031,39,031,Coshocton County,36574,367,36207,86,110,403,0,27,476,476,0,35105
0500000US39033,39,033,Crawford County,42021,682,41339,27,232,369,14,14,590,587,3,40093
0500000US39041,39,041,Delaware County,197008,4982,192026,181,11579,6435,55,190,4680,4528,152,168906
0500000US39059,39,059,Guernsey County,39274,465,38809,79,148,463,0,201,875,875,0,37043
0500000US39073,39,073,Hocking County,28495,296,28199,20,86,231,0,25,357,357,0,27480
0500000US39107,39,107,Mercer County,40806,781,40025,0,179,252,179,34,393,393,0,38988
0500000US39141,39,141,Ross County,77051,947,76104,15,418,4036,5,221,2354,2346,8,69055
0500000US39035,39,035,Cuyahoga County,1253783,72492,1181291,1785,36534,367181,247,2834,30230,29074,1156,742480
0500000US39093,39,093,Lorain County,306713,29923,276790,695,3348,23924,66,238,7779,7520,259,240740
0500000US39109,39,109,Miami County,104800,1697,103103,122,1404,2152,19,28,2428,2394,34,96950
0500000US39113,39,113,Montgomery County,532034,15138,516896,1102,11184,108566,157,1365,16494,16151,343,378028
0500000US39155,39,155,Trumbull County,201794,3539,198255,272,987,16448,9,155,4313,4142,171,176071
0500000US39173,39,173,Wood County,129936,7113,122823,156,2158,3395,16,28,2143,2112,31,114927
0500000US39007,39,007,Ashtabula County,98136,3997,94139,158,486,3462,53,89,1911,1911,0,87980
0500000US40001,40,001,Adair County,22113,1461,20652,9404,145,69,39,4,2070,2068,2,8921
0500000US40137,40,137,Stephens County,43983,3320,40663,2164,273,748,22,23,2056,2036,20,35377
0500000US40025,40,025,Cimarron County,2189,473,1716,10,4,5,0,0,3,3,0,1694
0500000US40019,40,019,Carter County,48406,3422,44984,3573,550,3108,6,20,3682,3665,17,34045
0500000US40053,40,053,Grant County,4418,215,4203,31,5,50,3,2,205,205,0,3907
0500000US40055,40,055,Greer County,5943,669,5274,145,0,495,0,0,177,170,7,4457
0500000US40087,40,087,McClain County,38634,3048,35586,2040,119,373,23,11,2326,2326,0,30694
0500000US40091,40,091,McIntosh County,19819,534,19285,3126,13,535,0,0,2125,2125,0,13486
0500000US40099,40,099,Murray County,13875,894,12981,1199,81,220,0,0,1416,1416,0,10065
0500000US40103,40,103,Noble County,11411,416,10995,774,12,20,5,12,874,871,3,9298
0500000US40115,40,115,Ottawa County,31566,1761,29805,5174,219,308,232,4,3263,3262,1,20605
0500000US40135,40,135,Sequoyah County,41359,1680,39679,8220,296,730,21,0,4335,4321,14,26077
0500000US40145,40,145,Wagoner County,77850,4643,73207,6488,1147,2673,63,103,6816,6788,28,55917
0500000US40151,40,151,Woods County,9127,648,8479,123,87,210,0,2,464,402,62,7593
0500000US40015,40,015,Caddo County,29342,3662,25680,6364,113,652,42,23,1703,1698,5,16783
0500000US40101,40,101,Muskogee County,69084,4164,64920,12388,495,7369,19,103,5746,5676,70,38800
0500000US40107,40,107,Okfuskee County,12115,472,11643,1611,11,919,0,13,1647,1645,2,7442
0500000US40013,40,013,Bryan County,45759,2663,43096,6752,246,856,46,23,2468,2453,15,32705
0500000US40059,40,059,Harper County,3847,896,2951,13,0,4,0,0,27,27,0,2907
0500000US40071,40,071,Kay County,44880,3519,41361,3532,216,979,0,4,2964,2948,16,33666
0500000US40035,40,035,Craig County,14493,516,13977,3114,130,439,15,0,1029,1015,14,9250
0500000US40143,40,143,Tulsa County,642781,80012,562769,29072,20209,63780,536,1521,46081,45655,426,401570
0500000US40017,40,017,Canadian County,136710,11788,124922,5183,4042,3677,4,380,6806,6594,212,104830
0500000US40057,40,057,Harmon County,2721,778,1943,11,20,238,0,0,98,98,0,1576
0500000US40077,40,077,Latimer County,10495,376,10119,2098,76,101,0,4,961,961,0,6879
0500000US40113,40,113,Osage County,47311,1668,45643,6012,183,5322,12,0,4047,4035,12,30067
0500000US40139,40,139,Texas County,21121,9564,11557,102,651,910,9,12,398,349,49,9475
0500000US40127,40,127,Pushmataha County,11119,415,10704,1416,54,98,12,0,1172,1165,7,7952
0500000US40047,40,047,Garfield County,62190,7557,54633,1108,582,2529,609,0,3112,3078,34,46693
0500000US40069,40,069,Johnston County,11041,576,10465,707,8,206,0,0,1844,1817,27,7700
0500000US40121,40,121,Pittsburg County,44382,2200,42182,2841,164,1284,46,22,6911,6911,0,30914
0500000US40129,40,129,Roger Mills County,3708,261,3447,101,0,17,0,0,218,218,0,3111
0500000US40153,40,153,Woodward County,20967,2619,18348,272,38,286,4,0,915,915,0,16833
0500000US40021,40,021,Cherokee County,48599,3424,45175,16059,299,634,106,6,4806,4786,20,23265
0500000US40041,40,041,Delaware County,42112,1567,40545,9446,510,144,33,1,3469,3438,31,26942
0500000US40045,40,045,Ellis County,4072,296,3776,58,33,9,0,0,148,121,27,3528
0500000US40051,40,051,Grady County,54733,3127,51606,2454,219,1215,0,16,2988,2985,3,44714
0500000US40119,40,119,Payne County,81512,3820,77692,3603,3596,3230,69,46,4391,4351,40,62757
0500000US40125,40,125,Pottawatomie County,72000,3647,68353,9999,502,2388,47,15,3085,3062,23,52317
0500000US40037,40,037,Creek County,71160,2869,68291,7969,386,1513,40,115,3960,3956,4,54308
0500000US40141,40,141,Tillman County,7515,1986,5529,188,1,607,4,0,232,232,0,4497
0500000US40149,40,149,Washita County,11432,1125,10307,141,24,131,0,0,465,465,0,9546
0500000US40033,40,033,Cotton County,5929,453,5476,518,0,131,0,0,301,301,0,4526
0500000US40075,40,075,Kiowa County,9001,1039,7962,383,69,314,6,0,481,481,0,6709
0500000US40079,40,079,Le Flore County,49909,3452,46457,5248,257,1034,0,14,4144,4112,32,35760
0500000US40089,40,089,McCurtain County,32966,1934,31032,4278,222,2613,286,0,2960,2952,8,20673
0500000US40093,40,093,Major County,7718,723,6995,131,43,27,10,0,210,210,0,6574
0500000US40097,40,097,Mayes County,40980,1422,39558,6808,160,193,98,21,5594,5587,7,26684
0500000US40109,40,109,Oklahoma County,782051,133943,648108,18985,26362,116092,532,1384,43972,43305,667,440781
0500000US40039,40,039,Custer County,29209,5259,23950,784,329,927,10,0,1863,1849,14,20037
0500000US40007,40,007,Beaver County,5415,1245,4170,100,0,14,0,0,94,94,0,3962
0500000US40085,40,085,Love County,9933,1507,8426,523,78,253,0,0,454,454,0,7118
0500000US40009,40,009,Beckham County,22621,3273,19348,414,180,853,8,39,786,778,8,17068
0500000US40023,40,023,Choctaw County,14886,627,14259,2247,2,1661,22,21,1219,1216,3,9087
0500000US40065,40,065,Jackson County,25384,6035,19349,389,327,1666,20,17,941,896,45,15989
0500000US40081,40,081,Lincoln County,34854,1166,33688,2603,106,626,29,22,1539,1514,25,28763
0500000US41047,41,047,Marion County,335553,88282,247271,1823,6672,3888,2989,326,10765,10151,614,220808
0500000US41029,41,029,Jackson County,214267,26868,187399,1857,2690,1266,712,320,6463,6362,101,174091
0500000US41023,41,023,Grant County,7183,263,6920,97,31,22,6,2,184,184,0,6578
0500000US41031,41,031,Jefferson County,23143,4622,18521,3698,138,203,18,8,522,517,5,13934
0500000US41005,41,005,Clackamas County,405788,34659,371129,2468,16784,3478,1065,545,12783,12683,100,334006
0500000US41043,41,043,Linn County,122870,10910,111960,965,1340,496,100,122,4052,3968,84,104885
0500000US41057,41,057,Tillamook County,26076,2695,23381,188,160,96,117,0,795,795,0,22025
0500000US41001,41,001,Baker County,15984,651,15333,196,139,149,45,23,266,266,0,14515
0500000US41033,41,033,Josephine County,85481,6246,79235,764,817,379,60,78,2659,2650,9,74478
0500000US41059,41,059,Umatilla County,76898,20313,56585,1938,642,700,128,54,2044,2027,17,51079
0500000US41041,41,041,Lincoln County,47881,4340,43541,1235,543,215,109,0,1876,1833,43,39563
0500000US41009,41,009,Columbia County,50851,2534,48317,474,569,269,111,8,1729,1705,24,45157
0500000US41055,41,055,Sherman County,1605,58,1547,15,2,9,14,0,33,33,0,1474
0500000US41065,41,065,Wasco County,25866,4597,21269,874,183,82,152,0,570,570,0,19408
0500000US41039,41,039,Lane County,368882,31986,336896,3156,9574,3526,845,756,16103,15886,217,302936
0500000US41045,41,045,Malheur County,30431,10175,20256,234,375,308,21,19,600,598,2,18699
0500000US41067,41,067,Washington County,581821,96240,485581,1780,58824,11228,2249,945,24558,23872,686,385997
0500000US41049,41,049,Morrow County,11215,4024,7191,64,69,21,28,0,295,295,0,6714
0500000US41007,41,007,Clatsop County,38562,3260,35302,116,400,272,126,0,1340,1340,0,33048
0500000US41015,41,015,Curry County,22507,1563,20944,344,127,102,0,20,884,884,0,19467
0500000US41021,41,021,Gilliam County,1907,119,1788,82,9,0,13,0,7,7,0,1677
0500000US41037,41,037,Lake County,7843,627,7216,178,80,15,0,5,294,264,30,6644
0500000US41061,41,061,Union County,26028,1225,24803,236,276,170,322,15,623,623,0,23161
0500000US42045,42,045,Delaware County,563527,20697,542830,603,31152,117905,93,1055,12002,11521,481,380020
0500000US42119,42,119,Union County,45114,2643,42471,286,746,2757,26,76,578,517,61,38002
0500000US42127,42,127,Wayne County,51536,2220,49316,76,290,1522,9,11,635,629,6,46773
0500000US42043,42,043,Dauphin County,274515,24440,250075,369,11364,49035,38,442,6550,6202,348,182277
0500000US42053,42,053,Forest County,7351,466,6885,12,23,2159,0,4,169,155,14,4518
0500000US42089,42,089,Monroe County,167586,25830,141756,293,3862,22300,7,242,3087,2705,382,111965
0500000US42101,42,101,Philadelphia County,1575522,227711,1347811,3200,111912,646234,381,5676,34624,32568,2056,545784
0500000US42129,42,129,Westmoreland County,354751,4055,350696,178,3219,8421,50,270,5276,5026,250,333282
0500000US42013,42,013,Blair County,123842,1508,122334,39,866,1956,55,149,2027,1954,73,117242
0500000US42021,42,021,Cambria County,134550,2125,132425,63,636,4240,40,249,2317,2270,47,124880
0500000US42011,42,011,Berks County,416642,84748,331894,355,5712,17424,27,591,5923,5678,245,301862
0500000US42061,42,061,Huntingdon County,45421,858,44563,52,240,2345,4,0,682,609,73,41240
0500000US42073,42,073,Lawrence County,87382,1200,86182,69,425,3156,0,173,1908,1880,28,80451
0500000US42087,42,087,Mifflin County,46362,696,45666,73,88,361,3,15,618,607,11,44508
0500000US42041,42,041,Cumberland County,247433,9218,238215,219,10055,8772,36,256,5400,5274,126,213477
0500000US42003,42,003,Allegheny County,1225561,24925,1200636,1049,44549,155719,261,2788,30987,30096,891,965283
0500000US42109,42,109,Snyder County,40466,904,39562,12,275,369,0,0,434,414,20,38472
0500000US42115,42,115,Susquehanna County,41340,698,40642,27,138,289,0,7,352,341,11,39829
0500000US42039,42,039,Crawford County,86164,1084,85080,38,384,1523,29,72,1281,1215,66,81753
0500000US42049,42,049,Erie County,275972,11367,264605,575,4560,18972,46,751,6589,6387,202,233112
0500000US42057,42,057,Fulton County,14506,76,14430,36,29,297,0,0,114,109,5,13954
0500000US42067,42,067,Juniata County,24562,872,23690,0,123,256,0,6,110,110,0,23195
0500000US42107,42,107,Schuylkill County,143555,5870,137685,187,732,3967,0,43,1565,1470,95,131191
0500000US42131,42,131,Wyoming County,27588,508,27080,13,63,254,0,4,345,336,9,26401
0500000US42001,42,001,Adams County,102023,7045,94978,18,695,1400,0,32,1745,1689,56,91088
0500000US42005,42,005,Armstrong County,66331,492,65839,19,193,591,0,16,579,573,6,64441
0500000US42035,42,035,Clinton County,39074,577,38497,49,298,566,6,0,361,335,26,37217
0500000US42025,42,025,Carbon County,63931,2885,61046,21,323,1149,8,25,633,625,8,58887
0500000US42027,42,027,Centre County,161443,4680,156763,133,10173,5857,49,281,2249,2035,214,138021
0500000US42097,42,097,Northumberland County,92325,3006,89319,126,307,2303,8,82,795,792,3,85698
0500000US42095,42,095,Northampton County,301778,38717,263061,345,8206,14691,96,497,5977,5848,129,233249
0500000US42023,42,023,Cameron County,4686,41,4645,20,38,3,0,7,68,68,0,4509
0500000US42121,42,121,Venango County,52376,567,51809,8,191,408,0,80,877,874,3,50245
0500000US42007,42,007,Beaver County,166896,2541,164355,131,848,9724,78,88,3910,3901,9,149576
0500000US42017,42,017,Bucks County,626370,32238,594132,860,29174,24044,125,1024,9929,9264,665,528976
0500000US42069,42,069,Lackawanna County,211454,15071,196383,105,5564,5462,48,240,3464,3230,234,181500
0500000US42083,42,083,McKean County,41806,873,40933,24,186,980,15,20,625,601,24,39083
0500000US42051,42,051,Fayette County,132289,1503,130786,26,434,5126,346,46,3228,3149,79,121580
0500000US42091,42,091,Montgomery County,821301,41162,780139,695,61174,72945,188,1589,18207,17407,800,625341
0500000US42059,42,059,Greene County,37144,562,36582,34,124,1124,0,11,548,498,50,34741
0500000US42075,42,075,Lebanon County,138674,17542,121132,64,1862,2826,25,86,1520,1472,48,114749
0500000US42079,42,079,Luzerne County,317884,35075,282809,403,3822,11360,72,103,4266,4088,178,262783
0500000US42093,42,093,Montour County,18294,171,18123,6,866,321,0,7,148,145,3,16775
0500000US42037,42,037,Columbia County,66220,1767,64453,82,740,1165,26,22,624,603,21,61794
0500000US42019,42,019,Butler County,186566,2685,183881,69,2353,1622,46,170,2658,2593,65,176963
0500000US42065,42,065,Jefferson County,44084,383,43701,75,127,213,21,6,394,374,20,42865
0500000US42071,42,071,Lancaster County,538347,55213,483134,531,11576,19391,51,619,7748,7433,315,443218
0500000US42099,42,099,Perry County,45924,854,45070,74,182,422,0,28,474,466,8,43890
0500000US42105,42,105,Potter County,16937,218,16719,32,58,68,0,0,196,186,10,16365
0500000US42117,42,117,Tioga County,41226,520,40706,34,224,264,11,16,488,480,8,39669
0500000US44007,44,007,Providence County,634533,141206,493327,2211,25916,51578,502,6221,16456,13685,2771,390443
0500000US44001,44,001,Bristol County,48900,1421,47479,43,996,621,0,26,682,646,36,45111
0500000US44005,44,005,Newport County,83075,4693,78382,293,1632,2649,72,184,2272,2208,64,71280
0500000US45003,45,003,Aiken County,166926,9365,157561,549,1619,40865,76,157,3416,3309,107,110879
0500000US45071,45,071,Newberry County,38068,2797,35271,162,61,11997,9,66,168,168,0,22808
0500000US45037,45,037,Edgefield County,26769,1559,25210,37,70,9708,0,14,258,245,13,15123
0500000US45027,45,027,Clarendon County,34017,1036,32981,29,21,16503,0,0,260,245,15,16168
0500000US45029,45,029,Colleton County,37568,1187,36381,289,42,14374,200,17,231,231,0,21228
0500000US45085,45,085,Sumter County,106995,4147,102848,272,1328,50218,38,100,2318,2318,0,48574
0500000US45063,45,063,Lexington County,286316,16998,269318,742,5019,41302,275,363,6315,6244,71,215302
0500000US45011,45,011,Barnwell County,21577,512,21065,32,17,9838,0,112,161,161,0,10905
0500000US45015,45,015,Berkeley County,209065,13505,195560,865,4740,49446,203,637,6338,6241,97,133331
0500000US45031,45,031,Darlington County,67253,1338,65915,252,300,27353,9,0,1100,1100,0,36901
0500000US45043,45,043,Georgetown County,61605,1885,59720,75,321,19153,0,135,803,799,4,39233
0500000US45091,45,091,York County,258641,13788,244853,1580,5021,49180,133,877,4926,4836,90,183136
0500000US45007,45,007,Anderson County,195995,7128,188867,296,1782,30736,63,181,3953,3953,0,151856
0500000US45025,45,025,Chesterfield County,46024,1947,44077,209,222,14803,35,0,939,939,0,27869
0500000US45047,45,047,Greenwood County,70264,4209,66055,25,588,22062,0,209,1128,1034,94,42043
0500000US45051,45,051,Horry County,320915,19290,301625,1473,4128,43370,153,946,3909,3688,221,247646
0500000US45055,45,055,Kershaw County,64361,2690,61671,147,253,15253,0,157,1489,1489,0,44372
0500000US45075,45,075,Orangeburg County,88454,1917,86537,289,735,54253,83,122,1651,1641,10,29404
0500000US45001,45,001,Abbeville County,24657,347,24310,0,80,6761,0,0,494,493,1,16975
0500000US45009,45,009,Bamberg County,14600,291,14309,7,43,8923,0,16,105,99,6,5215
0500000US45017,45,017,Calhoun County,14713,540,14173,80,0,6076,0,0,105,105,0,7912
0500000US45033,45,033,Dillon County,30871,841,30030,583,81,14403,2,0,827,825,2,14134
0500000US45079,45,079,Richland County,408263,20733,387530,660,11416,188510,477,1267,10289,10107,182,174911
0500000US45039,45,039,Fairfield County,22712,471,22241,58,74,12710,0,0,770,770,0,8629
0500000US45049,45,049,Hampton County,19807,788,19019,36,95,10539,0,88,158,150,8,8103
0500000US45045,45,045,Greenville County,498402,44630,453772,856,11660,89068,301,704,8950,8468,482,342233
0500000US45057,45,057,Lancaster County,89546,4692,84854,188,1008,18978,0,149,1743,1728,15,62788
0500000US45035,45,035,Dorchester County,155474,8057,147417,598,2955,38865,152,593,4118,3759,359,100136
0500000US45041,45,041,Florence County,138561,3522,135039,305,1780,58560,110,190,1777,1701,76,72317
0500000US45059,45,059,Laurens County,66710,3119,63591,84,291,16370,46,40,1439,1408,31,45321
0500000US45065,45,065,McCormick County,9606,63,9543,34,43,4483,0,20,161,161,0,4802
0500000US45077,45,077,Pickens County,122746,4377,118369,320,2354,8123,62,178,1931,1894,37,105401
0500000US45087,45,087,Union County,27644,402,27242,16,3,8537,0,40,727,727,0,17919
0500000US45089,45,089,Williamsburg County,31794,727,31067,89,186,20476,0,58,337,337,0,9921
0500000US46003,46,003,Aurora County,2759,200,2559,77,0,31,0,0,17,17,0,2434
0500000US46051,46,051,Grant County,7217,161,7056,202,14,11,0,3,134,134,0,6692
0500000US46123,46,123,Tripp County,5468,11,5457,680,21,0,0,0,291,291,0,4465
0500000US46071,46,071,Jackson County,3287,19,3268,1823,18,3,0,0,138,138,0,1286
0500000US46099,46,099,Minnehaha County,186749,9067,177682,4248,4020,9969,17,279,4540,4465,75,154609
0500000US46033,46,033,Custer County,8573,269,8304,286,36,33,0,0,187,187,0,7762
0500000US46069,46,069,Hyde County,1331,9,1322,151,0,16,0,0,27,27,0,1128
0500000US46025,46,025,Clark County,3673,111,3562,72,5,1,0,6,29,29,0,3449
0500000US46049,46,049,Faulk County,2322,30,2292,68,2,1,0,0,15,15,0,2206
0500000US46077,46,077,Kingsbury County,4967,108,4859,9,10,0,0,0,26,25,1,4814
0500000US46129,46,129,Walworth County,5510,115,5395,538,75,262,0,0,161,161,0,4359
0500000US46027,46,027,Clay County,13925,396,13529,550,360,133,0,17,256,256,0,12213
0500000US46037,46,037,Day County,5506,117,5389,570,5,0,0,0,69,69,0,4745
0500000US46043,46,043,Douglas County,2930,19,2911,65,2,0,0,0,69,69,0,2775
0500000US46063,46,063,Harding County,1311,26,1285,37,4,27,0,0,24,24,0,1193
0500000US46089,46,089,McPherson County,2364,15,2349,82,10,1,0,0,6,6,0,2250
0500000US46109,46,109,Roberts County,10285,342,9943,3708,11,63,0,7,304,304,0,5850
0500000US46119,46,119,Sully County,1331,18,1313,13,0,0,0,0,30,30,0,1270
0500000US46083,46,083,Lincoln County,54914,1099,53815,310,605,638,10,25,966,966,0,51261
0500000US46079,46,079,Lake County,12574,194,12380,75,231,42,0,5,264,264,0,11763
0500000US46081,46,081,Lawrence County,25234,805,24429,548,293,211,32,30,335,335,0,22980
0500000US46029,46,029,Codington County,27993,638,27355,527,164,168,0,0,469,469,0,26027
0500000US46019,46,019,Butte County,10177,361,9816,235,0,68,0,4,186,186,0,9323
0500000US46031,46,031,Corson County,4168,16,4152,2845,1,19,0,0,75,75,0,1212
0500000US46045,46,045,Edmunds County,3940,70,3870,29,5,4,0,0,21,21,0,3811
0500000US46021,46,021,Campbell County,1435,4,1431,5,1,0,0,0,5,5,0,1420
0500000US46007,46,007,Bennett County,3437,286,3151,1781,14,2,0,0,199,199,0,1155
0500000US46055,46,055,Haakon County,2082,19,2063,60,0,1,0,0,51,51,0,1951
0500000US46075,46,075,Jones County,735,0,735,10,0,0,0,0,0,0,0,725
0500000US46093,46,093,Meade County,27424,1156,26268,791,341,531,0,5,534,529,5,24066
0500000US46125,46,125,Turner County,8264,189,8075,44,3,27,0,0,109,109,0,7892
0500000US46013,46,013,Brown County,38840,1027,37813,1207,1110,824,0,12,589,589,0,34071
0500000US46061,46,061,Hanson County,3397,0,3397,1,0,0,0,0,12,12,0,3384
0500000US46087,46,087,McCook County,5511,192,5319,25,0,42,0,0,68,66,2,5184
0500000US46095,46,095,Mellette County,2055,102,1953,1105,0,0,0,0,16,16,0,832
0500000US46105,46,105,Perkins County,2907,46,2861,53,0,0,0,5,26,26,0,2777
0500000US46103,46,103,Pennington County,109294,5436,103858,8697,1431,1146,68,178,4635,4619,16,87703
0500000US46127,46,127,Union County,15177,456,14721,105,176,128,0,0,267,267,0,14045
0500000US46097,46,097,Miner County,2229,44,2185,3,7,21,0,1,31,31,0,2122
0500000US46137,46,137,Ziebach County,2814,11,2803,2105,15,0,0,0,20,20,0,663
0500000US46039,46,039,Deuel County,4306,126,4180,1,0,0,0,0,10,10,0,4169
0500000US46009,46,009,Bon Homme County,6969,195,6774,388,55,104,0,0,171,171,0,6056
0500000US46015,46,015,Brule County,5256,138,5118,560,21,1,0,0,96,96,0,4440
0500000US46047,46,047,Fall River County,6774,275,6499,385,91,21,0,2,250,250,0,5750
0500000US46053,46,053,Gregory County,4201,27,4174,289,70,0,0,0,119,119,0,3696
0500000US46102,46,102,Oglala Lakota County,14335,562,13773,12838,0,12,0,0,308,308,0,615
0500000US47119,47,119,Maury County,89776,5086,84690,246,833,10376,11,198,1622,1622,0,71404
0500000US47173,47,173,Union County,19293,303,18990,6,33,86,44,0,219,219,0,18602
0500000US47125,47,125,Montgomery County,196387,19483,176904,972,4325,37580,689,769,7174,7022,152,125395
0500000US47043,47,043,Dickson County,51988,1783,50205,191,271,2150,0,70,891,864,27,46632
0500000US47129,47,129,Morgan County,21596,273,21323,31,0,1091,0,0,67,67,0,20134
0500000US47061,47,061,Grundy County,13331,164,13167,118,25,89,6,9,1770,1770,0,11150
0500000US47123,47,123,Monroe County,45876,1975,43901,352,187,935,0,0,623,604,19,41804
0500000US47079,47,079,Henry County,32279,803,31476,47,81,2736,0,0,396,390,6,28216
0500000US47029,47,029,Cocke County,35336,807,34529,225,0,585,10,0,710,710,0,32999
0500000US47033,47,033,Crockett County,14499,1515,12984,22,51,1911,0,16,229,229,0,10755
0500000US47041,47,041,DeKalb County,19601,1574,18027,0,158,266,15,0,276,276,0,17312
0500000US47095,47,095,Lake County,7526,169,7357,16,10,2180,0,20,105,98,7,5026
0500000US47093,47,093,Knox County,456185,18777,437408,1108,9983,39963,177,706,8886,8682,204,376585
0500000US47101,47,101,Lewis County,11956,268,11688,0,83,195,0,12,228,228,0,11170
0500000US47107,47,107,McMinn County,52773,2041,50732,135,396,1963,26,17,1018,1018,0,47177
0500000US47117,47,117,Marshall County,32269,1643,30626,0,103,2367,0,200,461,450,11,27495
0500000US47131,47,131,Obion County,30520,1285,29235,72,113,3039,11,24,590,590,0,25386
0500000US47143,47,143,Rhea County,32628,1614,31014,31,109,727,0,0,590,586,4,29557
0500000US47151,47,151,Scott County,21954,195,21759,47,3,116,0,0,223,207,16,21370
0500000US47167,47,167,Tipton County,61446,1675,59771,196,402,11092,94,60,1285,1259,26,46642
0500000US47001,47,001,Anderson County,75775,2120,73655,376,1018,2470,29,145,1926,1917,9,67691
0500000US47045,47,045,Dyer County,37576,1254,36322,173,282,4806,53,6,892,881,11,30110
0500000US47049,47,049,Fentress County,17994,269,17725,32,112,30,0,0,165,165,0,17386
0500000US47053,47,053,Gibson County,49175,1317,47858,157,159,8685,39,68,980,889,91,37770
0500000US47065,47,065,Hamilton County,357546,19538,338008,603,7114,68493,111,504,6486,6320,166,254697
0500000US47105,47,105,Loudon County,51610,4393,47217,73,371,502,0,42,793,793,0,45436
0500000US47149,47,149,Rutherford County,307128,23900,283228,639,9806,43527,32,310,8829,8417,412,220085
0500000US47159,47,159,Smith County,19458,511,18947,88,20,512,0,23,204,199,5,18100
0500000US47189,47,189,Wilson County,132663,5372,127291,269,1985,9253,69,84,2124,2025,99,113507
0500000US47163,47,163,Sullivan County,156734,2867,153867,168,892,2873,89,59,3178,3082,96,146608
0500000US47177,47,177,Warren County,40454,3612,36842,134,234,569,115,17,1172,1168,4,34601
0500000US47179,47,179,Washington County,127055,4273,122782,311,1970,5084,5,53,2441,2390,51,112918
0500000US47005,47,005,Benton County,16112,277,15835,69,8,511,0,0,267,258,9,14980
0500000US47013,47,013,Campbell County,39687,490,39197,161,155,128,0,12,419,419,0,38322
0500000US47015,47,015,Cannon County,13976,300,13676,34,4,234,0,0,237,237,0,13167
0500000US47047,47,047,Fayette County,39692,1034,38658,155,273,10857,1,4,311,311,0,27057
0500000US47067,47,067,Hancock County,6585,55,6530,19,51,37,0,3,36,32,4,6384
0500000US47091,47,091,Johnson County,17789,352,17437,85,63,584,0,5,204,199,5,16496
0500000US47103,47,103,Lincoln County,33711,1154,32557,54,175,2342,0,0,639,639,0,29347
0500000US47127,47,127,Moore County,6322,13,6309,149,107,84,0,0,83,77,6,5886
0500000US47051,47,051,Franklin County,41512,1362,40150,65,226,1971,26,98,994,994,0,36770
0500000US47009,47,009,Blount County,128443,4180,124263,369,973,3299,80,36,2385,2385,0,117121
0500000US47019,47,019,Carter County,56391,1013,55378,194,214,850,0,0,558,558,0,53562
0500000US47057,47,057,Grainger County,23013,742,22271,88,75,94,0,0,254,254,0,21760
0500000US47097,47,097,Lauderdale County,26297,642,25655,198,84,8804,0,14,579,572,7,15976
0500000US47099,47,099,Lawrence County,42937,892,42045,119,229,746,49,108,559,559,0,40235
0500000US47115,47,115,Marion County,28417,498,27919,58,121,603,0,12,1007,1007,0,26118
0500000US47133,47,133,Overton County,22004,304,21700,0,104,139,75,7,201,201,0,21174
0500000US47165,47,165,Sumner County,179473,8434,171039,498,2282,12587,110,164,3305,3174,131,152093
0500000US47169,47,169,Trousdale County,9573,65,9508,24,18,911,0,0,468,468,0,8087
0500000US47187,47,187,Williamson County,218648,10357,208291,255,9057,9220,56,111,3679,3472,207,185913
0500000US47027,47,027,Clay County,7686,52,7634,77,7,262,0,0,30,30,0,7258
0500000US47059,47,059,Greene County,68669,1919,66750,175,246,1314,0,14,997,994,3,64004
0500000US47157,47,157,Shelby County,937005,58537,878468,1037,23821,499489,201,1895,13851,13372,479,338174
0500000US47175,47,175,Van Buren County,5704,58,5646,0,0,13,0,0,157,157,0,5476
0500000US47077,47,077,Henderson County,27859,625,27234,0,55,2174,28,16,563,563,0,24398
0500000US47081,47,081,Hickman County,24678,596,24082,0,86,1230,4,36,413,413,0,22313
0500000US47089,47,089,Jefferson County,53247,1908,51339,64,293,961,0,0,845,831,14,49176
0500000US47153,47,153,Sequatchie County,14730,517,14213,9,0,28,0,9,362,362,0,13805
0500000US47155,47,155,Sevier County,96287,5612,90675,288,828,692,9,34,1822,1778,44,87002
0500000US47017,47,017,Carroll County,28018,715,27303,86,95,2853,27,3,495,495,0,23744
0500000US47023,47,023,Chester County,17150,188,16962,7,86,1771,0,4,401,400,1,14693
0500000US47037,47,037,Davidson County,684017,69634,614383,1360,24012,185754,423,2311,15873,15072,801,384650
0500000US47087,47,087,Jackson County,11615,234,11381,0,8,79,0,10,190,190,0,11094
0500000US47135,47,135,Perry County,7912,192,7720,9,35,274,0,0,106,106,0,7296
0500000US47145,47,145,Roane County,52897,940,51957,138,381,1282,16,7,979,952,27,49154
0500000US47121,47,121,Meigs County,11962,241,11721,27,11,236,0,0,168,161,7,11279
0500000US47063,47,063,Hamblen County,63740,7374,56366,111,657,2227,139,7,1175,1146,29,52050
0500000US47075,47,075,Haywood County,17779,779,17000,0,8,9005,8,7,119,119,0,7853
0500000US48143,48,143,Erath County,41482,8671,32811,213,312,674,21,9,500,432,68,31082
0500000US48039,48,039,Brazoria County,353999,106731,247268,1013,22670,47228,21,595,5419,5272,147,170322
0500000US48345,48,345,Motley County,1156,224,932,0,0,19,0,11,41,34,7,861
0500000US48129,48,129,Donley County,3387,373,3014,13,14,166,0,0,72,72,0,2749
0500000US48013,48,013,Atascosa County,48828,31200,17628,29,152,124,0,12,770,734,36,16541
0500000US48083,48,083,Coleman County,8391,1465,6926,39,79,254,0,0,91,91,0,6463
0500000US48353,48,353,Nolan County,14966,5527,9439,70,66,743,0,0,128,128,0,8432
0500000US48229,48,229,Hudspeth County,4098,3212,886,0,74,49,0,0,43,43,0,720
0500000US48325,48,325,Medina County,49334,25470,23864,99,356,1157,11,0,562,458,104,21679
0500000US48475,48,475,Ward County,11586,6131,5455,55,67,533,0,0,76,76,0,4724
0500000US48213,48,213,Henderson County,80460,10072,70388,568,530,5080,37,32,988,983,5,63153
0500000US48203,48,203,Harrison County,66645,8627,58018,188,489,14084,15,43,785,774,11,42414
0500000US48327,48,327,Menard County,2123,728,1395,12,0,14,0,0,50,38,12,1319
0500000US48277,48,277,Lamar County,49532,3804,45728,194,429,6135,111,19,1835,1835,0,37005
0500000US48149,48,149,Fayette County,25066,5212,19854,13,119,1592,0,0,213,205,8,17917
0500000US48491,48,491,Williamson County,527057,128133,398924,866,33636,31855,366,1198,14363,13696,667,316640
0500000US48373,48,373,Polk County,47837,7193,40644,693,313,4850,62,31,818,818,0,33877
0500000US48391,48,391,Refugio County,7236,3631,3605,5,14,400,0,0,158,158,0,3028
0500000US48055,48,055,Caldwell County,41401,21312,20089,136,401,2425,26,0,415,376,39,16686
0500000US48487,48,487,Wilbarger County,12906,3739,9167,78,90,1221,0,27,168,161,7,7583
0500000US48383,48,383,Reagan County,3752,2652,1100,0,0,27,0,0,9,9,0,1064
0500000US48189,48,189,Hale County,34113,20153,13960,10,104,1486,7,22,662,652,10,11669
0500000US48419,48,419,Shelby County,25478,4605,20873,39,415,4576,0,35,79,79,0,15729
0500000US48399,48,399,Runnels County,10310,3495,6815,16,25,317,0,6,83,80,3,6368
0500000US48407,48,407,San Jacinto County,27819,3563,24256,134,0,2846,13,0,484,426,58,20779
0500000US48451,48,451,Tom Green County,117466,46319,71147,248,1349,4702,50,114,1489,1480,9,63195
0500000US48469,48,469,Victoria County,91970,42733,49237,155,1001,5205,0,165,1283,1262,21,41428
0500000US48473,48,473,Waller County,49987,14903,35084,31,428,12222,24,48,760,717,43,21571
0500000US48485,48,485,Wichita County,131818,24818,107000,922,2732,13116,59,450,3203,3145,58,86518
0500000US48493,48,493,Wilson County,48198,18995,29203,53,188,642,44,56,563,563,0,27657
0500000US48219,48,219,Hockley County,23162,10970,12192,141,72,769,17,28,217,217,0,10948
0500000US48323,48,323,Maverick County,57970,55206,2764,652,269,236,32,136,0,0,0,1439
0500000US48329,48,329,Midland County,164194,72325,91869,677,3316,9934,72,100,1810,1780,30,75960
0500000US48297,48,297,Live Oak County,12123,4782,7341,0,117,336,0,0,41,41,0,6847
0500000US48299,48,299,Llano County,20640,2113,18527,28,82,26,0,0,511,511,0,17880
0500000US48147,48,147,Fannin County,34175,3752,30423,169,242,2133,13,3,845,840,5,27018
0500000US48255,48,255,Karnes County,15387,8304,7083,32,14,1218,0,0,174,174,0,5645
0500000US48041,48,041,Brazos County,219193,55519,163674,211,13706,22279,46,296,4269,4087,182,122867
0500000US48067,48,067,Cass County,30087,1335,28752,10,110,5177,1,6,465,465,0,22983
0500000US48165,48,165,Gaines County,20321,8375,11946,93,95,391,13,44,11,11,0,11299
0500000US48179,48,179,Gray County,22685,6465,16220,181,153,1007,19,0,356,356,0,14504
0500000US48313,48,313,Madison County,14128,3230,10898,27,441,2111,26,14,464,456,8,7815
0500000US48237,48,237,Jack County,8842,1465,7377,23,12,415,0,11,62,62,0,6854
0500000US48259,48,259,Kendall County,41982,9894,32088,31,369,286,25,0,776,776,0,30601
0500000US48035,48,035,Bosque County,18122,3263,14859,59,92,280,0,0,261,254,7,14167
0500000US48029,48,029,Bexar County,1925865,1155505,770360,2863,52513,136411,1589,2655,34894,32879,2015,539435
0500000US48017,48,017,Bailey County,7092,4558,2534,72,70,46,0,0,0,0,0,2346
0500000US48023,48,023,Baylor County,3591,370,3221,0,0,112,0,0,59,59,0,3050
0500000US48061,48,061,Cameron County,421750,377439,44311,543,2786,1673,38,272,665,610,55,38334
0500000US48121,48,121,Denton County,807047,155047,652000,2730,66371,74946,620,1354,21638,20833,805,484341
0500000US48477,48,477,Washington County,34796,5483,29313,79,591,5771,36,0,472,466,6,22364
0500000US48343,48,343,Morris County,12424,1176,11248,75,17,2927,6,0,177,177,0,8046
0500000US48429,48,429,Stephens County,9372,2199,7173,66,38,222,0,26,112,112,0,6709
0500000US48201,48,201,Harris County,4602523,1958963,2643560,8147,317911,855008,2456,10431,65575,61450,4125,1384032
0500000US48003,48,003,Andrews County,17818,9979,7839,0,63,321,21,0,219,206,13,7215
0500000US48171,48,171,Gillespie County,26208,6006,20202,7,42,19,0,34,447,427,20,19653
0500000US48177,48,177,Gonzales County,20667,10436,10231,17,52,1356,4,0,135,135,0,8667
0500000US48305,48,305,Lynn County,5808,2751,3057,21,43,61,4,0,76,76,0,2852
0500000US48503,48,503,Young County,18114,3332,14782,112,89,354,0,0,51,51,0,14176
0500000US48505,48,505,Zapata County,14369,13542,827,0,179,0,0,0,33,33,0,615
0500000US48221,48,221,Hood County,56901,7026,49875,469,433,466,0,0,460,460,0,48047
0500000US48223,48,223,Hopkins County,36240,6043,30197,44,243,2523,42,34,654,648,6,26657
0500000US48357,48,357,Ochiltree County,10348,5564,4784,47,16,18,0,0,191,191,0,4512
0500000US48269,48,269,King County,228,38,190,0,0,0,0,0,0,0,0,190
0500000US48275,48,275,Knox County,3733,1269,2464,4,5,213,0,0,51,51,0,2191
0500000US48309,48,309,McLennan County,248429,64733,183696,418,3957,35575,30,304,3646,3486,160,139766
0500000US48073,48,073,Cherokee County,51903,11855,40048,270,180,7008,43,0,906,906,0,31641
0500000US48095,48,095,Concho County,4233,2372,1861,6,48,89,0,0,12,12,0,1706
0500000US48119,48,119,Delta County,5215,380,4835,16,35,391,0,3,158,158,0,4232
0500000US48137,48,137,Edwards County,2055,1194,861,1,0,0,0,0,1,1,0,859
0500000US48133,48,133,Eastland County,18270,2963,15307,71,119,550,0,0,35,35,0,14532
0500000US48253,48,253,Jones County,19891,5447,14444,30,70,2842,0,33,856,828,28,10613
0500000US48389,48,389,Reeves County,15125,11352,3773,0,228,312,13,38,65,65,0,3117
0500000US48403,48,403,Sabine County,10458,455,10003,1,0,650,20,53,313,313,0,8966
0500000US48421,48,421,Sherman County,3058,1302,1756,6,0,9,0,0,20,20,0,1721
0500000US48437,48,437,Swisher County,7484,3254,4230,50,17,393,8,15,233,233,0,3514
0500000US48231,48,231,Hunt County,92152,14595,77557,952,1144,7297,43,72,1509,1476,33,66540
0500000US48063,48,063,Camp County,12813,3159,9654,52,44,2122,0,0,260,244,16,7176
0500000US48195,48,195,Hansford County,5547,2618,2929,4,0,3,0,0,11,11,0,2911
0500000US48187,48,187,Guadalupe County,155137,58462,96675,274,2578,11140,246,530,3252,3091,161,78655
0500000US48077,48,077,Clay County,10387,616,9771,114,60,59,0,0,182,176,6,9356
0500000US48217,48,217,Hill County,35399,7247,28152,115,120,2279,65,15,519,476,43,25039
0500000US48347,48,347,Nacogdoches County,65558,12565,52993,182,1082,11311,7,76,1256,1240,16,39079
0500000US48369,48,369,Parmer County,9852,6201,3651,29,25,107,0,0,89,71,18,3401
0500000US48377,48,377,Presidio County,7123,5956,1167,0,180,0,0,0,0,0,0,987
0500000US48465,48,465,Val Verde County,49027,40086,8941,64,285,611,31,0,338,326,12,7612
0500000US48135,48,135,Ector County,158342,94453,63889,339,1692,6704,50,325,1949,1891,58,52830
0500000US48173,48,173,Glasscock County,1430,626,804,0,0,0,0,0,0,0,0,804
0500000US48185,48,185,Grimes County,27630,6616,21014,90,45,4165,0,15,536,529,7,16163
0500000US48085,48,085,Collin County,944350,143369,800981,3132,135508,88702,582,2691,22963,21550,1413,547403
0500000US48005,48,005,Angelina County,87607,19174,68433,107,987,12834,5,163,1121,1103,18,53216
0500000US48101,48,101,Cottle County,1623,382,1241,5,0,243,0,89,37,37,0,867
0500000US48209,48,209,Hays County,204150,78334,125816,416,2806,7421,78,423,3384,3262,122,111288
0500000US48295,48,295,Lipscomb County,3469,1051,2418,69,9,18,0,0,70,70,0,2252
0500000US48321,48,321,Matagorda County,36743,15441,21302,98,710,3587,53,0,524,524,0,16330
0500000US48371,48,371,Pecos County,15797,10837,4960,164,74,567,17,17,81,81,0,4040
0500000US48397,48,397,Rockwall County,93642,16206,77436,224,2300,5670,0,57,2139,2079,60,67046
0500000US48401,48,401,Rusk County,53595,8855,44740,78,301,9131,22,31,853,817,36,34324
0500000US48447,48,447,Throckmorton County,1567,235,1332,0,0,16,0,0,24,24,0,1292
0500000US48471,48,471,Walker County,71539,12787,58752,256,911,16393,10,16,656,653,3,40510
0500000US48499,48,499,Wood County,43815,4313,39502,277,133,2335,37,34,413,405,8,36273
0500000US48007,48,007,Aransas County,24763,6756,18007,14,488,365,0,33,416,405,11,16691
0500000US48075,48,075,Childress County,7226,2241,4985,69,96,552,0,0,96,96,0,4172
0500000US48081,48,081,Coke County,3275,698,2577,44,6,20,0,0,32,32,0,2475
0500000US48099,48,099,Coryell County,75389,13631,61758,472,1476,9991,569,0,4772,4706,66,44478
0500000US48211,48,211,Hemphill County,4061,1455,2606,15,24,34,0,0,31,23,8,2502
0500000US48341,48,341,Moore County,21801,11973,9828,97,1713,627,0,0,217,217,0,7174
0500000US48349,48,349,Navarro County,48583,13013,35570,169,309,6124,539,88,815,813,2,27526
0500000US48405,48,405,San Augustine County,8327,583,7744,111,0,1760,0,0,132,132,0,5741
0500000US48417,48,417,Shackelford County,3311,385,2926,10,7,6,0,0,73,73,0,2830
0500000US48427,48,427,Starr County,63894,63299,595,7,69,21,0,12,21,21,0,465
0500000US48461,48,461,Upton County,3634,1837,1797,5,25,237,0,5,0,0,0,1525
0500000US48021,48,021,Bastrop County,82577,30389,52188,358,704,6097,0,434,838,799,39,43757
0500000US48191,48,191,Hall County,3074,1057,2017,3,9,239,0,0,37,37,0,1729
0500000US48159,48,159,Franklin County,10679,1515,9164,22,5,408,8,0,261,261,0,8460
0500000US48163,48,163,Frio County,19394,15279,4115,9,172,757,0,23,119,119,0,3035
0500000US48281,48,281,Lampasas County,20640,4025,16615,25,208,903,63,78,358,358,0,14980
0500000US48319,48,319,Mason County,4161,978,3183,12,92,1,0,0,49,49,0,3029
0500000US48125,48,125,Dickens County,2216,673,1543,0,12,68,0,0,0,0,0,1463
0500000US48439,48,439,Tarrant County,2019977,576242,1443735,5797,106427,319829,3474,3976,45930,44769,1161,958302
0500000US48001,48,001,Anderson County,57863,10142,47721,158,319,12127,9,15,781,777,4,34312
0500000US48239,48,239,Jackson County,14820,4873,9947,0,134,947,8,0,141,141,0,8717
0500000US48331,48,331,Milam County,24664,6459,18205,28,121,2093,0,12,525,520,5,15426
0500000US48093,48,093,Comanche County,13495,3729,9766,54,74,87,0,1,112,112,0,9438
0500000US48047,48,047,Brooks County,7180,6741,439,0,0,4,0,0,35,35,0,400
0500000US19029,19,029,Cass County,13191,326,12865,12,53,40,21,0,124,124,0,12615
0500000US19035,19,035,Cherokee County,11468,147,11321,51,78,269,0,0,182,179,3,10741
0500000US19047,19,047,Crawford County,17132,4758,12374,40,337,428,28,3,137,137,0,11401
0500000US19057,19,057,Des Moines County,39600,1193,38407,56,318,2328,0,2,962,962,0,34741
0500000US19065,19,065,Fayette County,19929,462,19467,9,131,379,0,0,231,206,25,18717
0500000US19085,19,085,Harrison County,14143,233,13910,32,40,31,16,2,161,161,0,13628
0500000US19109,19,109,Kossuth County,15075,362,14713,21,82,166,0,0,105,96,9,14339
0500000US19129,19,129,Mills County,14957,448,14509,108,40,130,0,3,123,123,0,14105
0500000US19133,19,133,Monona County,8796,170,8626,179,0,24,0,2,75,75,0,8346
0500000US19139,19,139,Muscatine County,42950,7641,35309,79,389,971,11,30,671,659,12,33158
0500000US19143,19,143,Osceola County,6115,479,5636,5,11,77,5,0,61,57,4,5477
0500000US19153,19,153,Polk County,474274,39086,435188,785,21376,30183,380,224,11958,11770,188,370282
0500000US19187,19,187,Webster County,36757,1743,35014,119,486,1719,6,0,460,455,5,32224
0500000US19169,19,169,Story County,96922,3259,93663,217,7449,1772,25,45,2679,2667,12,81476
0500000US19193,19,193,Woodbury County,102398,16541,85857,1570,2938,3193,199,15,2269,2251,18,75673
0500000US19013,19,013,Black Hawk County,133009,5738,127271,428,3073,12031,363,393,2633,2606,27,108350
0500000US19075,19,075,Grundy County,12341,155,12186,14,44,69,0,0,83,80,3,11976
0500000US19097,19,097,Jackson County,19395,276,19119,7,80,99,131,0,265,265,0,18537
0500000US19105,19,105,Jones County,20568,390,20178,6,226,504,0,0,138,138,0,19304
0500000US19111,19,111,Lee County,34541,1232,33309,74,206,883,0,0,751,745,6,31395
0500000US19131,19,131,Mitchell County,10631,146,10485,55,53,9,0,0,88,70,18,10280
0500000US19181,19,181,Warren County,49361,1333,48028,66,255,192,159,8,713,713,0,46635
0500000US19161,19,161,Sac County,9868,283,9585,0,8,64,0,0,114,106,8,9399
0500000US19149,19,149,Plymouth County,25039,1244,23795,106,134,159,16,7,283,283,0,23090
0500000US19041,19,041,Clay County,16313,567,15746,5,89,44,3,37,319,316,3,15249
0500000US19045,19,045,Clinton County,47218,1443,45775,171,343,1262,2,14,838,825,13,43145
0500000US20183,20,183,Smith County,3663,76,3587,19,9,8,0,0,74,74,0,3477
0500000US20067,20,067,Grant County,7616,3598,4018,0,19,0,0,10,50,40,10,3939
0500000US20095,20,095,Kingman County,7470,254,7216,42,1,21,0,0,168,168,0,6984
0500000US20131,20,131,Nemaha County,10104,204,9900,33,16,56,1,1,162,162,0,9631
0500000US20149,20,149,Pottawatomie County,23545,1238,22307,333,230,155,0,0,431,431,0,21158
0500000US20021,20,021,Cherokee County,20331,512,19819,483,87,125,72,11,1089,1089,0,17952
0500000US20015,20,015,Butler County,66468,3142,63326,497,750,1481,31,10,1302,1264,38,59255
0500000US20105,20,105,Lincoln County,3097,98,2999,0,0,23,0,0,48,48,0,2928
0500000US20191,20,191,Sumner County,23208,1245,21963,314,50,245,0,13,502,498,4,20839
0500000US20195,20,195,Trego County,2858,58,2800,23,38,3,0,0,37,37,0,2699
0500000US20205,20,205,Wilson County,8780,267,8513,57,2,49,0,0,311,311,0,8094
0500000US20207,20,207,Woodson County,3170,30,3140,16,0,34,0,0,145,141,4,2945
0500000US20135,20,135,Ness County,2955,300,2655,6,10,21,0,0,9,7,2,2609
0500000US20141,20,141,Osborne County,3603,74,3529,14,10,14,0,18,68,68,0,3405
0500000US20011,20,011,Bourbon County,14702,390,14312,71,133,473,0,0,381,381,0,13254
0500000US20075,20,075,Hamilton County,2616,937,1679,0,0,25,0,3,48,48,0,1603
0500000US20097,20,097,Kiowa County,2526,164,2362,22,30,16,0,1,53,53,0,2240
0500000US20177,20,177,Shawnee County,178284,21736,156548,1299,2470,14183,41,175,6182,6004,178,132198
0500000US20181,20,181,Sherman County,5966,723,5243,46,39,43,0,2,102,68,34,5011
0500000US20193,20,193,Thomas County,7824,471,7353,34,55,132,0,0,40,40,0,7092
0500000US20125,20,125,Montgomery County,32970,2135,30835,1032,346,1656,41,0,1436,1436,0,26324
0500000US20127,20,127,Morris County,5566,263,5303,6,29,2,0,0,149,146,3,5117
0500000US20153,20,153,Rawlins County,2509,170,2339,22,5,10,0,0,28,26,2,2274
0500000US20163,20,163,Rooks County,5118,131,4987,10,10,44,8,5,91,91,0,4819
0500000US20025,20,025,Clark County,2053,172,1881,25,16,10,0,0,66,66,0,1764
0500000US20053,20,053,Ellsworth County,6293,380,5913,49,37,287,0,12,129,119,10,5399
0500000US20077,20,077,Harper County,5673,355,5318,142,12,10,0,0,37,37,0,5117
0500000US20167,20,167,Russell County,6977,217,6760,7,0,107,35,0,143,143,0,6468
0500000US20111,20,111,Lyon County,33299,6998,26301,113,692,746,0,0,1008,1008,0,23742
0500000US20145,20,145,Pawnee County,6709,524,6185,51,4,331,0,0,148,148,0,5651
0500000US20001,20,001,Allen County,12630,438,12192,35,76,188,7,11,444,444,0,11431
0500000US20033,20,033,Comanche County,1780,123,1657,0,0,0,0,0,25,25,0,1632
0500000US20049,20,049,Elk County,2562,111,2451,46,18,6,0,0,63,63,0,2318
0500000US20063,20,063,Gove County,2619,91,2528,15,28,3,0,0,48,48,0,2434
0500000US20079,20,079,Harvey County,34555,4078,30477,115,250,573,83,0,783,780,3,28673
0500000US20083,20,083,Hodgeman County,1842,158,1684,2,35,0,0,0,22,22,0,1625
0500000US20093,20,093,Kearny County,3932,1232,2700,0,13,21,0,0,58,56,2,2608
0500000US20185,20,185,Stafford County,4214,560,3654,43,12,25,0,0,51,51,0,3523
0500000US20113,20,113,McPherson County,28630,1176,27454,131,163,313,0,20,546,546,0,26281
0500000US20139,20,139,Osage County,15882,496,15386,30,32,95,0,0,396,388,8,14833
0500000US20071,20,071,Greeley County,1200,276,924,7,0,8,0,0,10,10,0,899
0500000US20031,20,031,Coffey County,8296,219,8077,61,23,51,0,4,188,188,0,7750
0500000US20037,20,037,Crawford County,39108,2146,36962,164,787,842,0,0,1190,1190,0,33979
0500000US20051,20,051,Ellis County,28878,1640,27238,55,307,399,43,22,498,498,0,25914
0500000US20073,20,073,Greenwood County,6156,233,5923,9,8,19,0,0,214,214,0,5673
0500000US20099,20,099,Labette County,20367,908,19459,190,62,852,0,0,946,946,0,17409
0500000US20107,20,107,Linn County,9635,252,9383,78,51,30,0,0,195,195,0,9029
0500000US20173,20,173,Sedgwick County,512064,73527,438537,3459,22005,44285,169,473,18161,17975,186,349985
0500000US20175,20,175,Seward County,22692,13627,9065,149,656,1132,0,3,145,136,9,6980
0500000US20157,20,157,Republic County,4686,87,4599,17,30,16,0,0,47,47,0,4489
0500000US20065,20,065,Graham County,2545,77,2468,5,25,100,0,0,88,88,0,2250
0500000US20091,20,091,Johnson County,585502,44056,541446,1167,28582,26671,163,492,14561,14452,109,469810
0500000US20045,20,045,Douglas County,119319,7356,111963,2565,6198,4841,10,146,4335,4261,74,93868
0500000US20179,20,179,Sheridan County,2506,120,2386,5,0,11,0,0,9,9,0,2361
0500000US20121,20,121,Miami County,33127,1031,32096,278,136,456,0,0,452,452,0,30774
0500000US20069,20,069,Gray County,6037,950,5087,30,7,0,34,0,55,55,0,4961
0500000US20199,20,199,Wallace County,1575,83,1492,0,0,4,0,0,35,30,5,1453
0500000US20189,20,189,Stevens County,5686,2049,3637,15,11,37,0,0,103,103,0,3471
0500000US20201,20,201,Washington County,5525,189,5336,6,0,14,0,0,119,114,5,5197
0500000US20019,20,019,Chautauqua County,3367,36,3331,208,0,20,0,0,198,198,0,2905
0500000US20129,20,129,Morton County,2838,654,2184,0,18,26,0,0,101,101,0,2039
0500000US20155,20,155,Reno County,63101,5888,57213,469,339,1668,0,129,1454,1445,9,53154
0500000US20029,20,029,Cloud County,9060,289,8771,12,3,161,0,12,154,154,0,8429
0500000US20043,20,043,Doniphan County,7736,215,7521,34,7,422,0,0,72,72,0,6986
0500000US20081,20,081,Haskell County,4047,1219,2828,22,10,0,1,0,71,71,0,2724
0500000US20101,20,101,Lane County,1642,97,1545,29,0,1,5,0,2,2,0,1508
0500000US20171,20,171,Scott County,4949,885,4064,5,70,0,0,0,57,35,22,3932
0500000US20133,20,133,Neosho County,16125,811,15314,49,65,157,6,15,443,443,0,14579
0500000US20013,20,013,Brown County,9664,415,9249,682,52,105,10,0,345,345,0,8055
0500000US20147,20,147,Phillips County,5408,183,5225,14,25,32,5,0,75,75,0,5074
0500000US20161,20,161,Riley County,75296,6232,69064,232,3733,4658,172,114,2546,2394,152,57609
0500000US20039,20,039,Decatur County,2881,81,2800,26,4,4,0,0,22,22,0,2744
0500000US20087,20,087,Jefferson County,18888,494,18394,129,2,128,0,20,417,410,7,17698
0500000US21031,21,031,Butler County,12745,408,12337,26,26,34,4,0,153,153,0,12094
0500000US21061,21,061,Edmonson County,12122,94,12028,28,11,185,0,1,255,255,0,11548
0500000US21097,21,097,Harrison County,18668,445,18223,0,0,361,3,38,361,361,0,17460
0500000US21023,21,023,Bracken County,8306,148,8158,14,46,3,0,0,110,110,0,7985
0500000US21143,21,143,Lyon County,8186,240,7946,29,9,364,4,0,110,105,5,7430
0500000US21063,21,063,Elliott County,7517,22,7495,6,0,252,0,0,15,15,0,7222
0500000US21111,21,111,Jefferson County,767154,40117,727037,1154,21196,162652,346,1756,18796,18139,657,521137
0500000US21123,21,123,Larue County,14156,459,13697,9,64,507,0,13,143,143,0,12961
0500000US21161,21,161,Mason County,17153,315,16838,6,149,934,6,13,446,436,10,15284
0500000US21167,21,167,Mercer County,21516,634,20882,12,174,838,10,0,300,286,14,19548
0500000US21201,21,201,Robertson County,2143,13,2130,0,0,16,0,0,4,4,0,2110
0500000US21207,21,207,Russell County,17760,657,17103,24,91,136,0,15,187,187,0,16650
0500000US21229,21,229,Washington County,12019,539,11480,0,103,624,0,0,239,239,0,10514
0500000US21007,21,007,Ballard County,8090,103,7987,20,31,336,0,3,90,90,0,7507
0500000US21009,21,009,Barren County,43680,1362,42318,50,141,1611,0,25,967,967,0,39524
0500000US21087,21,087,Green County,11023,52,10971,310,9,143,0,0,94,89,5,10415
0500000US21091,21,091,Hancock County,8719,130,8589,12,64,81,0,0,96,93,3,8336
0500000US21159,21,159,Martin County,11919,198,11721,21,0,597,10,0,63,54,9,11030
0500000US21093,21,093,Hardin County,108095,6154,101941,200,2271,12083,350,251,4534,4507,27,82252
0500000US21149,21,149,McLean County,9331,128,9203,18,20,47,0,0,131,131,0,8987
0500000US21183,21,183,Ohio County,24071,816,23255,8,67,225,0,0,231,231,0,22724
0500000US21197,21,197,Powell County,12321,197,12124,33,71,29,6,0,145,145,0,11840
0500000US21233,21,233,Webster County,13155,719,12436,9,4,513,8,14,266,266,0,11622
0500000US21033,21,033,Caldwell County,12727,221,12506,0,0,840,0,0,92,92,0,11574
0500000US21045,21,045,Casey County,15796,459,15337,44,25,112,0,0,182,182,0,14974
0500000US21047,21,047,Christian County,72263,5600,66663,326,1094,14939,276,154,2288,2288,0,47586
0500000US21085,21,085,Grayson County,26178,374,25804,106,61,273,0,114,343,268,75,24907
0500000US21103,21,103,Henry County,15814,511,15303,38,115,456,18,0,187,187,0,14489
0500000US21107,21,107,Hopkins County,45664,932,44732,163,290,2901,0,0,907,903,4,40471
0500000US21109,21,109,Jackson County,13373,13,13360,2,0,13,0,0,39,39,0,13306
0500000US21125,21,125,Laurel County,60180,926,59254,228,113,560,0,14,680,660,20,57659
0500000US21157,21,157,Marshall County,31166,488,30678,58,104,197,0,0,241,241,0,30078
0500000US21163,21,163,Meade County,28326,1068,27258,216,217,922,0,9,574,574,0,25320
0500000US21173,21,173,Montgomery County,27759,752,27007,85,15,804,21,9,297,297,0,25776
0500000US21181,21,181,Nicholas County,7100,121,6979,20,0,76,0,0,80,80,0,6803
0500000US21185,21,185,Oldham County,65374,2564,62810,136,965,2386,17,78,1449,1427,22,57779
0500000US21187,21,187,Owen County,10741,291,10450,25,0,174,17,0,54,54,0,10180
0500000US21203,21,203,Rockcastle County,16827,148,16679,186,0,25,0,0,87,87,0,16381
0500000US21209,21,209,Scott County,53517,2341,51176,73,529,2558,0,60,1389,1384,5,46567
0500000US21227,21,227,Warren County,126427,6667,119760,394,4820,11308,354,271,2875,2839,36,99738
0500000US21003,21,003,Allen County,20794,428,20366,0,85,311,0,0,177,177,0,19793
0500000US21017,21,017,Bourbon County,20144,1382,18762,0,89,1435,0,0,114,114,0,17124
0500000US21019,21,019,Boyd County,48091,850,47241,47,133,1202,15,0,1031,1009,22,44813
0500000US21029,21,029,Bullitt County,79466,1479,77987,139,509,562,80,133,1367,1349,18,75197
0500000US21055,21,055,Crittenden County,9083,104,8979,29,0,109,0,10,94,94,0,8737
0500000US21067,21,067,Fayette County,318734,22854,295880,470,11587,45335,161,1145,9899,9593,306,227283
0500000US21075,21,075,Fulton County,6210,117,6093,21,7,1550,0,5,98,93,5,4412
0500000US21115,21,115,Johnson County,22843,89,22754,20,325,112,0,0,61,61,0,22236
0500000US21165,21,165,Menifee County,6405,0,6405,0,8,4,0,0,24,24,0,6369
0500000US21175,21,175,Morgan County,13285,126,13159,14,158,443,36,14,142,142,0,12352
0500000US21193,21,193,Perry County,26917,271,26646,29,323,306,36,0,242,242,0,25710
0500000US21237,21,237,Wolfe County,7223,23,7200,30,3,8,0,0,41,41,0,7118
0500000US21051,21,051,Clay County,20621,559,20062,70,0,613,30,9,247,225,22,19093
0500000US21013,21,013,Bell County,27188,279,26909,41,32,780,0,31,374,374,0,25651
0500000US21025,21,025,Breathitt County,13116,140,12976,24,28,146,0,0,89,89,0,12689
0500000US21083,21,083,Graves County,37294,2402,34892,44,168,1555,101,2,661,661,0,32361
0500000US21099,21,099,Hart County,18627,343,18284,102,92,776,0,12,250,250,0,17052
0500000US21231,21,231,Wayne County,20609,483,20126,0,67,471,0,0,342,342,0,19246
0500000US21155,21,155,Marion County,19232,519,18713,26,45,1417,68,25,261,261,0,16871
0500000US21221,21,221,Trigg County,14344,303,14041,0,51,1253,0,0,75,75,0,12662
0500000US21015,21,015,Boone County,129095,5339,123756,118,2911,3873,0,8,3118,3097,21,113728
0500000US21131,21,131,Leslie County,10472,73,10399,0,44,6,0,0,120,120,0,10229
0500000US21121,21,121,Knox County,31467,367,31100,216,124,392,0,0,192,192,0,30176
0500000US21127,21,127,Lawrence County,15783,169,15614,5,67,87,0,0,168,162,6,15287
0500000US21139,21,139,Livingston County,9263,165,9098,11,13,64,1,0,146,146,0,8863
0500000US21195,21,195,Pike County,60483,553,59930,88,322,533,0,29,301,301,0,58657
0500000US21211,21,211,Shelby County,46786,4468,42318,0,416,2853,37,145,1382,1359,23,37485
0500000US21005,21,005,Anderson County,22214,383,21831,0,71,566,18,0,281,281,0,20895
0500000US21027,21,027,Breckinridge County,20080,289,19791,36,71,369,0,3,340,340,0,18972
0500000US21073,21,073,Franklin County,50296,1618,48678,65,915,4764,20,43,1763,1737,26,41108
0500000US21117,21,117,Kenton County,164688,5159,159529,207,2034,7289,2,47,3885,3868,17,146065
0500000US21151,21,151,Madison County,89700,2138,87562,330,892,3818,7,170,1935,1838,97,80410
0500000US21153,21,153,Magoffin County,12666,46,12620,4,0,5,0,0,0,0,0,12611
0500000US21189,21,189,Owsley County,4463,16,4447,4,3,62,0,8,4,4,0,4366
0500000US21213,21,213,Simpson County,18063,426,17637,109,143,1775,0,0,199,199,0,15411
0500000US21217,21,217,Taylor County,25500,607,24893,0,259,999,0,15,761,761,0,22859
0500000US21219,21,219,Todd County,12350,478,11872,4,0,976,0,72,219,219,0,10601
0500000US21039,21,039,Carlisle County,4841,105,4736,70,27,65,0,2,26,26,0,4546
0500000US21053,21,053,Clinton County,10211,289,9922,0,19,43,0,0,34,34,0,9826
0500000US21077,21,077,Gallatin County,8703,467,8236,0,6,158,0,0,146,146,0,7926
0500000US21079,21,079,Garrard County,17328,390,16938,70,24,192,0,0,323,323,0,16329
0500000US21069,21,069,Fleming County,14479,186,14293,9,26,235,0,16,117,117,0,13890
0500000US21037,21,037,Campbell County,92267,1852,90415,68,913,2938,20,49,1231,1225,6,85196
0500000US22113,22,113,Vermilion Parish,59867,2060,57807,265,1254,8811,0,73,500,500,0,46904
0500000US22089,22,089,St. Charles Parish,52724,3162,49562,201,558,13818,0,31,521,422,99,34433
0500000US22029,22,029,Concordia Parish,20021,280,19741,15,36,8230,26,7,25,25,0,11402
0500000US22107,22,107,Tensas Parish,4666,121,4545,0,4,2539,0,9,17,17,0,1976
0500000US22093,22,093,St. James Parish,21357,343,21014,0,24,10592,0,9,144,42,102,10245
0500000US22043,22,043,Grant Parish,22348,1116,21232,14,46,3684,0,89,321,252,69,17078
0500000US22051,22,051,Jefferson Parish,435300,62522,372778,1315,18037,114087,26,1279,6950,6714,236,231084
0500000US22013,22,013,Bienville Parish,13668,26,13642,6,19,5884,0,142,155,155,0,7436
0500000US22015,22,015,Bossier Parish,126131,8262,117869,588,2074,27941,136,247,2192,2092,100,84691
0500000US22023,22,023,Cameron Parish,6868,403,6465,34,27,289,0,0,21,0,21,6094
0500000US22037,22,037,East Feliciana Parish,19499,313,19186,93,51,8522,0,21,139,135,4,10360
0500000US22095,22,095,St. John the Baptist Parish,43446,2554,40892,0,456,24066,0,362,723,692,31,15285
0500000US22075,22,075,Plaquemines Parish,23373,1652,21721,218,850,4728,8,5,840,840,0,15072
0500000US22073,22,073,Ouachita Parish,156075,3429,152646,271,1643,58313,0,63,1432,1378,54,90924
0500000US22079,22,079,Rapides Parish,131546,4063,127483,836,1764,41699,16,56,2437,2270,167,80675
0500000US22117,22,117,Washington Parish,46457,1022,45435,139,61,13951,6,23,786,779,7,30469
0500000US22097,22,097,St. Landry Parish,83449,1762,81687,116,210,34275,0,325,1276,1266,10,45485
0500000US22105,22,105,Tangipahoa Parish,130504,5483,125021,348,985,38555,0,142,2367,2288,79,82624
0500000US22001,22,001,Acadia Parish,62568,1560,61008,20,42,11109,10,116,1289,1289,0,48422
0500000US22101,22,101,St. Mary Parish,51734,3583,48151,646,753,16058,11,40,1622,1622,0,29021
0500000US22123,22,123,West Carroll Parish,11180,394,10786,24,0,1800,10,21,85,85,0,8846
0500000US22103,22,103,St. Tammany Parish,252093,13857,238236,1248,3862,29523,73,573,4118,3975,143,198839
0500000US22111,22,111,Union Parish,22475,1047,21428,14,19,5584,39,0,318,318,0,15454
0500000US22021,22,021,Caldwell Parish,9996,317,9679,50,12,1671,0,0,33,33,0,7913
0500000US22017,22,017,Caddo Parish,248361,6956,241405,973,3091,120802,66,413,3850,3711,139,112210
0500000US22035,22,035,East Carroll Parish,7225,27,7198,0,0,5051,0,0,58,58,0,2089
0500000US22005,22,005,Ascension Parish,121176,6603,114573,47,1281,26335,40,229,3253,3226,27,83388
0500000US22055,22,055,Lafayette Parish,240091,11038,229053,378,4392,61883,0,430,3776,3730,46,158194
0500000US22045,22,045,Iberia Parish,72691,3051,69640,62,1952,22917,0,65,1782,1774,8,42862
0500000US22087,22,087,St. Bernard Parish,45694,4575,41119,67,1035,10214,18,178,879,879,0,28728
0500000US22091,22,091,St. Helena Parish,10411,36,10375,108,43,5626,0,0,16,16,0,4582
0500000US22121,22,121,West Baton Rouge Parish,25860,786,25074,33,41,10164,0,0,270,270,0,14566
0500000US22031,22,031,De Soto Parish,27216,777,26439,302,46,9713,16,26,443,430,13,15893
0500000US22081,22,081,Red River Parish,8618,186,8432,0,2,3364,0,11,148,148,0,4907
0500000US22063,22,063,Livingston Parish,138111,4948,133163,333,637,8252,17,23,2207,2183,24,121694
0500000US22069,22,069,Natchitoches Parish,38963,876,38087,390,268,15756,0,612,658,630,28,20403
0500000US22071,22,071,Orleans Parish,389648,21403,368245,499,11163,229914,64,1525,5757,5555,202,119323
0500000US22025,22,025,Catahoula Parish,9893,163,9730,19,10,3158,0,0,22,14,8,6521
0500000US22019,22,019,Calcasieu Parish,200182,6763,193419,687,2723,49675,6,285,4201,4092,109,135842
0500000US22041,22,041,Franklin Parish,20322,106,20216,10,18,6701,5,0,245,199,46,13237
0500000US22007,22,007,Assumption Parish,22714,659,22055,83,39,6783,0,0,242,198,44,14908
0500000US22049,22,049,Jackson Parish,15926,257,15669,12,87,4771,0,54,25,17,8,10720
0500000US22083,22,083,Richland Parish,20474,439,20035,0,153,7249,0,39,201,201,0,12393
0500000US22099,22,099,St. Martin Parish,53752,1579,52173,196,534,15676,0,182,1037,1021,16,34548
0500000US22127,22,127,Winn Parish,14494,292,14202,24,0,4574,0,0,172,172,0,9432
0500000US22033,22,033,East Baton Rouge Parish,444094,17912,426182,585,13935,203285,117,639,7992,7794,198,199629
0500000US22003,22,003,Allen Parish,25661,1503,24158,464,167,4786,0,0,522,509,13,18219
0500000US22065,22,065,Madison Parish,11472,237,11235,8,0,7301,0,8,28,28,0,3890
0500000US23017,23,017,Oxford County,57325,750,56575,164,268,250,4,0,1175,1160,15,54714
0500000US23027,23,027,Waldo County,39418,528,38890,180,195,186,0,18,641,641,0,37670
0500000US23019,23,019,Penobscot County,151748,2006,149742,1513,1560,1325,63,85,2703,2650,53,142493
0500000US23001,23,001,Androscoggin County,107444,1980,105464,232,812,2013,4,50,4802,4761,41,97551
0500000US23003,23,003,Aroostook County,68269,801,67468,1236,287,623,7,0,947,945,2,64368
0500000US23005,23,005,Cumberland County,290944,5959,284985,357,6088,8305,11,343,6569,6427,142,263312
0500000US23013,23,013,Knox County,39823,592,39231,132,215,204,0,9,729,718,11,37942
0500000US23031,23,031,York County,203102,3378,199724,845,2597,1674,31,121,2842,2823,19,191614
0500000US23007,23,007,Franklin County,30019,386,29633,119,114,84,31,28,510,503,7,28747
0500000US23025,23,025,Somerset County,50710,530,50180,224,152,266,0,1,935,935,0,48602
0500000US24047,24,047,Worcester County,51564,1765,49799,100,657,6692,32,28,998,996,2,41292
0500000US24510,24,510,Baltimore city,614700,31503,583197,1353,15862,380636,194,2219,13648,12967,681,169285
0500000US24041,24,041,Talbot County,37211,2412,34799,23,514,4006,20,142,1160,1156,4,28934
0500000US24025,24,025,Harford County,251025,11069,239956,419,6645,33181,0,775,6999,6556,443,191937
0500000US24027,24,027,Howard County,315327,21200,294127,583,55819,57522,58,1614,11219,10773,446,167312
0500000US24003,24,003,Anne Arundel County,567696,42640,525056,774,20967,91488,352,1458,18439,17977,462,391578
0500000US24005,24,005,Baltimore County,827625,43484,784141,1792,49103,231318,341,1736,19336,18646,690,480515
0500000US24009,24,009,Calvert County,91082,3427,87655,116,1649,10481,38,187,3734,3732,2,71450
0500000US24023,24,023,Garrett County,29376,331,29045,19,114,228,8,0,327,311,16,28349
0500000US24031,24,031,Montgomery County,1040133,200307,839826,1401,151825,183962,454,5682,34084,31055,3029,462418
0500000US24013,24,013,Carroll County,167522,5632,161890,349,2998,5560,31,240,2857,2821,36,149855
0500000US24035,24,035,Queen Anne's County,49355,1871,47484,18,462,3333,0,153,793,752,41,42725
0500000US24037,24,037,St. Mary's County,111531,5521,106010,123,3071,15952,13,176,3478,3439,39,83197
0500000US24017,24,017,Charles County,157671,8757,148914,797,4859,69462,64,399,7662,7517,145,65671
0500000US24019,24,019,Dorchester County,32261,1715,30546,31,335,8639,0,11,1093,1061,32,20437
0500000US24043,24,043,Washington County,149811,7155,142656,175,2643,15460,102,146,4792,4741,51,119338
0500000US24045,24,045,Wicomico County,102172,5198,96974,147,3240,26199,37,113,2456,2382,74,64782
0500000US24015,24,015,Cecil County,102517,4386,98131,157,1480,6556,8,37,2316,2293,23,87577
0500000US24011,24,011,Caroline County,32875,2304,30571,80,218,4511,10,50,727,717,10,24975
0500000US25025,25,025,Suffolk County,791766,179702,612064,1442,68775,159705,225,6825,18442,16506,1936,356650
0500000US25001,25,001,Barnstable County,213690,6228,207462,1048,3167,6130,130,1552,3664,3271,393,191771
0500000US25007,25,007,Dukes County,17313,606,16707,101,64,615,0,271,758,717,41,14898
0500000US25017,25,017,Middlesex County,1595192,125533,1469659,1743,185650,78649,340,9796,36643,33248,3395,1156838
0500000US25003,25,003,Berkshire County,127328,5839,121489,273,2169,3489,56,333,2538,2531,7,112631
0500000US25005,25,005,Bristol County,558905,43042,515863,164,12553,20746,136,10622,13787,11023,2764,457855
0500000US25013,25,013,Hampden County,469116,115479,353637,602,10748,36369,18,980,8055,7711,344,296865
0500000US25023,25,023,Plymouth County,512135,19476,492659,335,6427,46146,166,12961,10499,8335,2164,416125
0500000US25009,25,009,Essex County,781024,158974,622050,776,26765,23933,74,2622,13137,12464,673,554743
0500000US25011,25,011,Franklin County,70935,2766,68169,216,1138,934,65,83,1318,1246,72,64415
0500000US25021,25,021,Norfolk County,698249,30363,667886,747,74864,45399,233,3517,14207,12976,1231,528919
0500000US25015,25,015,Hampshire County,161159,8882,152277,190,8408,4334,63,183,3766,3694,72,135333
0500000US25019,25,019,Nantucket County,11101,505,10596,35,107,570,7,38,392,253,139,9447
0500000US26115,26,115,Monroe County,149699,5261,144438,407,928,3520,7,295,2484,2452,32,136797
0500000US26005,26,005,Allegan County,115250,8392,106858,533,781,1562,0,135,1775,1769,6,102072
0500000US26059,26,059,Hillsdale County,45830,1034,44796,178,173,328,0,23,601,593,8,43493
0500000US26003,26,003,Alger County,9194,137,9057,320,14,692,0,0,325,323,2,7706
0500000US26127,26,127,Oceana County,26417,3913,22504,243,59,275,0,8,293,290,3,21626
0500000US26089,26,089,Leelanau County,21639,938,20701,600,146,79,3,16,374,369,5,19483
0500000US26035,26,035,Clare County,30616,592,30024,140,111,186,0,5,515,513,2,29067
0500000US26083,26,083,Keweenaw County,2130,12,2118,0,2,31,0,0,15,15,0,2070
0500000US26073,26,073,Isabella County,70775,2753,68022,2014,1174,1836,8,94,2426,2364,62,60470
0500000US26139,26,139,Ottawa County,284034,27450,256584,654,7423,4132,46,168,5560,5499,61,238601
0500000US26157,26,157,Tuscola County,53250,1779,51471,151,171,596,0,30,736,729,7,49787
0500000US26007,26,007,Alpena County,28612,382,28230,139,141,148,20,0,347,341,6,27435
0500000US26067,26,067,Ionia County,64176,3032,61144,169,251,2889,6,5,1110,1039,71,56714
0500000US26111,26,111,Midland County,83389,2212,81177,345,1907,1149,40,126,1222,1204,18,76388
0500000US26021,26,021,Berrien County,154807,8340,146467,605,3032,22572,38,223,4059,3940,119,115938
0500000US26135,26,135,Oscoda County,8277,126,8151,52,4,53,4,0,119,119,0,7919
0500000US26039,26,039,Crawford County,13836,265,13571,70,123,84,0,0,185,185,0,13109
0500000US26037,26,037,Clinton County,77896,3506,74390,95,1205,1349,0,4,1588,1588,0,70149
0500000US26057,26,057,Gratiot County,41067,2454,38613,103,156,2203,23,6,692,628,64,35430
0500000US26063,26,063,Huron County,31543,741,30802,73,184,124,0,16,339,336,3,30066
0500000US26091,26,091,Lenawee County,98474,7784,90690,296,284,2421,15,102,2086,1996,90,85486
0500000US26105,26,105,Mason County,28884,1314,27570,217,183,269,0,0,485,414,71,26416
0500000US26117,26,117,Montcalm County,63209,2197,61012,306,253,1332,41,23,1007,918,89,58050
0500000US26149,26,149,St. Joseph County,60897,4710,56187,75,304,1324,30,7,1682,1665,17,52765
0500000US26147,26,147,St. Clair County,159566,5281,154285,226,1062,3345,38,159,3957,3898,59,145498
0500000US26161,26,161,Washtenaw County,365961,16999,348962,679,33053,42619,144,859,14406,14083,323,257202
0500000US26011,26,011,Arenac County,15165,301,14864,184,55,89,0,2,157,155,2,14377
0500000US26027,26,027,Cass County,51460,1949,49511,555,434,2533,21,71,1546,1512,34,44351
0500000US26071,26,071,Iron County,11212,221,10991,173,65,57,0,0,82,82,0,10614
0500000US26143,26,143,Roscommon County,23877,424,23453,219,75,35,0,0,418,418,0,22706
0500000US26163,26,163,Wayne County,1761382,103202,1658180,4498,57117,681837,460,4551,36499,35209,1290,873218
0500000US26023,26,023,Branch County,43584,2019,41565,166,283,965,17,4,642,606,36,39488
0500000US26075,26,075,Jackson County,158913,5523,153390,652,1339,12576,41,134,3957,3827,130,134691
0500000US26097,26,097,Mackinac County,10817,185,10632,1795,78,297,14,5,501,487,14,7942
0500000US26009,26,009,Antrim County,23177,517,22660,153,73,79,0,8,362,362,0,21985
0500000US26061,26,061,Houghton County,36360,572,35788,104,1062,250,22,138,787,764,23,33425
0500000US26069,26,069,Iosco County,25247,537,24710,185,173,168,10,5,429,429,0,23740
0500000US26085,26,085,Lake County,11763,311,11452,113,27,939,0,7,403,395,8,9963
0500000US26119,26,119,Montmorency County,9261,118,9143,82,7,32,1,2,124,124,0,8895
0500000US26141,26,141,Presque Isle County,12797,168,12629,42,60,70,0,17,195,195,0,12245
0500000US26077,26,077,Kalamazoo County,261573,12593,248980,592,6355,27517,56,389,10874,10604,270,203197
0500000US26107,26,107,Mecosta County,43264,958,42306,162,327,1227,7,59,979,959,20,39545
0500000US26103,26,103,Marquette County,66939,1001,65938,546,654,1079,33,15,1887,1847,40,61724
0500000US26123,26,123,Newaygo County,48142,2792,45350,300,160,612,0,42,623,623,0,43613
0500000US26133,26,133,Osceola County,23232,418,22814,192,70,253,0,0,296,296,0,22003
0500000US26137,26,137,Otsego County,24397,412,23985,99,106,97,0,0,641,618,23,23042
0500000US26025,26,025,Calhoun County,134473,6885,127588,867,3095,14087,20,63,4734,4537,197,104722
0500000US26031,26,031,Cheboygan County,25458,351,25107,423,98,215,0,0,901,891,10,23470
0500000US26095,26,095,Luce County,6364,198,6166,327,17,463,2,0,390,368,22,4967
0500000US26081,26,081,Kent County,643140,67179,575961,1482,19213,59543,127,728,18902,18501,401,475966
0500000US26099,26,099,Macomb County,868704,22212,846492,2173,33743,98622,341,1795,18340,17871,469,691478
0500000US26145,26,145,Saginaw County,192778,16151,176627,422,2424,34953,12,215,4622,4547,75,133979
0500000US26155,26,155,Shiawassee County,68493,1995,66498,161,196,396,8,0,1223,1207,16,64514
0500000US26013,26,013,Baraga County,8507,132,8375,762,42,834,2,5,532,532,0,6198
0500000US26017,26,017,Bay County,104786,5503,99283,318,631,1675,0,16,2133,2126,7,94510
0500000US26029,26,029,Charlevoix County,26219,504,25715,378,110,126,20,10,468,446,22,24603
0500000US26045,26,045,Eaton County,109155,5793,103362,484,2526,7024,43,138,2469,2388,81,90678
0500000US26041,26,041,Delta County,36190,461,35729,671,153,106,7,17,1100,1065,35,33675
0500000US26053,26,053,Gogebic County,15414,207,15207,409,53,701,23,0,207,193,14,13814
0500000US26047,26,047,Emmet County,33039,532,32507,958,170,208,30,52,941,917,24,30148
0500000US05147,05,147,Woodruff County,6660,12,6648,0,91,1845,6,0,85,85,0,4621
0500000US05023,05,023,Cleburne County,25230,618,24612,273,152,140,0,0,144,140,4,23903
0500000US05025,05,025,Cleveland County,8226,154,8072,13,3,924,0,0,173,167,6,6959
0500000US05067,05,067,Jackson County,17225,485,16740,17,7,2131,7,15,1306,1299,7,13257
0500000US05057,05,057,Hempstead County,22018,2786,19232,51,17,6655,50,0,377,377,0,12082
0500000US05135,05,135,Sharp County,17043,373,16670,95,19,103,0,0,485,467,18,15968
0500000US05137,05,137,Stone County,12446,236,12210,55,14,9,0,0,334,334,0,11798
0500000US05143,05,143,Washington County,228529,38052,190477,1971,5532,7970,5039,676,6127,6023,104,163162
0500000US05005,05,005,Baxter County,41219,927,40292,129,172,74,13,81,711,711,0,39112
0500000US05003,05,003,Ashley County,20537,1097,19440,50,47,5250,0,5,112,112,0,13976
0500000US05031,05,031,Craighead County,105701,5253,100448,181,1328,14567,200,426,2657,2607,50,81089
0500000US05055,05,055,Greene County,44623,1244,43379,102,129,717,40,41,666,666,0,41684
0500000US05073,05,073,Lafayette County,6915,172,6743,21,35,2516,0,29,67,67,0,4075
0500000US05105,05,105,Perry County,10322,297,10025,60,0,186,0,3,263,253,10,9513
0500000US05107,05,107,Phillips County,19034,343,18691,2,11,11921,0,7,165,153,12,6585
0500000US05111,05,111,Poinsett County,24054,707,23347,43,12,1141,0,0,1207,1207,0,20944
0500000US05133,05,133,Sevier County,17193,5703,11490,322,61,868,50,0,250,250,0,9939
0500000US05149,05,149,Yell County,21573,4314,17259,106,216,434,0,0,218,215,3,16285
0500000US05013,05,013,Calhoun County,5202,206,4996,7,0,1107,10,9,88,88,0,3775
0500000US05019,05,019,Clark County,22385,1050,21335,86,156,5367,8,0,299,299,0,15419
0500000US05011,05,011,Bradley County,10948,1654,9294,0,0,3168,0,20,12,12,0,6094
0500000US05095,05,095,Monroe County,7249,199,7050,36,31,2897,0,0,158,150,8,3928
0500000US05113,05,113,Polk County,20163,1319,18844,299,157,91,0,67,546,538,8,17684
0500000US05103,05,103,Ouachita County,24106,546,23560,48,15,9830,0,0,345,345,0,13322
0500000US05101,05,101,Newton County,7848,73,7775,205,18,2,0,0,168,168,0,7382
0500000US05081,05,081,Little River County,12417,107,12310,143,44,2762,0,0,289,289,0,9072
0500000US05015,05,015,Carroll County,27887,4182,23705,141,334,171,208,0,534,531,3,22317
0500000US05091,05,091,Miller County,43759,1405,42354,283,180,10772,34,88,808,781,27,30189
0500000US06033,06,033,Lake County,64148,12830,51318,2090,642,1426,30,142,1365,1348,17,45623
0500000US06043,06,043,Mariposa County,17540,1909,15631,390,243,166,54,20,633,627,6,14125
0500000US06115,06,115,Yuba County,75493,20990,54503,643,4977,2340,292,126,4040,3982,58,42085
0500000US06013,06,013,Contra Costa County,1133247,288101,845146,2376,182135,93683,5251,3829,54921,53181,1740,502951
0500000US06035,06,035,Lassen County,31185,5834,25351,847,436,2695,205,22,618,559,59,20528
0500000US06083,06,083,Santa Barbara County,443738,200060,243678,1407,22996,7881,482,604,10952,10760,192,199356
0500000US06097,06,097,Sonoma County,501317,132985,368332,2068,19720,7192,1406,2501,17208,16693,515,318237
0500000US06025,06,025,Imperial County,180216,151019,29197,1076,2376,3906,307,120,1639,1598,41,19773
0500000US06051,06,051,Mono County,14174,3866,10308,342,336,40,0,80,276,276,0,9234
0500000US06001,06,001,Alameda County,1643700,369061,1274639,5288,483067,172329,13192,4977,72395,68394,4001,523391
0500000US06067,06,067,Sacramento County,1510023,347025,1162998,5469,231740,144003,16335,6086,76865,73779,3086,682500
0500000US06055,06,055,Napa County,140530,47687,92843,326,11210,2764,264,516,3604,3384,220,74159
0500000US06053,06,053,Monterey County,433212,252588,180624,1046,23647,10606,1963,530,11594,11458,136,131238
0500000US06091,06,091,Sierra County,2930,324,2606,25,0,6,0,0,8,8,0,2567
0500000US06073,06,073,San Diego County,3302833,1106925,2195908,12282,382336,155536,12811,6366,111197,108705,2492,1515380
0500000US06113,06,113,Yolo County,214977,67809,147168,533,29360,5215,919,258,9609,9276,333,101274
0500000US06023,06,023,Humboldt County,135768,15360,120408,5919,4049,1342,369,258,7166,7057,109,101305
0500000US06003,06,003,Alpine County,1146,105,1041,294,8,9,0,0,52,52,0,678
0500000US06045,06,045,Mendocino County,87422,21679,65743,2839,1667,511,170,180,3062,3037,25,57314
0500000US06087,06,087,Santa Cruz County,273765,91676,182089,360,12116,2359,168,554,8992,8851,141,157540
0500000US06037,06,037,Los Angeles County,10098052,4893603,5204449,20307,1451560,795505,24821,29924,223280,209713,13567,2659052
0500000US06065,06,065,Riverside County,2383286,1154517,1228769,10064,147706,144503,5846,5345,58837,56161,2676,856468
0500000US06085,06,085,Santa Clara County,1922200,495455,1426745,3003,685265,45379,6231,4743,66212,62474,3738,615912
0500000US06041,06,041,Marin County,260295,41335,218960,435,14815,5597,292,2453,9559,9282,277,185809
0500000US06093,06,093,Siskiyou County,43540,5336,38204,1283,671,619,120,33,2088,2062,26,33390
0500000US06089,06,089,Shasta County,179085,17605,161480,4014,5326,2140,182,151,6092,5863,229,143575
0500000US06015,06,015,Del Norte County,27424,5340,22084,1841,937,758,17,128,1231,1205,26,17172
0500000US06021,06,021,Glenn County,27897,11504,16393,414,820,223,17,0,412,410,2,14507
0500000US06007,06,007,Butte County,227075,36358,190717,1738,9900,3303,341,406,10639,10350,289,164390
0500000US06063,06,063,Plumas County,18699,1629,17070,387,200,194,41,126,551,551,0,15571
0500000US06079,06,079,San Luis Obispo County,281455,63002,218453,1363,9924,4912,258,244,7178,6955,223,194574
0500000US06029,06,029,Kern County,883053,465842,417211,4202,40273,45053,1153,1039,18461,17011,1450,307030
0500000US06059,06,059,Orange County,3164182,1080195,2083987,6348,629637,50412,8541,5881,87132,82896,4236,1296036
0500000US06009,06,009,Calaveras County,45235,5297,39938,374,568,299,126,52,1614,1595,19,36905
0500000US06101,06,101,Sutter County,95872,29354,66518,676,14532,1793,367,211,4170,3960,210,44769
0500000US06081,06,081,San Mateo County,765935,189002,576933,1151,212474,16838,10272,2476,30675,29042,1633,303047
0500000US06109,06,109,Tuolumne County,53932,6527,47405,747,732,880,125,40,1517,1489,28,43364
0500000US06077,06,077,San Joaquin County,732212,301256,430956,1536,110164,49926,3959,1069,26415,25080,1335,237887
0500000US06005,06,005,Amador County,37829,5132,32697,270,466,749,69,10,1370,1370,0,29763
0500000US08095,08,095,Phillips County,4318,944,3374,11,15,8,0,0,73,73,0,3267
0500000US08007,08,007,Archuleta County,12908,2371,10537,164,133,214,0,23,113,108,5,9890
0500000US08031,08,031,Denver County,693417,209859,483558,3359,25698,62617,835,1455,16884,16368,516,372710
0500000US08061,08,061,Kiowa County,1449,78,1371,0,0,17,0,0,94,94,0,1260
0500000US08055,08,055,Huerfano County,6583,2274,4309,25,0,20,0,10,68,68,0,4186
0500000US08009,08,009,Baca County,3563,381,3182,57,0,35,4,0,48,48,0,3038
0500000US08015,08,015,Chaffee County,19164,1935,17229,42,126,366,0,32,387,354,33,16276
0500000US08047,08,047,Gilpin County,5924,548,5376,135,0,15,0,0,103,103,0,5123
0500000US08063,08,063,Kit Carson County,7635,1466,6169,31,25,195,38,2,26,26,0,5852
0500000US08045,08,045,Garfield County,58538,16487,42051,244,536,228,0,99,866,866,0,40078
0500000US08051,08,051,Gunnison County,16537,1532,15005,119,83,65,22,26,272,267,5,14418
0500000US08059,08,059,Jefferson County,570427,87153,483274,2691,15960,5977,228,923,10627,10178,449,446868
0500000US08079,08,079,Mineral County,823,79,744,0,5,16,0,0,9,3,6,714
0500000US08091,08,091,Ouray County,4722,201,4521,50,21,0,4,0,45,45,0,4401
0500000US08103,08,103,Rio Blanco County,6465,650,5815,39,6,25,16,3,244,244,0,5482
0500000US08115,08,115,Sedgwick County,2350,319,2031,3,36,30,0,0,28,28,0,1934
0500000US08021,08,021,Conejos County,8142,4315,3827,107,10,36,16,23,51,51,0,3584
0500000US08023,08,023,Costilla County,3687,2307,1380,17,55,17,0,0,74,74,0,1217
0500000US08001,08,001,Adams County,497115,197279,299836,2348,18966,15509,598,744,10329,9887,442,251342
0500000US08037,08,037,Eagle County,54357,16140,38217,132,424,474,43,4,639,593,46,36501
0500000US08065,08,065,Lake County,7585,2346,5239,15,95,8,3,0,121,121,0,4997
0500000US08081,08,081,Moffat County,13060,1983,11077,97,0,131,28,0,224,224,0,10597
0500000US08097,08,097,Pitkin County,17909,1777,16132,8,266,266,0,106,169,169,0,15317
0500000US08017,08,017,Cheyenne County,2039,347,1692,0,47,2,3,0,61,55,6,1579
0500000US08025,08,025,Crowley County,5630,1747,3883,61,17,206,0,4,78,78,0,3517
0500000US08033,08,033,Dolores County,1841,108,1733,12,0,0,0,0,47,47,0,1674
0500000US08057,08,057,Jackson County,1296,254,1042,0,0,0,0,0,5,5,0,1037
0500000US08069,08,069,Larimer County,338161,38323,299838,1640,7357,3035,290,375,7019,6765,254,280122
0500000US08083,08,083,Montezuma County,25909,3222,22687,3233,57,44,10,23,493,427,66,18827
0500000US08113,08,113,San Miguel County,7968,820,7148,42,91,16,0,25,89,89,0,6885
0500000US08013,08,013,Boulder County,321030,44266,276764,894,14919,2613,169,637,7729,7531,198,249803
0500000US08071,08,071,Las Animas County,14179,5963,8216,293,104,104,0,12,232,217,15,7471
0500000US08125,08,125,Yuma County,10069,2311,7758,41,0,89,0,3,46,46,0,7579
0500000US08107,08,107,Routt County,24874,1740,23134,116,259,193,5,95,196,196,0,22270
0500000US08117,08,117,Summit County,30429,4352,26077,75,144,261,109,32,424,424,0,25032
0500000US08019,08,019,Clear Creek County,9379,618,8761,8,98,103,7,0,178,178,0,8367
0500000US08029,08,029,Delta County,30346,4595,25751,317,258,157,0,0,310,300,10,24709
0500000US08101,08,101,Pueblo County,164685,70637,94048,969,1116,2795,27,232,2850,2769,81,86059
0500000US08087,08,087,Morgan County,28257,10147,18110,66,166,905,37,0,343,325,18,16593
0500000US08093,08,093,Park County,17392,1051,16341,277,142,24,19,59,313,313,0,15507
0500000US08077,08,077,Mesa County,149998,21629,128369,939,1401,931,362,169,2261,2221,40,122306
0500000US08099,08,099,Prowers County,12052,4532,7520,54,41,134,0,0,119,119,0,7172
0500000US08041,08,041,El Paso County,688153,115664,572489,2241,18864,40940,2442,1652,28354,27585,769,477996
0500000US08121,08,121,Washington County,4840,474,4366,14,22,53,0,0,48,48,0,4229
0500000US08005,08,005,Arapahoe County,636671,121355,515316,2230,36803,65578,1377,1702,20981,20254,727,386645
0500000US08014,08,014,Broomfield County,66120,8069,58051,246,4317,735,0,244,1513,1487,26,50996
0500000US09009,09,009,New Haven County,859339,151361,707978,823,33850,106325,164,2240,18456,17321,1135,546120
0500000US09003,09,003,Hartford County,894730,157785,736945,1398,46327,114565,176,2673,18381,16953,1428,553425
0500000US09015,09,015,Windham County,116538,13368,103170,66,1552,2084,23,95,2555,2516,39,96795
0500000US09007,09,007,Middlesex County,163368,9835,153533,118,4956,8050,0,140,2573,2549,24,137696
0500000US09013,09,013,Tolland County,151269,8086,143183,59,7013,4299,0,298,2911,2877,34,128603
0500000US10003,10,003,New Castle County,555133,54071,501062,1184,30385,135169,168,821,11074,10648,426,322261
0500000US10005,10,005,Sussex County,219540,20064,199476,685,2609,26714,62,518,4213,3978,235,164675
0500000US11001,11,001,District of Columbia,684498,74776,609722,1314,26278,315281,280,2648,15864,15104,760,248057
0500000US12091,12,091,Okaloosa County,200737,18118,182619,937,5887,18978,292,455,7650,7610,40,148420
0500000US12123,12,123,Taylor County,22098,937,21161,75,80,4826,34,84,145,145,0,15917
0500000US12133,12,133,Washington County,24566,887,23679,296,149,3747,112,17,324,315,9,19034
0500000US12031,12,031,Duval County,924229,86184,838045,1766,42474,269513,668,3110,26154,25336,818,494360
0500000US12007,12,007,Bradford County,26979,1068,25911,101,158,5326,0,28,308,308,0,19990
0500000US12009,12,009,Brevard County,576808,57695,519113,1577,13522,55699,492,1722,14411,13668,743,431690
0500000US12019,12,019,Clay County,207291,20037,187254,205,6016,20242,100,780,7683,7509,174,152228
0500000US12067,12,067,Lafayette County,8744,1263,7481,13,0,1339,187,0,136,136,0,5806
0500000US12069,12,069,Lake County,335362,50061,285301,1234,6445,33118,201,1324,6111,5734,377,236868
0500000US12089,12,089,Nassau County,80578,3257,77321,274,821,4816,0,40,985,980,5,70385
0500000US12103,12,103,Pinellas County,957875,90359,867516,2188,31613,95859,905,2948,22281,21164,1117,711722
0500000US12105,12,105,Polk County,668671,143958,524713,1816,11148,98050,298,1758,10556,10185,371,401087
0500000US12111,12,111,St. Lucie County,305591,56661,248930,675,5681,59731,244,425,4995,4826,169,177179
0500000US12043,12,043,Glades County,13363,2790,10573,516,54,1762,0,12,176,148,28,8053
0500000US12051,12,051,Hendry County,40127,21219,18908,571,324,4407,0,87,392,335,57,13127
0500000US12061,12,061,Indian River County,150984,18512,132472,228,1929,13317,58,76,2669,2612,57,114195
0500000US12063,12,063,Jackson County,48472,2314,46158,302,134,13007,58,90,895,879,16,31672
0500000US12099,12,099,Palm Beach County,1446277,316016,1130261,1137,38372,262376,465,5586,22555,20647,1908,799770
0500000US12109,12,109,St. Johns County,235503,15749,219754,585,6378,12445,175,250,4115,4091,24,195806
0500000US12117,12,117,Seminole County,455086,94168,360918,723,19749,48821,257,2069,10236,9452,784,279063
0500000US12086,12,086,Miami-Dade County,2715516,1845646,869870,2321,41372,436864,590,7370,16222,13622,2600,365131
0500000US12005,12,005,Bay County,182482,11453,171029,989,4067,19650,30,675,5967,5938,29,139651
0500000US12035,12,035,Flagler County,107139,10828,96311,120,2701,11094,14,306,1827,1754,73,80249
0500000US12037,12,037,Franklin County,11736,639,11097,8,53,1577,63,176,190,171,19,9030
0500000US12047,12,047,Hamilton County,14269,1332,12937,83,8,4836,0,15,163,163,0,7832
0500000US12077,12,077,Liberty County,8365,484,7881,90,20,1215,0,34,159,159,0,6363
0500000US12119,12,119,Sumter County,120999,6841,114158,336,1027,8684,44,80,1240,1157,83,102747
0500000US12039,12,039,Gadsden County,46017,4659,41358,68,280,25464,15,103,467,447,20,14961
0500000US12059,12,059,Holmes County,19430,533,18897,216,141,1315,71,5,255,244,11,16894
0500000US12071,12,071,Lee County,718679,149116,569563,1181,11224,58965,211,1814,8790,8095,695,487378
0500000US12083,12,083,Marion County,348371,44391,303980,908,5288,42216,206,1051,7580,6893,687,246731
0500000US12021,12,021,Collier County,363922,100061,263861,659,4406,24703,0,559,3301,3180,121,230233
0500000US12095,12,095,Orange County,1321194,408324,912870,1471,66884,262987,696,10823,30660,27197,3463,539349
0500000US12101,12,101,Pasco County,510593,74279,436314,1429,12547,26225,327,1013,8965,8665,300,385808
0500000US12055,12,055,Highlands County,102101,20005,82096,231,1490,9162,15,85,2092,2087,5,69021
0500000US12121,12,121,Suwannee County,43924,3962,39962,42,43,5704,0,0,951,951,0,33222
0500000US12027,12,027,DeSoto County,36399,11352,25047,45,194,4402,46,20,323,296,27,20017
0500000US12013,12,013,Calhoun County,14444,837,13607,157,117,1775,0,31,408,404,4,11119
0500000US12023,12,023,Columbia County,69105,4120,64985,184,625,12099,47,41,1727,1472,255,50262
0500000US12029,12,029,Dixie County,16437,647,15790,38,16,1334,5,0,519,519,0,13878
0500000US12107,12,107,Putnam County,72766,7187,65579,172,406,11591,8,80,1230,1230,0,52092
0500000US12125,12,125,Union County,15239,840,14399,111,85,3302,0,5,268,268,0,10628
0500000US12081,12,081,Manatee County,373853,60515,313338,844,7534,31631,209,391,5419,5058,361,267310
0500000US12075,12,075,Levy County,39961,3269,36692,80,251,3414,0,0,950,950,0,31997
0500000US12003,12,003,Baker County,27785,674,27111,67,206,3770,9,30,389,389,0,22640
0500000US12127,12,127,Volusia County,527634,70582,457052,1656,9158,54722,160,1594,8474,8181,293,381288
0500000US12073,12,073,Leon County,288102,18050,270052,494,10061,88415,68,601,6628,6178,450,163785
0500000US12079,12,079,Madison County,18474,966,17508,70,194,7081,2,0,104,104,0,10057
0500000US12033,12,033,Escambia County,311522,17293,294229,1410,9532,67770,359,373,13500,13299,201,201285
0500000US12053,12,053,Hernando County,182696,23507,159189,515,2257,8689,25,1177,3336,3280,56,143190
0500000US13037,13,037,Calhoun County,6428,299,6129,0,34,3908,0,25,65,65,0,2097
0500000US13193,13,193,Macon County,13480,569,12911,27,63,8168,1,96,167,162,5,4389
0500000US13021,13,021,Bibb County,153490,4923,148567,230,3000,82816,49,248,2727,2497,230,59497
0500000US13197,13,197,Marion County,8484,603,7881,14,89,2563,36,40,110,110,0,5029
0500000US13249,13,249,Schley County,5211,268,4943,0,0,1545,0,0,18,15,3,3380
0500000US13023,13,023,Bleckley County,12775,360,12415,9,28,3570,0,0,19,19,0,8789
0500000US13093,13,093,Dooly County,13905,958,12947,8,15,6824,0,3,168,168,0,5929
0500000US13119,13,119,Franklin County,22514,1003,21511,16,196,2150,0,0,305,305,0,18844
0500000US13103,13,103,Effingham County,58689,2483,56206,75,552,7839,24,294,1232,1232,0,46190
0500000US13171,13,171,Lamar County,18513,438,18075,19,149,5392,0,0,487,487,0,12028
0500000US13107,13,107,Emanuel County,22499,1003,21496,11,4,7694,0,12,420,417,3,13355
0500000US13239,13,239,Quitman County,2276,6,2270,0,138,1192,5,0,59,59,0,876
0500000US13159,13,159,Jasper County,13784,539,13245,8,36,2881,0,0,136,136,0,10184
0500000US13167,13,167,Johnson County,9730,229,9501,0,19,3256,0,0,139,139,0,6087
0500000US13179,13,179,Liberty County,62108,7845,54263,232,1247,24775,312,181,2911,2821,90,24605
0500000US13205,13,205,Mitchell County,22432,1016,21416,26,101,10438,8,5,510,510,0,10328
0500000US13253,13,253,Seminole County,8437,260,8177,0,67,2779,0,7,128,128,0,5196
0500000US13277,13,277,Tift County,40510,4661,35849,36,576,12154,14,26,290,272,18,22753
0500000US13289,13,289,Twiggs County,8284,40,8244,0,9,3510,0,0,160,160,0,4565
0500000US13233,13,233,Polk County,41621,5463,36158,0,155,5082,10,21,920,920,0,29970
0500000US13263,13,263,Talbot County,6378,48,6330,2,33,3687,0,0,25,25,0,2583
0500000US13269,13,269,Taylor County,8193,208,7985,0,124,3150,0,0,19,19,0,4692
0500000US13273,13,273,Terrell County,8859,242,8617,4,203,5195,0,0,66,66,0,3149
0500000US13275,13,275,Thomas County,44730,1651,43079,51,58,16234,16,19,943,927,16,25758
0500000US13279,13,279,Toombs County,27048,3133,23915,4,247,6918,0,131,294,294,0,16321
0500000US13319,13,319,Wilkinson County,9078,251,8827,10,0,3567,6,0,95,95,0,5149
0500000US13017,13,017,Ben Hill County,17154,1042,16112,0,18,6286,9,0,143,143,0,9656
0500000US13033,13,033,Burke County,22550,703,21847,5,61,10952,0,7,204,95,109,10618
0500000US13047,13,047,Catoosa County,66299,1942,64357,220,870,1432,24,0,1362,1362,0,60449
0500000US13053,13,053,Chattahoochee County,10767,1653,9114,34,333,2111,35,49,244,238,6,6308
0500000US13055,13,055,Chattooga County,24817,1230,23587,29,130,2489,0,50,314,282,32,20575
0500000US13073,13,073,Columbia County,147295,9481,137814,227,5828,24274,0,659,4489,4422,67,102337
0500000US13087,13,087,Decatur County,26833,1577,25256,19,90,11160,0,250,182,182,0,13555
0500000US13115,13,115,Floyd County,96824,10422,86402,159,1441,13781,0,563,1561,1449,112,68897
0500000US13117,13,117,Forsyth County,219880,20875,199005,307,25997,6915,34,319,4271,3775,496,161162
0500000US13137,13,137,Habersham County,44289,6401,37888,40,907,1351,86,293,913,906,7,34298
0500000US13185,13,185,Lowndes County,114582,6345,108237,331,2114,41486,91,118,1900,1869,31,62197
0500000US13199,13,199,Meriwether County,21113,449,20664,30,132,8136,0,77,397,389,8,11892
0500000US13207,13,207,Monroe County,27010,631,26379,52,251,6302,0,140,238,238,0,19396
0500000US13261,13,261,Sumter County,30352,1644,28708,18,359,15936,0,13,381,374,7,12001
0500000US13265,13,265,Taliaferro County,1665,26,1639,0,8,1078,0,0,4,4,0,549
0500000US13007,13,007,Baker County,3189,134,3055,7,95,1228,20,0,0,0,0,1705
0500000US13035,13,035,Butts County,23750,751,22999,10,105,6817,0,26,197,192,5,15844
0500000US13043,13,043,Candler County,10827,1252,9575,69,109,2546,0,0,280,126,154,6571
0500000US13045,13,045,Carroll County,116022,7843,108179,369,867,21696,108,1151,2038,2005,33,81950
0500000US13079,13,079,Crawford County,12344,160,12184,0,25,2978,0,0,113,113,0,9068
0500000US13081,13,081,Crisp County,22846,749,22097,0,220,9974,30,8,391,391,0,11474
0500000US13077,13,077,Coweta County,140516,9562,130954,274,2692,24512,21,201,2884,2878,6,100370
0500000US13067,13,067,Cobb County,745057,95619,649438,1030,38662,197992,303,2928,17435,16294,1141,391088
0500000US13083,13,083,Dade County,16227,360,15867,0,181,72,9,21,368,357,11,15216
0500000US13297,13,297,Walton County,90132,3784,86348,157,1050,15269,17,696,1266,1138,128,67893
0500000US13027,13,027,Brooks County,15622,896,14726,0,128,5323,7,34,378,378,0,8856
0500000US13091,13,091,Dodge County,20919,724,20195,2,79,5868,0,0,586,586,0,13660
0500000US13105,13,105,Elbert County,19212,1075,18137,0,20,5854,0,26,49,49,0,12188
0500000US13113,13,113,Fayette County,111369,7981,103388,136,4992,24241,118,757,2896,2729,167,70248
0500000US13165,13,165,Jenkins County,8827,747,8080,17,109,2937,0,0,72,72,0,4945
0500000US13217,13,217,Newton County,106497,5733,100764,169,1132,46165,84,232,2274,2134,140,50708
0500000US13227,13,227,Pickens County,30832,945,29887,217,136,409,13,0,2206,2206,0,26906
0500000US13071,13,071,Colquitt County,45606,8662,36944,168,384,10416,9,16,298,298,0,25653
0500000US13085,13,085,Dawson County,23861,1042,22819,12,148,230,0,12,332,332,0,22085
0500000US13063,13,063,Clayton County,278666,36703,241963,539,14541,189835,72,1530,5714,5487,227,29732
0500000US13139,13,139,Hall County,195961,55153,140808,297,3327,14079,15,197,3120,3065,55,119773
0500000US13141,13,141,Hancock County,8535,164,8371,0,74,6170,14,0,45,45,0,2068
0500000US13189,13,189,McDuffie County,21498,637,20861,0,97,8655,195,0,352,352,0,11562
0500000US13211,13,211,Morgan County,18235,587,17648,37,5,4251,0,40,261,261,0,13054
0500000US13149,13,149,Heard County,11677,312,11365,2,58,1085,20,0,290,290,0,9910
0500000US13095,13,095,Dougherty County,91049,2487,88562,175,834,62701,6,69,1398,1381,17,23379
0500000US13111,13,111,Fannin County,24925,565,24360,26,165,79,28,38,324,324,0,23700
0500000US13153,13,153,Houston County,151682,9976,141706,498,4364,45872,13,359,4363,4313,50,86237
0500000US13175,13,175,Laurens County,47418,1241,46177,44,535,17584,7,408,251,234,17,27348
0500000US13255,13,255,Spalding County,64719,2860,61859,282,627,21697,19,27,997,931,66,38210
0500000US13271,13,271,Telfair County,16115,1893,14222,9,5,6188,0,0,98,86,12,7922
0500000US13291,13,291,Union County,22775,728,22047,151,173,148,0,0,181,181,0,21394
0500000US13303,13,303,Washington County,20461,496,19965,10,124,10806,0,9,242,242,0,8774
0500000US13311,13,311,White County,28928,909,28019,162,169,417,1,295,246,246,0,26729
0500000US13223,13,223,Paulding County,155840,9491,146349,452,1353,28348,46,390,3438,3409,29,112322
0500000US13231,13,231,Pike County,18082,279,17803,0,65,1808,0,10,225,225,0,15695
0500000US13245,13,245,Richmond County,201463,9759,191704,451,3646,112216,428,572,3742,3550,192,70649
0500000US13267,13,267,Tattnall County,25353,2779,22574,50,63,7375,5,111,220,201,19,14750
0500000US13019,13,019,Berrien County,19025,925,18100,26,34,2103,0,2,298,295,3,15637
0500000US13295,13,295,Walker County,68824,1439,67385,84,486,2817,9,190,1109,1060,49,62690
0500000US13135,13,135,Gwinnett County,902298,188608,713690,1221,102668,239090,219,4042,20574,19480,1094,345876
0500000US13013,13,013,Barrow County,76887,8012,68875,125,2791,8685,6,206,1521,1460,61,55541
0500000US13049,13,049,Charlton County,12983,1103,11880,219,107,3309,0,0,262,257,5,7983
0500000US13065,13,065,Clinch County,6743,345,6398,4,29,1862,0,0,96,94,2,4407
0500000US13015,13,015,Bartow County,103620,8631,94989,176,1032,10962,2,335,1781,1573,208,80701
0500000US13097,13,097,Douglas County,141840,13371,128469,141,2218,63998,1,200,2427,2387,40,59484
0500000US13131,13,131,Grady County,24926,2774,22152,124,141,7039,83,0,258,258,0,14507
0500000US13161,13,161,Jeff Davis County,14991,1754,13237,0,39,2444,0,0,49,5,44,10705
0500000US13209,13,209,Montgomery County,9036,589,8447,20,32,2342,0,160,60,57,3,5833
0500000US13221,13,221,Oglethorpe County,14784,647,14137,24,64,2623,0,0,228,228,0,11198
0500000US13243,13,243,Randolph County,7087,96,6991,0,0,4406,0,0,111,111,0,2474
0500000US13247,13,247,Rockdale County,89011,9038,79973,95,1743,46459,319,122,1744,1618,126,29491
0500000US13299,13,299,Ware County,35599,1460,34139,178,403,10528,33,38,343,335,8,22616
0500000US13305,13,305,Wayne County,29767,1853,27914,22,141,5798,0,108,639,618,21,21206
0500000US13309,13,309,Wheeler County,7939,101,7838,36,0,3343,0,0,8,8,0,4451
0500000US13315,13,315,Wilcox County,8846,399,8447,26,0,3122,0,64,67,67,0,5168
0500000US13009,13,009,Baldwin County,45286,997,44289,140,690,19015,0,32,597,577,20,23815
0500000US13031,13,031,Bulloch County,74782,2894,71888,211,1048,20984,186,88,1705,1698,7,47666
0500000US13059,13,059,Clarke County,124602,13272,111330,75,5014,34090,46,254,3002,2815,187,68849
0500000US13101,13,101,Echols County,3994,984,3010,82,0,143,0,12,86,86,0,2687
0500000US13127,13,127,Glynn County,83974,5578,78396,350,1048,21778,57,182,1527,1497,30,53454
0500000US13143,13,143,Haralson County,28956,455,28501,91,219,1347,0,56,422,412,10,26366
0500000US13163,13,163,Jefferson County,15772,576,15196,20,18,8485,0,0,60,58,2,6613
0500000US13169,13,169,Jones County,28548,445,28103,56,213,7000,0,0,384,384,0,20450
0500000US13213,13,213,Murray County,39557,5837,33720,46,152,424,0,5,306,306,0,32787
0500000US13215,13,215,Muscogee County,196670,14858,181812,777,4783,88840,329,635,6403,6057,346,80045
0500000US13241,13,241,Rabun County,16457,1331,15126,91,170,280,0,156,114,114,0,14315
0500000US13259,13,259,Stewart County,6042,1040,5002,9,148,3269,0,46,42,42,0,1488
0500000US13283,13,283,Treutlen County,6777,122,6655,0,0,1833,0,0,16,16,0,4806
0500000US13155,13,155,Irwin County,9268,135,9133,13,36,2734,0,0,116,98,18,6234
0500000US13003,13,003,Atkinson County,8265,2031,6234,60,0,1471,0,9,2,2,0,4692
0500000US13005,13,005,Bacon County,11228,940,10288,0,30,1714,25,0,267,217,50,8252
0500000US13025,13,025,Brantley County,18561,392,18169,23,183,569,3,11,218,218,0,17162
0500000US16087,16,087,Washington County,10025,1718,8307,96,47,17,0,0,235,218,17,7912
0500000US16031,16,031,Cassia County,23615,6417,17198,281,138,46,17,0,184,184,0,16532
0500000US16045,16,045,Gem County,17052,1418,15634,248,114,0,2,0,287,287,0,14983
0500000US16085,16,085,Valley County,10401,190,10211,26,23,9,0,0,52,52,0,10101
0500000US16003,16,003,Adams County,4019,141,3878,50,0,11,8,0,94,94,0,3715
0500000US16069,16,069,Nez Perce County,40155,1547,38608,2304,315,94,41,6,901,878,23,34947
0500000US16055,16,055,Kootenai County,153605,6918,146687,1931,1151,482,219,57,3389,3310,79,139458
0500000US16061,16,061,Lewis County,3845,171,3674,263,54,9,1,14,94,94,0,3239
0500000US16083,16,083,Twin Falls County,83666,13502,70164,578,1346,591,68,5,990,990,0,66586
0500000US16073,16,073,Owyhee County,11455,3048,8407,323,18,50,0,0,206,206,0,7810
0500000US16015,16,015,Boise County,7163,310,6853,49,49,16,0,0,190,185,5,6549
0500000US16023,16,023,Butte County,2602,71,2531,1,0,4,0,0,0,0,0,2526
0500000US16029,16,029,Caribou County,6918,387,6531,6,7,0,0,4,157,156,1,6357
0500000US16001,16,001,Ada County,446052,35838,410214,1805,11694,5682,713,480,11009,10713,296,378831
0500000US16005,16,005,Bannock County,85065,7191,77874,2183,1285,546,138,111,2132,2028,104,71479
0500000US16011,16,011,Bingham County,45551,8186,37365,2385,348,113,2,45,866,855,11,33606
0500000US16025,16,025,Camas County,886,8,878,0,0,0,0,0,2,2,0,876
0500000US16027,16,027,Canyon County,212230,53357,158873,1415,1755,712,476,68,4612,4482,130,149835
0500000US16051,16,051,Jefferson County,27969,2941,25028,154,142,24,14,0,412,412,0,24282
0500000US16057,16,057,Latah County,39239,1690,37549,367,987,382,10,33,896,896,0,34874
0500000US16075,16,075,Payette County,23041,3963,19078,123,145,78,0,0,623,604,19,18109
0500000US16009,16,009,Benewah County,9086,321,8765,762,32,6,22,0,245,245,0,7698
0500000US16033,16,033,Clark County,1077,505,572,96,0,7,0,0,4,4,0,465
0500000US16039,16,039,Elmore County,26433,4406,22027,372,687,669,111,29,867,859,8,19292
0500000US16043,16,043,Fremont County,12965,1628,11337,33,19,37,41,10,194,194,0,11003
0500000US16079,16,079,Shoshone County,12526,439,12087,322,23,55,0,1,228,228,0,11458
0500000US16049,16,049,Idaho County,16337,540,15797,532,80,33,12,0,260,202,58,14880
0500000US15001,15,001,Hawaii County,197658,25014,172644,411,42641,1229,22062,238,46057,45918,139,60006
0500000US15009,15,009,Maui County,165281,18582,146699,202,47385,854,17266,440,30325,30217,108,50227
0500000US15007,15,007,Kauai County,71377,7802,63575,244,22966,466,5622,53,13074,13044,30,21150
0500000US15005,15,005,Kalawao County,75,2,73,2,21,2,19,0,13,13,0,16
0500000US17083,17,083,Jersey County,22069,302,21767,23,47,105,0,2,428,428,0,21162
0500000US17155,17,155,Putnam County,5746,308,5438,0,25,24,0,0,89,85,4,5300
0500000US17039,17,039,De Witt County,16042,430,15612,7,4,76,10,3,318,318,0,15194
0500000US17051,17,051,Fayette County,21724,408,21316,49,107,1043,0,0,109,99,10,20008
0500000US17103,17,103,Lee County,34527,2077,32450,92,210,1754,62,35,450,425,25,29847
0500000US17107,17,107,Logan County,29207,1000,28207,41,218,1833,2,24,823,820,3,25266
0500000US17117,17,117,Macoupin County,45719,536,45183,77,213,422,3,8,494,469,25,43966
0500000US17159,17,159,Richland County,15881,264,15617,45,162,141,0,0,116,116,0,15153
0500000US17165,17,165,Saline County,24231,430,23801,40,185,683,47,13,658,658,0,22175
0500000US17189,17,189,Washington County,14155,201,13954,18,34,117,8,2,168,163,5,13607
0500000US17135,17,135,Montgomery County,29009,504,28505,45,27,1458,13,0,269,244,25,26693
0500000US17195,17,195,Whiteside County,56396,6687,49709,52,269,900,44,72,585,585,0,47787
0500000US17001,17,001,Adams County,66427,1021,65406,178,540,2676,42,72,889,881,8,61009
0500000US17027,17,027,Clinton County,37628,1166,36462,104,214,1308,0,0,394,394,0,34442
0500000US17037,17,037,DeKalb County,104200,11422,92778,38,2566,7749,0,37,1950,1877,73,80438
0500000US17047,17,047,Edwards County,6507,90,6417,0,24,41,0,0,67,67,0,6285
0500000US17079,17,079,Jasper County,9598,24,9574,16,4,97,0,32,99,91,8,9326
0500000US17081,17,081,Jefferson County,38169,969,37200,44,449,3193,0,24,787,774,13,32703
0500000US17197,17,197,Will County,688697,117522,571175,559,36393,75872,140,836,15127,14598,529,442248
0500000US17199,17,199,Williamson County,67299,1749,65550,146,744,2759,0,33,1374,1358,16,60494
0500000US17041,17,041,Douglas County,19714,1424,18290,66,144,105,18,31,103,103,0,17823
0500000US17057,17,057,Fulton County,35418,1043,34375,87,49,1315,10,0,365,356,9,32549
0500000US17061,17,061,Greene County,13218,86,13132,40,25,194,0,0,127,127,0,12746
0500000US17069,17,069,Hardin County,4009,69,3940,11,1,112,0,0,23,23,0,3793
0500000US17073,17,073,Henry County,49464,2773,46691,102,274,848,0,54,590,558,32,44823
0500000US17095,17,095,Knox County,50999,2875,48124,25,509,4349,0,130,786,786,0,42325
0500000US17097,17,097,Lake County,703619,150590,553029,874,52499,46334,308,1265,14152,13284,868,437597
0500000US17127,17,127,Massac County,14430,404,14026,7,22,901,0,0,331,329,2,12765
0500000US17171,17,171,Scott County,5047,62,4985,15,9,8,10,0,44,33,11,4899
0500000US17017,17,017,Cass County,12665,2374,10291,17,47,505,1,13,86,79,7,9622
0500000US17099,17,099,LaSalle County,110401,10473,99928,224,860,2678,21,14,1407,1386,21,94724
0500000US17067,17,067,Hancock County,18112,268,17844,3,69,148,0,0,189,189,0,17435
0500000US17063,17,063,Grundy County,50509,4877,45632,17,401,611,17,216,668,653,15,43702
0500000US17091,17,091,Kankakee County,111061,11317,99744,198,1054,16543,0,120,1681,1681,0,80148
0500000US17043,17,043,DuPage County,931743,132004,799739,504,108353,43312,242,1345,18933,17172,1761,627050
0500000US17167,17,167,Sangamon County,197661,4449,193212,168,3798,24901,83,652,4584,4568,16,159026
0500000US17129,17,129,Menard County,12367,185,12182,16,65,58,38,9,164,164,0,11832
0500000US17031,17,031,Cook County,5223719,1314232,3909487,5210,372825,1213706,1184,10132,88696,82280,6416,2217734
0500000US17141,17,141,Ogle County,51328,5108,46220,145,292,497,13,18,574,574,0,44681
0500000US17137,17,137,Morgan County,34426,816,33610,63,248,2267,1,3,561,534,27,30467
0500000US17177,17,177,Stephenson County,45433,1725,43708,47,366,4469,0,56,1105,1091,14,37665
0500000US17193,17,193,White County,14025,198,13827,5,51,101,4,2,127,127,0,13537
0500000US17203,17,203,Woodford County,38817,695,38122,10,204,240,0,0,573,573,0,37095
0500000US17071,17,071,Henderson County,6884,117,6767,16,48,5,0,0,78,78,0,6620
0500000US17111,17,111,McHenry County,307789,39326,268463,240,8300,4160,27,210,4539,4465,74,250987
0500000US17113,17,113,McLean County,173219,8340,164879,251,8889,14200,13,548,3296,3083,213,137682
0500000US17145,17,145,Perry County,21384,657,20727,22,130,1918,0,35,263,263,0,18359
0500000US17149,17,149,Pike County,15754,195,15559,43,42,234,0,17,126,125,1,15097
0500000US17161,17,161,Rock Island County,145275,18459,126816,315,3698,14107,58,197,3808,3782,26,104633
0500000US17163,17,163,St. Clair County,263463,10507,252956,322,3720,79040,56,643,6209,6117,92,162966
0500000US17185,17,185,Wabash County,11573,271,11302,14,119,93,0,0,158,128,30,10918
0500000US17013,17,013,Calhoun County,4858,57,4801,1,41,17,0,0,31,31,0,4711
0500000US17035,17,035,Cumberland County,10865,114,10751,22,30,9,14,6,162,162,0,10508
0500000US17085,17,085,Jo Daviess County,21834,648,21186,57,95,110,12,8,209,205,4,20695
0500000US17089,17,089,Kane County,530839,168385,362454,489,21011,27979,153,844,7638,7461,177,304340
0500000US17101,17,101,Lawrence County,16189,616,15573,34,43,1440,0,10,335,316,19,13711
0500000US17009,17,009,Brown County,6675,286,6389,6,37,1343,0,4,66,64,2,4933
0500000US17123,17,123,Marshall County,11794,360,11434,11,37,46,18,0,145,145,0,11177
0500000US17075,17,075,Iroquois County,28169,1914,26255,16,91,282,0,108,383,342,41,25375
0500000US17021,17,021,Christian County,33231,533,32698,62,212,417,61,5,336,333,3,31605
0500000US17025,17,025,Clay County,13338,196,13142,20,38,61,0,0,190,190,0,12833
0500000US17059,17,059,Gallatin County,5157,75,5082,27,22,12,0,5,80,80,0,4936
0500000US17077,17,077,Jackson County,58551,2530,56021,102,2003,8604,2,177,1710,1687,23,43423
0500000US17133,17,133,Monroe County,33936,514,33422,17,331,76,0,32,244,208,36,32722
0500000US17143,17,143,Peoria County,184463,8681,175782,514,7250,32208,8,397,6084,5902,182,129321
0500000US17181,17,181,Union County,17127,876,16251,11,58,237,0,81,273,266,7,15591
0500000US17201,17,201,Winnebago County,286174,35640,250534,434,7303,35871,52,368,7223,7117,106,199283
0500000US17147,17,147,Piatt County,16427,213,16214,10,74,90,0,28,186,186,0,15826
0500000US17153,17,153,Pulaski County,5611,124,5487,7,16,1680,0,11,202,200,2,3571
0500000US17169,17,169,Schuyler County,7064,29,7035,7,0,518,0,0,110,110,0,6400
0500000US17175,17,175,Stark County,5500,88,5412,0,61,38,0,0,46,46,0,5267
0500000US17045,17,045,Edgar County,17539,201,17338,12,181,61,0,0,74,74,0,17010
0500000US17005,17,005,Bond County,16712,578,16134,50,196,1043,0,22,118,118,0,14705
0500000US17007,17,007,Boone County,53606,11459,42147,153,633,1084,0,59,848,809,39,39370
0500000US17011,17,011,Bureau County,33381,2995,30386,46,289,304,3,25,337,333,4,29382
0500000US17015,17,015,Carroll County,14562,523,14039,17,107,163,0,12,161,157,4,13579
0500000US17029,17,029,Coles County,51736,1288,50448,85,627,1897,17,7,735,733,2,47080
0500000US17033,17,033,Crawford County,19088,668,18420,14,137,1083,13,3,349,342,7,16821
0500000US18105,18,105,Monroe County,145403,4895,140508,289,9529,4227,19,75,4476,4418,58,121893
0500000US18045,18,045,Fountain County,16486,406,16080,10,88,60,0,0,190,190,0,15732
0500000US18039,18,039,Elkhart County,203604,31761,171843,265,2156,10694,83,599,5211,5107,104,152835
0500000US18025,18,025,Crawford County,10581,151,10430,24,0,33,0,0,185,185,0,10188
0500000US18017,18,017,Cass County,38084,5667,32417,135,646,451,6,9,532,524,8,30638
0500000US18097,18,097,Marion County,944523,96260,848263,1827,29015,259571,245,2630,26271,25536,735,528704
0500000US18021,18,021,Clay County,26268,98,26170,25,63,202,0,0,597,578,19,25283
0500000US18063,18,063,Hendricks County,160940,6016,154924,270,4430,10167,15,744,2601,2465,136,136697
0500000US18047,18,047,Franklin County,22842,25,22817,0,63,25,0,0,25,25,0,22704
0500000US18053,18,053,Grant County,66944,2814,64130,112,547,4890,0,9,1573,1513,60,56999
0500000US18071,18,071,Jackson County,43938,2903,41035,142,877,471,0,58,493,445,48,38994
0500000US18067,18,067,Howard County,82387,2691,79696,376,1072,5740,18,265,1903,1903,0,70322
0500000US18119,18,119,Owen County,20878,259,20619,50,97,100,0,0,275,275,0,20097
0500000US18135,18,135,Randolph County,25076,845,24231,34,27,170,0,189,383,383,0,23428
0500000US18183,18,183,Whitley County,33649,675,32974,109,114,139,0,12,462,405,57,32138
0500000US18013,18,013,Brown County,15034,249,14785,0,76,157,0,0,160,151,9,14392
0500000US18023,18,023,Clinton County,32301,5028,27273,86,102,201,19,10,184,172,12,26671
0500000US18161,18,161,Union County,7153,128,7025,0,71,5,0,0,111,111,0,6838
0500000US18027,18,027,Daviess County,32937,1583,31354,10,44,561,10,18,422,422,0,30289
0500000US18029,18,029,Dearborn County,49501,614,48887,151,264,419,11,80,314,314,0,47648
0500000US18083,18,083,Knox County,37409,717,36692,36,299,1070,47,16,497,497,0,34727
0500000US18093,18,093,Lawrence County,45619,743,44876,248,206,163,17,17,548,535,13,43677
0500000US18123,18,123,Perry County,19141,260,18881,34,95,546,0,8,163,163,0,18035
0500000US18131,18,131,Pulaski County,12660,372,12288,18,80,43,0,0,185,177,8,11962
0500000US18129,18,129,Posey County,25589,296,25293,7,110,377,0,0,229,229,0,24570
0500000US18171,18,171,Warren County,8247,137,8110,18,1,53,0,8,95,95,0,7935
0500000US18165,18,165,Vermillion County,15560,57,15503,48,43,217,0,47,123,123,0,15025
0500000US18003,18,003,Allen County,370016,27170,342846,594,13714,41308,140,340,12079,11722,357,274671
0500000US18031,18,031,Decatur County,26552,515,26037,43,362,167,0,9,253,159,94,25203
0500000US18043,18,043,Floyd County,76809,2421,74388,281,809,4002,0,55,1585,1561,24,67656
0500000US18079,18,079,Jennings County,27727,663,27064,97,55,314,0,0,198,192,6,26400
0500000US18081,18,081,Johnson County,151564,5286,146278,210,4743,3611,12,255,1488,1463,25,135959
0500000US18109,18,109,Morgan County,69727,1053,68674,46,485,212,0,12,850,823,27,67069
0500000US18051,18,051,Gibson County,33596,523,33073,18,137,658,0,21,637,637,0,31602
0500000US18117,18,117,Orange County,19547,301,19246,22,99,260,0,0,224,224,0,18641
0500000US18085,18,085,Kosciusko County,78806,6245,72561,272,933,547,12,329,1032,1003,29,69436
0500000US18099,18,099,Marshall County,46595,4585,42010,5,224,374,0,3,588,569,19,40816
0500000US18163,18,163,Vanderburgh County,181313,4685,176628,206,2196,16961,262,389,4465,4388,77,152149
0500000US18009,18,009,Blackford County,12129,191,11938,40,48,17,0,2,216,216,0,11615
0500000US18143,18,143,Scott County,23743,521,23222,66,129,60,0,11,267,267,0,22689
0500000US18061,18,061,Harrison County,39712,730,38982,110,175,309,0,104,396,370,26,37888
0500000US18091,18,091,LaPorte County,110552,7136,103416,318,612,12154,5,92,2317,2271,46,87918
0500000US18169,18,169,Wabash County,31631,805,30826,191,92,304,0,0,350,320,30,29889
0500000US18073,18,073,Jasper County,33449,1999,31450,0,139,254,0,0,404,396,8,30653
0500000US18101,18,101,Martin County,10210,107,10103,34,13,80,0,9,54,54,0,9913
0500000US18127,18,127,Porter County,168041,16449,151592,277,2294,5620,121,72,2718,2664,54,140490
0500000US18145,18,145,Shelby County,44399,1844,42555,41,290,481,0,104,628,628,0,41011
0500000US18137,18,137,Ripley County,28425,512,27913,97,252,144,0,34,240,225,15,27146
0500000US18147,18,147,Spencer County,20526,589,19937,43,57,149,13,0,180,173,7,19495
0500000US18153,18,153,Sullivan County,20792,357,20435,11,105,799,0,0,385,385,0,19135
0500000US18159,18,159,Tipton County,15218,412,14806,0,38,25,61,0,210,210,0,14472
0500000US18157,18,157,Tippecanoe County,189294,15486,173808,332,15320,9445,74,258,3790,3645,145,144589
0500000US18167,18,167,Vigo County,107693,2826,104867,193,2022,7013,48,121,3208,3129,79,92262
0500000US18173,18,173,Warrick County,61928,1122,60806,88,1680,1072,3,34,611,562,49,57318
0500000US18057,18,057,Hamilton County,316095,12280,303815,371,18063,11649,95,432,7127,6806,321,266078
0500000US18033,18,033,DeKalb County,42704,1188,41516,35,141,71,0,0,670,670,0,40599
0500000US18087,18,087,LaGrange County,38942,1544,37398,19,67,31,5,10,550,542,8,36716
0500000US18005,18,005,Bartholomew County,81893,5423,76470,173,5701,1419,38,218,1498,1338,160,67423
0500000US18139,18,139,Rush County,16704,266,16438,0,21,257,0,16,138,138,0,16006
0500000US18011,18,011,Boone County,64321,1842,62479,75,1730,1024,0,81,949,917,32,58620
0500000US18049,18,049,Fulton County,20212,1029,19183,93,78,204,12,12,183,183,0,18601
0500000US18089,18,089,Lake County,486849,90954,395895,893,6540,115090,105,721,8188,7840,348,264358
0500000US18107,18,107,Montgomery County,38276,1827,36449,74,314,303,8,7,497,496,1,35246
0500000US18113,18,113,Noble County,47451,4858,42593,21,302,243,0,0,643,586,57,41384
0500000US18001,18,001,Adams County,35195,1588,33607,6,133,392,0,90,69,64,5,32917
0500000US18041,18,041,Fayette County,23259,267,22992,0,44,569,0,0,127,111,16,22252
0500000US19055,19,055,Delaware County,17258,254,17004,55,48,48,0,1,154,154,0,16698
0500000US19185,19,185,Wayne County,6413,55,6358,19,2,67,0,0,99,99,0,6171
0500000US19113,19,113,Linn County,222121,7084,215037,352,5174,11539,264,491,5311,5236,75,191906
0500000US19163,19,163,Scott County,172288,11370,160918,490,4650,12815,30,252,4438,4365,73,138243
0500000US19141,19,141,O'Brien County,13911,651,13260,28,127,125,4,0,69,69,0,12907
0500000US19011,19,011,Benton County,25626,371,25255,47,85,155,0,6,232,232,0,24730
0500000US19061,19,061,Dubuque County,96802,2315,94487,85,1157,3263,380,137,1294,1294,0,88171
0500000US19079,19,079,Hamilton County,15110,901,14209,4,459,206,24,0,21,21,0,13495
0500000US19151,19,151,Pocahontas County,6898,253,6645,25,105,44,0,0,42,42,0,6429
0500000US19175,19,175,Union County,12453,365,12088,20,164,63,8,0,103,103,0,11730
0500000US19177,19,177,Van Buren County,7223,107,7116,0,9,35,0,0,96,96,0,6976
0500000US19159,19,159,Ringgold County,4984,119,4865,18,47,3,0,0,30,26,4,4767
0500000US19001,19,001,Adair County,7124,135,6989,0,31,27,0,0,64,64,0,6867
0500000US19009,19,009,Audubon County,5637,37,5600,4,26,2,0,0,107,107,0,5461
0500000US19039,19,039,Clarke County,9282,1227,8055,8,16,6,0,0,53,53,0,7972
0500000US19051,19,051,Davis County,8885,124,8761,0,62,5,0,0,85,85,0,8609
0500000US19093,19,093,Ida County,6916,152,6764,35,36,0,0,0,72,72,0,6621
0500000US19107,19,107,Keokuk County,10200,166,10034,12,27,39,5,0,96,96,0,9855
0500000US19135,19,135,Monroe County,7863,201,7662,0,10,5,0,109,186,186,0,7352
0500000US19179,19,179,Wapello County,35315,3763,31552,53,376,1122,174,51,519,519,0,29257
0500000US19167,19,167,Sioux County,34825,3655,31170,21,248,124,20,7,410,410,0,30340
0500000US19025,19,025,Calhoun County,9780,182,9598,62,30,121,0,4,140,140,0,9241
0500000US19031,19,031,Cedar County,18445,358,18087,29,59,136,0,0,220,220,0,17643
0500000US19033,19,033,Cerro Gordo County,42984,2034,40950,127,482,745,8,18,476,476,0,39094
0500000US19073,19,073,Greene County,9003,252,8751,12,59,25,0,8,105,105,0,8542
0500000US19083,19,083,Hardin County,17127,735,16392,169,74,217,3,7,158,141,17,15764
0500000US19117,19,117,Lucas County,8597,153,8444,1,0,13,0,0,22,22,0,8408
0500000US19189,19,189,Winnebago County,10571,464,10107,56,131,136,0,0,76,69,7,9708
0500000US19147,19,147,Palo Alto County,9055,241,8814,16,47,197,0,0,60,60,0,8494
0500000US19007,19,007,Appanoose County,12510,239,12271,22,68,74,0,0,169,169,0,11938
0500000US19095,19,095,Iowa County,16207,430,15777,7,40,148,0,5,127,127,0,15450
0500000US19099,19,099,Jasper County,36891,792,36099,68,176,704,56,0,481,481,0,34614
0500000US19191,19,191,Winneshiek County,20401,446,19955,18,270,193,0,1,58,58,0,19415
0500000US19157,19,157,Poweshiek County,18605,597,18008,0,396,345,9,0,218,218,0,17040
0500000US19127,19,127,Marshall County,40271,8581,31690,44,1446,357,14,6,949,938,11,28874
0500000US19015,19,015,Boone County,26399,685,25714,59,98,135,93,0,405,405,0,24924
0500000US19017,19,017,Bremer County,24782,380,24402,55,277,247,11,18,192,192,0,23602
0500000US19089,19,089,Howard County,9264,146,9118,0,4,29,0,4,128,128,0,8953
0500000US19063,19,063,Emmet County,9551,913,8638,28,36,168,0,0,43,43,0,8363
0500000US19081,19,081,Hancock County,10888,453,10435,26,18,70,0,0,142,142,0,10179
0500000US19121,19,121,Madison County,15890,331,15559,13,181,37,0,0,154,154,0,15174
0500000US19125,19,125,Marion County,33207,629,32578,63,313,197,0,3,557,557,0,31445
0500000US19197,19,197,Wright County,12804,1481,11323,5,39,88,0,0,165,165,0,11026
0500000US39097,39,097,Madison County,43988,858,43130,96,523,2568,5,9,938,938,0,38991
0500000US39119,39,119,Muskingum County,86076,948,85128,139,306,2596,19,224,3006,2843,163,78838
0500000US27037,27,037,Dakota County,418201,29186,389015,1096,19736,24310,158,752,12377,12178,199,330586
0500000US27083,27,083,Lyon County,25839,1721,24118,67,1056,869,3,0,322,322,0,21801
0500000US27129,27,129,Renville County,14721,1228,13493,186,84,67,0,0,160,160,0,12996
0500000US27031,27,031,Cook County,5311,120,5191,455,47,24,0,0,108,106,2,4557
0500000US27093,27,093,Meeker County,23079,883,22196,18,65,128,11,13,223,223,0,21738
0500000US27113,27,113,Pennington County,14184,507,13677,247,140,153,1,10,228,228,0,12898
0500000US27167,27,167,Wilkin County,6343,52,6291,109,0,48,0,0,190,190,0,5944
0500000US27027,27,027,Clay County,62801,2796,60005,898,635,1905,5,13,1418,1393,25,55131
0500000US27045,27,045,Fillmore County,20888,322,20566,9,106,102,2,10,174,174,0,20163
0500000US27119,27,119,Polk County,31591,2016,29575,404,304,597,11,0,668,668,0,27591
0500000US27135,27,135,Roseau County,15462,192,15270,240,426,134,6,3,213,213,0,14248
0500000US27165,27,165,Watonwan County,10973,2693,8280,9,130,89,0,0,68,68,0,7984
0500000US27011,27,011,Big Stone County,5016,80,4936,3,0,2,0,2,37,37,0,4892
0500000US27021,27,021,Cass County,29022,621,28401,3256,178,122,13,1,735,729,6,24096
0500000US27049,27,049,Goodhue County,46217,1543,44674,470,352,519,0,1,736,731,5,42596
0500000US27063,27,063,Jackson County,10047,348,9699,10,290,13,0,0,75,75,0,9311
0500000US27105,27,105,Nobles County,21839,5931,15908,87,1418,986,5,0,304,302,2,13108
0500000US27141,27,141,Sherburne County,93231,2369,90862,468,1229,2045,0,121,1637,1611,26,85362
0500000US27019,27,019,Carver County,100416,4156,96260,204,2705,1656,5,104,1968,1892,76,89618
0500000US27061,27,061,Itasca County,45203,638,44565,1603,186,218,2,0,1023,985,38,41533
0500000US27123,27,123,Ramsey County,541493,40569,500924,2950,76809,62495,156,1036,19505,19069,436,337973
0500000US27169,27,169,Winona County,50847,1459,49388,140,1341,681,9,42,753,736,17,46422
0500000US28089,28,089,Madison County,103498,3054,100444,200,2646,39296,7,219,612,549,63,57464
0500000US28091,28,091,Marion County,25202,390,24812,73,122,8118,12,64,72,72,0,16351
0500000US48449,48,449,Titus County,32730,14015,18715,84,333,2953,0,40,434,410,24,14871
0500000US48291,48,291,Liberty County,81862,19098,62764,311,500,8062,8,37,1021,989,32,52825
0500000US48497,48,497,Wise County,64639,12300,52339,258,281,759,114,2,1057,982,75,49868
0500000US48249,48,249,Jim Wells County,41192,33060,8132,28,253,254,63,20,82,82,0,7432
0500000US48127,48,127,Dimmit County,10663,9244,1419,0,402,5,0,0,4,0,4,1008
0500000US48157,48,157,Fort Bend County,739342,179653,559689,1652,146020,149334,141,1583,11645,9851,1794,249314
0500000US48235,48,235,Irion County,1524,374,1150,0,0,54,0,0,10,10,0,1086
0500000US48097,48,097,Cooke County,39571,7043,32528,221,357,967,17,40,947,947,0,29979
0500000US48115,48,115,Dawson County,12964,7402,5562,56,6,763,0,0,107,89,18,4630
0500000US48051,48,051,Burleson County,17863,3657,14206,52,40,2240,0,8,249,230,19,11617
0500000US48245,48,245,Jefferson County,255210,51461,203749,428,9401,85589,114,251,3097,2508,589,104869
0500000US48359,48,359,Oldham County,2090,353,1737,1,10,100,0,0,67,67,0,1559
0500000US48141,48,141,El Paso County,837654,690189,147465,2213,9163,25430,1022,425,7100,6869,231,102112
0500000US48443,48,443,Terrell County,862,548,314,2,0,23,0,0,24,24,0,265
0500000US48463,48,463,Uvalde County,27009,19247,7762,107,271,86,0,5,70,66,4,7223
0500000US48009,48,009,Archer County,8789,727,8062,27,47,76,0,0,140,140,0,7772
0500000US48215,48,215,Hidalgo County,849389,781681,67708,614,7779,3619,118,254,1025,774,251,54299
0500000US48425,48,425,Somervell County,8743,1648,7095,27,35,54,60,6,2,2,0,6911
0500000US48207,48,207,Haskell County,5809,1665,4144,33,44,192,0,7,110,110,0,3758
0500000US48333,48,333,Mills County,4902,968,3934,10,5,10,0,0,8,8,0,3901
0500000US48351,48,351,Newton County,14057,497,13560,21,166,2771,0,0,267,267,0,10335
0500000US49045,49,045,Tooele County,65185,7933,57252,396,494,329,367,33,1274,1261,13,54359
0500000US49043,49,043,Summit County,40511,4662,35849,88,667,304,10,28,520,520,0,34232
0500000US49031,49,031,Piute County,1904,34,1870,2,0,2,0,1,11,11,0,1854
0500000US49001,49,001,Beaver County,6443,729,5714,62,16,0,0,0,25,25,0,5611
0500000US49039,49,039,Sanpete County,29366,2829,26537,262,140,275,152,17,458,458,0,25233
0500000US49049,49,049,Utah County,590440,68285,522155,2180,8542,3210,4716,751,14555,14266,289,488201
0500000US50011,50,011,Franklin County,49025,742,48283,254,174,292,0,233,1280,1275,5,46050
0500000US50003,50,003,Bennington County,35920,675,35245,62,390,136,15,26,723,693,30,33893
0500000US50009,50,009,Essex County,6208,83,6125,20,35,62,0,4,80,80,0,5924
0500000US51530,51,530,Buena Vista city,6399,62,6337,6,275,381,8,0,33,33,0,5634
0500000US51730,51,730,Petersburg city,31827,1522,30305,79,311,24486,16,66,567,555,12,4780
0500000US51600,51,600,Fairfax city,23865,4039,19826,23,4060,1099,0,28,1064,949,115,13552
0500000US51683,51,683,Manassas city,41457,14863,26594,148,2235,5492,34,101,1259,1186,73,17325
0500000US51800,51,800,Suffolk city,89160,3764,85396,140,1666,36669,14,149,2624,2499,125,44134
0500000US51041,51,041,Chesterfield County,339447,28910,310537,931,11316,76417,79,720,9446,9307,139,211628
0500000US51093,51,093,Isle of Wight County,36372,1075,35297,99,348,7944,22,0,1142,1142,0,25742
0500000US51620,51,620,Franklin city,8211,90,8121,0,27,4833,0,0,212,212,0,3049
0500000US51540,51,540,Charlottesville city,47042,2531,44511,129,3356,8773,23,44,1263,1221,42,30923
0500000US51087,51,087,Henrico County,325642,17959,307683,535,26501,95769,112,949,9083,8779,304,174734
0500000US51101,51,101,King William County,16497,257,16240,141,207,2700,0,57,562,562,0,12573
0500000US51109,51,109,Louisa County,35380,986,34394,83,252,5207,0,260,1254,1254,0,27338
0500000US51147,51,147,Prince Edward County,22956,880,22076,63,143,7326,0,0,383,326,57,14161
0500000US51159,51,159,Richmond County,8878,603,8275,37,25,2441,0,0,373,342,31,5399
0500000US51177,51,177,Spotsylvania County,131412,12308,119104,350,3317,20564,131,433,3916,3845,71,90393
0500000US51043,51,043,Clarke County,14365,748,13617,6,102,684,0,0,398,398,0,12427
0500000US51117,51,117,Mecklenburg County,30847,888,29959,63,34,10983,3,15,315,315,0,18546
0500000US51015,51,015,Augusta County,74701,1970,72731,151,453,3030,29,43,928,920,8,68097
0500000US51051,51,051,Dickenson County,14960,133,14827,4,14,99,0,0,98,98,0,14612
0500000US51107,51,107,Loudoun County,385143,52119,333024,832,68745,27568,260,2088,14577,13690,887,218954
0500000US51161,51,161,Roanoke County,93583,2731,90852,91,2708,5290,17,62,2040,1866,174,80644
0500000US51570,51,570,Colonial Heights city,17593,1011,16582,48,649,2484,0,48,492,484,8,12861
0500000US51021,51,021,Bland County,6447,48,6399,0,4,119,0,0,65,65,0,6211
0500000US51029,51,029,Buckingham County,17004,408,16596,86,56,5771,0,0,287,287,0,10396
0500000US51580,51,580,Covington city,5582,144,5438,0,74,710,8,0,113,113,0,4533
0500000US51810,51,810,Virginia Beach city,450135,36043,414092,908,29330,83234,284,784,20264,19804,460,279288
0500000US51640,51,640,Galax city,6638,1099,5539,0,19,477,0,19,25,25,0,4999
0500000US51193,51,193,Westmoreland County,17638,1110,16528,95,100,4621,1,13,423,423,0,11275
0500000US51155,51,155,Pulaski County,34234,584,33650,11,244,1575,0,56,667,667,0,31097
0500000US51590,51,590,Danville city,41512,1711,39801,24,453,20186,30,32,1212,1129,83,17864
0500000US51009,51,009,Amherst County,31882,774,31108,123,152,5665,22,0,1195,1189,6,23951
0500000US51017,51,017,Bath County,4393,165,4228,0,16,78,0,0,101,101,0,4033
0500000US51700,51,700,Newport News city,180145,15798,164347,356,5626,71563,327,968,7293,7049,244,78214
0500000US51680,51,680,Lynchburg city,80131,3194,76937,180,2172,22739,24,249,1629,1528,101,49944
0500000US51690,51,690,Martinsville city,13101,703,12398,89,33,6077,0,0,264,264,0,5935
0500000US51057,51,057,Essex County,11036,390,10646,103,69,4281,0,6,138,138,0,6049
0500000US51790,51,790,Staunton city,24452,729,23723,60,350,2790,0,36,665,665,0,19822
0500000US51750,51,750,Radford city,17630,512,17118,4,271,1708,7,10,478,428,50,14640
0500000US51045,51,045,Craig County,5113,2,5111,0,0,7,0,0,12,12,0,5092
0500000US51071,51,071,Giles County,16814,285,16529,0,35,363,21,0,142,142,0,15968
0500000US51157,51,157,Rappahannock County,7332,263,7069,13,99,354,0,0,71,71,0,6532
0500000US54085,54,085,Ritchie County,9932,52,9880,0,0,7,0,58,28,28,0,9787
0500000US54043,54,043,Lincoln County,21078,180,20898,0,34,84,10,0,141,141,0,20629
0500000US54079,54,079,Putnam County,56652,644,56008,48,376,663,33,4,753,753,0,54131
0500000US54005,54,005,Boone County,22817,52,22765,8,53,209,0,4,192,192,0,22299
0500000US54051,54,051,Marshall County,31645,319,31326,131,78,310,34,0,161,159,2,30612
0500000US54093,54,093,Tucker County,7027,28,6999,0,30,16,0,25,85,85,0,6843
0500000US54087,54,087,Roane County,14205,150,14055,18,14,12,0,16,231,231,0,13764
0500000US54107,54,107,Wood County,85556,948,84608,142,412,1139,31,8,1419,1210,209,81457
0500000US54053,54,053,Mason County,26939,184,26755,22,40,110,0,25,493,417,76,26065
0500000US54073,54,073,Pleasants County,7507,44,7463,0,0,16,0,0,72,72,0,7375
0500000US54037,54,037,Jefferson County,56179,3111,53068,124,827,3524,0,398,1299,1277,22,46896
0500000US54045,54,045,Logan County,33801,303,33498,117,34,558,6,0,355,355,0,32428
0500000US53031,53,031,Jefferson County,30856,1102,29754,613,532,231,53,10,953,935,18,27362
0500000US53049,53,049,Pacific County,21281,2009,19272,271,387,72,126,20,904,904,0,17492
0500000US53059,53,059,Skamania County,11620,720,10900,246,129,103,18,16,178,178,0,10210
0500000US53009,53,009,Clallam County,74487,4640,69847,3353,1105,750,47,311,2492,2380,112,61789
0500000US53039,53,039,Klickitat County,21396,2581,18815,647,142,46,0,0,394,394,0,17586
0500000US53017,53,017,Douglas County,41371,12948,28423,284,296,133,85,52,886,776,110,26687
0500000US53053,53,053,Pierce County,859840,91436,768404,9254,52670,55321,11824,1376,58860,57937,923,579099
0500000US53071,53,071,Walla Walla County,60236,12789,47447,253,974,1031,90,114,1682,1646,36,43303
0500000US53061,53,061,Snohomish County,786620,78883,707737,5859,81032,21751,4180,1484,40226,39167,1059,553205
0500000US53067,53,067,Thurston County,274684,23964,250720,3575,15668,8054,2338,365,13566,13383,183,207154
0500000US53011,53,011,Clark County,465384,43347,422037,2260,20382,7386,3515,1029,20188,20067,121,367277
0500000US53001,53,001,Adams County,19452,12246,7206,79,182,65,0,0,169,165,4,6711
0500000US53057,53,057,Skagit County,123907,22677,101230,1892,2385,859,280,105,3322,3259,63,92387
0500000US53043,53,043,Lincoln County,10435,341,10094,136,72,71,32,0,230,227,3,9553
0500000US55119,55,119,Taylor County,20356,404,19952,50,32,94,0,0,229,229,0,19547
0500000US55099,55,099,Price County,13490,239,13251,122,82,102,110,9,107,106,1,12719
0500000US55079,55,079,Milwaukee County,954209,140575,813634,4647,40443,249011,183,1403,24224,23568,656,493723
0500000US55033,55,033,Dunn County,44498,817,43681,65,1149,246,0,26,838,778,60,41357
0500000US55045,55,045,Green County,36864,1110,35754,74,235,162,16,13,443,443,0,34811
0500000US55115,55,115,Shawano County,41009,1119,39890,2982,120,154,7,3,987,985,2,35637
0500000US55078,55,078,Menominee County,4579,258,4321,3718,21,21,0,0,114,114,0,447
0500000US55011,55,011,Buffalo County,13167,273,12894,28,12,74,0,2,152,150,2,12626
0500000US55063,55,063,La Crosse County,117850,2182,115668,393,5157,1682,36,90,2209,2209,0,106101
0500000US55035,55,035,Eau Claire County,102991,2448,100543,397,3882,880,364,33,2037,1979,58,92950
0500000US55095,55,095,Polk County,43349,818,42531,431,206,172,14,21,454,439,15,41233
0500000US55133,55,133,Waukesha County,398879,18469,380410,689,13745,6236,130,247,5133,4951,182,354230
0500000US55125,55,125,Vilas County,21593,534,21059,1806,124,56,9,26,712,711,1,18326
0500000US55057,55,057,Juneau County,26419,788,25631,393,141,607,5,12,235,228,7,24238
0500000US55131,55,131,Washington County,134535,4181,130354,262,1679,1643,30,70,1510,1429,81,125160
0500000US55025,55,025,Dane County,529843,33285,496558,1345,30974,26683,167,551,13990,13516,474,422848
0500000US55039,55,039,Fond du Lac County,102315,5125,97190,472,1367,1409,8,184,1708,1624,84,92042
0500000US55091,55,091,Pepin County,7262,121,7141,10,24,28,6,0,56,56,0,7017
0500000US55097,55,097,Portage County,70599,2224,68375,228,1999,499,11,137,1079,983,96,64422
0500000US56023,56,023,Lincoln County,19011,871,18140,89,56,18,4,0,409,363,46,17564
0500000US56021,56,021,Laramie County,97692,14138,83554,644,1083,2267,110,44,2340,2340,0,77066
0500000US01093,01,093,Marion County,29965,752,29213,122,49,1047,0,0,436,436,0,27559
0500000US01073,01,073,Jefferson County,659892,25048,634844,1265,10169,280748,206,1465,10129,9643,486,330862
0500000US01059,01,059,Franklin County,31542,5333,26209,159,119,1338,0,17,263,263,0,24313
0500000US01019,01,019,Cherokee County,25853,398,25455,236,42,1267,0,0,180,180,0,23730
0500000US01047,01,047,Dallas County,40029,412,39617,10,224,28119,4,0,236,227,9,11024
0500000US01087,01,087,Macon County,19054,328,18726,43,50,15583,0,9,69,69,0,2972
0500000US01117,01,117,Shelby County,211261,12125,199136,468,4249,25166,47,471,3677,3566,111,165058
0500000US01003,01,003,Baldwin County,208107,9353,198754,1398,1668,19529,9,410,2972,2620,352,172768
0500000US01069,01,069,Houston County,104352,3437,100915,277,848,27887,13,75,1989,1909,80,69826
0500000US01125,01,125,Tuscaloosa County,206213,7437,198776,283,3282,65058,73,114,2199,2135,64,127767
0500000US01027,01,027,Clay County,13378,415,12963,119,18,1971,0,26,89,89,0,10740
0500000US01109,01,109,Pike County,33403,263,33140,209,715,12661,3,21,766,766,0,18765
0500000US01037,01,037,Coosa County,10855,50,10805,8,0,3713,0,0,0,0,0,7084
0500000US01065,01,065,Hale County,14887,130,14757,29,39,8743,0,16,32,32,0,5898
0500000US01053,01,053,Escambia County,37328,838,36490,1435,135,11912,72,39,417,411,6,22480
0500000US01013,01,013,Butler County,20025,67,19958,2,231,9027,0,0,314,314,0,10384
0500000US01105,01,105,Perry County,9486,89,9397,6,21,6569,0,3,0,0,0,2798
0500000US01035,01,035,Conecuh County,12514,105,12409,56,18,5961,0,2,98,98,0,6274
0500000US01007,01,007,Bibb County,22527,547,21980,8,37,4974,0,0,160,160,0,16801
0500000US01017,01,017,Chambers County,33826,768,33058,97,405,13319,0,18,347,347,0,18872
0500000US01057,01,057,Fayette County,16585,285,16300,0,108,1858,6,0,286,286,0,14042
0500000US01009,01,009,Blount County,57645,5261,52384,124,198,820,18,174,818,818,0,50232
0500000US01001,01,001,Autauga County,55200,1528,53672,159,568,10475,5,41,1012,1012,0,41412
0500000US01061,01,061,Geneva County,26491,1027,25464,191,109,2468,4,0,457,457,0,22235
0500000US02261,02,261,Valdez-Cordova Census Area,9301,466,8835,1186,327,25,57,25,737,720,17,6478
0500000US02105,02,105,Hoonah-Angoon Census Area,2132,142,1990,769,60,65,3,0,172,172,0,921
0500000US02275,02,275,Wrangell City and Borough,2484,121,2363,434,69,2,9,0,207,207,0,1642
0500000US04019,04,019,Pima County,1019722,376826,642896,25076,28133,32824,1374,1180,23160,22425,735,531149
0500000US04007,04,007,Gila County,53400,9992,43408,8410,471,305,0,0,887,831,56,33335
0500000US04003,04,003,Cochise County,126279,44598,81681,1253,2333,4455,420,291,3217,3061,156,69712
0500000US04001,04,001,Apache County,71522,4445,67077,52307,286,513,14,21,834,800,34,13102
0500000US04025,04,025,Yavapai County,224645,32461,192184,2659,2166,1224,191,132,4585,4502,83,181227
0500000US04017,04,017,Navajo County,108705,12329,96376,47144,685,788,87,117,2482,2441,41,45073
0500000US05119,05,119,Pulaski County,393463,24078,369385,831,8428,142917,122,881,8821,8430,391,207385
0500000US05021,05,021,Clay County,15061,300,14761,64,0,93,0,0,219,214,5,14385
0500000US05039,05,039,Dallas County,7432,229,7203,31,26,3088,15,0,86,86,0,3957
0500000US05121,05,121,Randolph County,17603,344,17259,69,0,201,0,0,351,344,7,16638
0500000US05009,05,009,Boone County,37288,899,36389,289,192,156,36,2,654,654,0,35060
0500000US05063,05,063,Independence County,37264,2305,34959,76,236,670,7,0,816,816,0,33154
0500000US05053,05,053,Grant County,18086,481,17605,33,9,528,0,0,263,263,0,16772
0500000US05045,05,045,Faulkner County,122416,4956,117460,402,1624,13872,163,419,2686,2630,56,98294
0500000US05089,05,089,Marion County,16438,366,16072,137,71,145,0,0,212,212,0,15507
0500000US05129,05,129,Searcy County,7923,183,7740,117,96,54,0,0,84,84,0,7389
0500000US05033,05,033,Crawford County,62472,4715,57757,980,1154,867,9,45,1864,1864,0,52838
0500000US05059,05,059,Hot Spring County,33520,1148,32372,22,141,4032,10,0,483,422,61,27684
0500000US05087,05,087,Madison County,16076,896,15180,181,162,11,59,16,352,329,23,14399
0500000US05061,05,061,Howard County,13389,1631,11758,14,34,2761,14,22,260,260,0,8653
0500000US05093,05,093,Mississippi County,42831,1728,41103,21,236,15066,25,15,686,686,0,25054
0500000US05139,05,139,Union County,39732,1540,38192,335,227,12968,0,73,411,400,11,24178
0500000US39055,39,055,Geauga County,93961,1361,92600,136,565,1149,0,23,861,850,11,89866
0500000US39085,39,085,Lake County,230052,9861,220191,277,2813,9112,18,181,3982,3887,95,203808
0500000US39023,39,023,Clark County,135198,4512,130686,173,836,10565,96,100,5079,5067,12,113837
0500000US39075,39,075,Holmes County,43859,409,43450,14,85,45,0,16,364,348,16,42926
0500000US39111,39,111,Monroe County,14090,150,13940,5,57,39,0,2,131,131,0,13706
0500000US39165,39,165,Warren County,226564,6038,220526,146,12340,7526,0,537,3824,3805,19,196153
0500000US39005,39,005,Ashland County,53477,713,52764,3,396,433,0,67,699,668,31,51166
0500000US40133,40,133,Seminole County,25071,1240,23831,4774,88,1174,1,39,1520,1506,14,16235
0500000US40011,40,011,Blaine County,9634,1003,8631,705,2,392,0,0,471,471,0,7061
0500000US40029,40,029,Coal County,5618,259,5359,671,11,7,0,17,786,786,0,3867
0500000US40073,40,073,Kingfisher County,15618,2439,13179,490,35,165,0,0,507,495,12,11982
0500000US40095,40,095,Marshall County,16376,2846,13530,1213,37,241,0,24,1278,1278,0,10737
0500000US40105,40,105,Nowata County,10383,305,10078,1628,30,257,16,9,1183,1180,3,6955
0500000US40131,40,131,Rogers County,90814,4169,86645,11047,1235,962,63,52,7803,7799,4,65483
0500000US40003,40,003,Alfalfa County,5857,309,5548,128,0,191,0,0,743,743,0,4486
0500000US40027,40,027,Cleveland County,276733,23307,253426,10163,12159,12611,137,464,18107,17980,127,199785
0500000US40005,40,005,Atoka County,13874,486,13388,1429,86,531,8,9,1417,1417,0,9908
0500000US40043,40,043,Dewey County,4918,353,4565,101,32,8,0,5,357,357,0,4062
0500000US40083,40,083,Logan County,46044,2754,43290,1626,158,3913,20,13,1795,1782,13,35765
0500000US40147,40,147,Washington County,52001,3065,48936,5587,1068,1350,15,28,2873,2774,99,38015
0500000US40061,40,061,Haskell County,12704,549,12155,1447,88,92,2,0,1530,1530,0,8996
0500000US40111,40,111,Okmulgee County,38889,1552,37337,5180,130,3286,0,47,4384,4350,34,24310
0500000US40067,40,067,Jefferson County,6223,645,5578,396,2,80,0,1,237,237,0,4862
0500000US40049,40,049,Garvin County,27823,2375,25448,1483,93,653,0,0,2111,2111,0,21108
0500000US40123,40,123,Pontotoc County,38358,2013,36345,3989,296,762,30,33,5984,5970,14,25251
0500000US40063,40,063,Hughes County,13460,724,12736,2708,18,804,0,0,711,711,0,8495
0500000US40031,40,031,Comanche County,122561,15802,106759,5480,2788,19507,595,46,9120,9061,59,69223
0500000US40117,40,117,Pawnee County,16428,497,15931,1897,68,151,7,0,1178,1174,4,12630
0500000US41019,41,019,Douglas County,108323,6130,102193,1108,1138,471,66,72,3938,3896,42,95400
0500000US41053,41,053,Polk County,81427,11126,70301,1403,1515,853,353,35,2266,2238,28,63876
0500000US41017,41,017,Deschutes County,180640,14199,166441,721,2155,1010,101,151,4207,4107,100,158096
0500000US41071,41,071,Yamhill County,103820,16438,87382,1007,1471,868,266,59,3428,3304,124,80283
0500000US41035,41,035,Klamath County,66310,8413,57897,2360,677,496,63,20,2317,2317,0,51964
0500000US41003,41,003,Benton County,89780,6545,83235,406,6395,867,227,153,2840,2795,45,72347
0500000US41013,41,013,Crook County,22337,1691,20646,180,82,29,100,0,536,523,13,19719
0500000US41025,41,025,Harney County,7228,365,6863,113,0,37,4,47,405,405,0,6257
0500000US41063,41,063,Wallowa County,6924,203,6721,71,24,16,6,7,148,143,5,6449
0500000US41069,41,069,Wheeler County,1426,138,1288,10,6,0,0,0,57,57,0,1215
0500000US41011,41,011,Coos County,63308,4041,59267,1305,698,416,54,65,2691,2678,13,54038
0500000US41027,41,027,Hood River County,23131,7280,15851,130,350,124,5,0,478,478,0,14764
0500000US41051,41,051,Multnomah County,798647,91130,707517,5180,57550,42275,4826,2555,36326,35642,684,558805
0500000US42055,42,055,Franklin County,153751,8354,145397,205,1239,5535,0,122,2424,2319,105,135872
0500000US42009,42,009,Bedford County,48611,575,48036,52,187,262,0,36,454,438,16,47045
0500000US42111,42,111,Somerset County,74949,1104,73845,46,297,1848,24,46,840,809,31,70744
0500000US42133,42,133,York County,444014,32028,411986,457,6641,23443,108,675,8436,8214,222,372226
0500000US42015,42,015,Bradford County,61304,880,60424,37,415,258,6,10,859,828,31,58839
0500000US42029,42,029,Chester County,517156,37858,479298,436,26688,29564,110,538,9081,8817,264,412881
0500000US42063,42,063,Indiana County,85755,1107,84648,196,839,1816,7,78,1149,1121,28,80563
0500000US42125,42,125,Washington County,207547,3417,204130,115,1828,6249,37,221,4023,3904,119,191657
0500000US42103,42,103,Pike County,55498,5911,49587,64,690,3203,19,151,669,634,35,44791
0500000US42077,42,077,Lehigh County,362613,85446,277167,322,12021,19471,19,503,7176,6990,186,237655
0500000US42031,42,031,Clarion County,38827,334,38493,83,207,370,21,42,472,463,9,37298
0500000US42033,42,033,Clearfield County,80216,2341,77875,161,397,2029,0,10,586,536,50,74692
0500000US42081,42,081,Lycoming County,114859,2278,112581,174,808,5436,18,259,1875,1793,82,104011
0500000US42123,42,123,Warren County,40035,420,39615,48,211,181,0,45,377,377,0,38753
0500000US42047,42,047,Elk County,30608,241,30367,76,160,160,0,0,144,140,4,29827
0500000US42085,42,085,Mercer County,112630,1621,111009,123,762,6308,3,137,2096,2085,11,101580
0500000US42113,42,113,Sullivan County,6177,134,6043,16,26,185,6,12,61,61,0,5737
0500000US44003,44,003,Kent County,163861,7624,156237,215,4178,2513,0,339,3107,2906,201,145885
0500000US44009,44,009,Washington County,126242,3914,122328,946,2406,1640,110,320,1898,1825,73,115008
0500000US45005,45,005,Allendale County,9214,138,9076,30,6,6957,3,0,30,30,0,2050
0500000US45023,45,023,Chester County,32326,633,31693,157,35,11912,0,17,578,578,0,18994
0500000US45067,45,067,Marion County,31562,880,30682,189,225,17860,0,0,215,208,7,12193
0500000US45073,45,073,Oconee County,76696,4083,72613,154,517,5366,13,55,1658,1658,0,64850
0500000US45019,45,019,Charleston County,394708,19944,374764,643,5561,107050,137,459,7554,7458,96,253360
0500000US45069,45,069,Marlboro County,27131,896,26235,808,80,13696,0,35,987,987,0,10629
0500000US45021,45,021,Cherokee County,56711,2392,54319,42,349,11354,25,7,1189,1160,29,41353
0500000US45053,45,053,Jasper County,27900,3684,24216,27,156,12015,0,0,244,244,0,11774
0500000US45061,45,061,Lee County,17606,423,17183,25,6,11292,0,6,161,161,0,5693
0500000US45083,45,083,Spartanburg County,302195,20137,282058,480,6703,61317,71,336,5875,5764,111,207276
0500000US45013,45,013,Beaufort County,182658,20412,162246,376,2304,32668,136,233,2986,2957,29,123543
0500000US45081,45,081,Saluda County,20299,3165,17134,19,0,5069,0,0,283,283,0,11763
0500000US46067,46,067,Hutchinson County,7315,166,7149,90,28,0,0,0,103,99,4,6928
0500000US46017,46,017,Buffalo County,2053,66,1987,1690,0,3,22,0,20,20,0,252
0500000US46041,46,041,Dewey County,5779,58,5721,4495,5,6,0,0,49,49,0,1166
0500000US46065,46,065,Hughes County,17617,541,17076,1939,82,56,0,0,434,434,0,14565
0500000US46111,46,111,Sanborn County,2388,87,2301,20,10,0,0,0,21,21,0,2250
0500000US46059,46,059,Hand County,3301,26,3275,0,18,3,0,0,24,24,0,3230
0500000US46135,46,135,Yankton County,22717,953,21764,670,50,346,15,0,503,503,0,20180
0500000US46005,46,005,Beadle County,18374,1803,16571,258,1703,143,8,0,210,210,0,14249
0500000US46035,46,035,Davison County,19901,568,19333,423,68,160,0,55,517,517,0,18110
0500000US46073,46,073,Jerauld County,2029,37,1992,21,0,0,0,0,20,20,0,1951
0500000US46117,46,117,Stanley County,2997,72,2925,290,0,0,35,0,73,73,0,2527
0500000US46107,46,107,Potter County,2326,68,2258,42,26,0,0,0,33,33,0,2157
0500000US46023,46,023,Charles Mix County,9344,311,9033,2751,13,7,3,6,365,365,0,5888
0500000US46091,46,091,Marshall County,4895,455,4440,340,2,23,0,2,50,50,0,4023
0500000US46101,46,101,Moody County,6506,276,6230,792,164,6,0,0,261,261,0,5007
0500000US46121,46,121,Todd County,10146,437,9709,8219,154,18,0,0,484,484,0,834
0500000US46085,46,085,Lyman County,3869,93,3776,1536,19,3,5,0,44,44,0,2169
0500000US46115,46,115,Spink County,6543,200,6343,111,0,5,13,5,74,74,0,6135
0500000US46011,46,011,Brookings County,34239,1011,33228,351,955,485,8,0,456,450,6,30973
0500000US46057,46,057,Hamlin County,6000,260,5740,24,16,15,0,0,62,62,0,5623
0500000US47083,47,083,Houston County,8176,50,8126,86,20,320,17,0,152,152,0,7531
0500000US47071,47,071,Hardin County,25771,642,25129,13,149,1082,21,11,195,186,9,23658
0500000US47069,47,069,Hardeman County,25562,442,25120,56,191,10615,0,5,323,304,19,13930
0500000US47139,47,139,Polk County,16782,335,16447,45,10,37,0,35,359,359,0,15961
0500000US47185,47,185,White County,26580,654,25926,8,51,534,0,12,445,445,0,24876
0500000US47171,47,171,Unicoi County,17780,824,16956,18,70,65,0,14,175,175,0,16614
0500000US47183,47,183,Weakley County,33626,814,32812,94,75,2908,18,39,431,421,10,29247
0500000US47007,47,007,Bledsoe County,14602,326,14276,223,8,659,0,23,396,396,0,12967
0500000US47031,47,031,Coffee County,54531,2283,52248,86,520,1332,7,7,1752,1732,20,48544
0500000US47073,47,073,Hawkins County,56402,841,55561,90,271,794,56,7,651,624,27,53692
0500000US47111,47,111,Macon County,23487,1212,22275,56,188,72,32,0,284,284,0,21643
0500000US47147,47,147,Robertson County,69344,4673,64671,207,378,4830,48,29,1144,1109,35,58035
0500000US47021,47,021,Cheatham County,39929,1140,38789,93,137,550,12,11,808,808,0,37178
0500000US47055,47,055,Giles County,29167,663,28504,90,65,2877,0,162,707,699,8,24603
0500000US47113,47,113,Madison County,97682,3692,93990,56,955,36271,0,49,1717,1711,6,54942
0500000US47137,47,137,Pickett County,5088,27,5061,0,0,26,0,0,4,4,0,5031
0500000US47181,47,181,Wayne County,16649,335,16314,60,64,1136,0,10,43,43,0,15001
0500000US47003,47,003,Bedford County,47558,5709,41849,27,79,3418,29,268,1258,1258,0,36770
0500000US47035,47,035,Cumberland County,58634,1731,56903,292,157,328,0,4,700,691,9,55422
0500000US47025,47,025,Claiborne County,31613,394,31219,38,206,346,84,0,371,362,9,30174
0500000US47085,47,085,Humphreys County,18318,436,17882,206,122,381,6,0,192,177,15,16975
0500000US47141,47,141,Putnam County,76440,4721,71719,294,935,1703,31,109,956,956,0,67691
0500000US47161,47,161,Stewart County,13301,370,12931,61,99,139,50,2,329,325,4,12251
0500000US47039,47,039,Decatur County,11683,198,11485,0,47,438,0,0,278,235,43,10722
0500000US47109,47,109,McNairy County,25903,529,25374,46,50,1520,0,12,440,440,0,23306
0500000US47011,47,011,Bradley County,104557,6217,98340,107,1191,4941,30,538,1739,1703,36,89794
0500000US48267,48,267,Kimble County,4408,1114,3294,17,0,1,0,16,67,67,0,3193
0500000US48467,48,467,Van Zandt County,54368,5741,48627,298,268,1423,39,0,885,840,45,45714
0500000US48317,48,317,Martin County,5614,2574,3040,8,4,48,2,0,0,0,0,2978
0500000US48501,48,501,Yoakum County,8571,5643,2928,11,5,25,0,29,95,95,0,2763
0500000US48387,48,387,Red River County,12275,902,11373,28,6,2080,0,0,277,277,0,8982
0500000US48435,48,435,Sutton County,3865,2385,1480,0,0,3,0,0,7,7,0,1470
0500000US48459,48,459,Upshur County,40769,3423,37346,294,239,3368,0,199,429,429,0,32817
0500000US48481,48,481,Wharton County,41551,16983,24568,27,64,5747,0,8,79,79,0,18643
0500000US48033,48,033,Borden County,665,56,609,0,0,0,0,0,14,14,0,595
0500000US48315,48,315,Marion County,10083,406,9677,43,0,2361,38,0,93,93,0,7142
0500000US48181,48,181,Grayson County,128560,16817,111743,1534,1805,6842,66,201,3838,3773,65,97457
0500000US48363,48,363,Palo Pinto County,28317,5625,22692,161,217,628,37,19,331,331,0,21299
0500000US48123,48,123,DeWitt County,20435,7132,13303,7,1,1865,0,0,159,137,22,11271
0500000US48059,48,059,Callahan County,13770,1300,12470,11,39,66,0,0,454,339,115,11900
0500000US48183,48,183,Gregg County,123494,22916,100578,377,1641,24767,121,144,2141,2103,38,71387
0500000US48303,48,303,Lubbock County,301454,105514,195940,1067,6328,20528,182,223,4945,4788,157,162667
0500000US48257,48,257,Kaufman County,118910,24531,94379,468,1410,12799,46,232,1783,1756,27,77641
0500000US48153,48,153,Floyd County,5872,3429,2443,8,10,164,0,0,77,77,0,2184
0500000US48071,48,071,Chambers County,40292,8793,31499,85,506,3158,0,0,564,564,0,27186
0500000US48027,48,027,Bell County,342236,83630,258606,1066,9767,72677,2156,286,13850,13735,115,158804
0500000US48233,48,233,Hutchinson County,21571,4959,16612,313,82,474,122,4,367,357,10,15250
0500000US48361,48,361,Orange County,84047,6165,77882,277,1007,7090,0,37,1353,1311,42,68118
0500000US48495,48,495,Winkler County,7802,4689,3113,78,0,159,0,0,65,65,0,2811
0500000US48053,48,053,Burnet County,45750,10120,35630,292,383,831,0,0,379,373,6,33745
0500000US48113,48,113,Dallas County,2586552,1033000,1553552,5243,158780,572790,1125,4484,45314,42407,2907,765816
0500000US48311,48,311,McMullen County,662,332,330,4,0,0,0,0,0,0,0,326
0500000US48251,48,251,Johnson County,163475,34048,129427,644,1400,4982,607,79,2587,2512,75,119128
0500000US48205,48,205,Hartley County,5767,1524,4243,2,85,492,0,37,237,237,0,3390
0500000US48293,48,293,Limestone County,23515,5101,18414,90,177,4058,63,60,150,150,0,13816
0500000US48367,48,367,Parker County,129802,15562,114240,523,644,1762,61,147,2238,2170,68,108865
0500000US48109,48,109,Culberson County,2241,1646,595,0,12,3,0,0,46,46,0,534
0500000US48169,48,169,Garza County,6288,3272,3016,23,137,267,0,7,20,20,0,2562
0500000US48453,48,453,Travis County,1203166,407676,795490,1963,78250,94922,368,2122,27492,26631,861,590373
0500000US48087,48,087,Collingsworth County,2996,834,2162,68,0,195,0,0,21,16,5,1878
0500000US48279,48,279,Lamb County,13262,7325,5937,33,72,442,0,0,138,138,0,5252
0500000US48301,48,301,Loving County,102,16,86,3,0,0,0,0,0,0,0,83
0500000US28117,28,117,Prentiss County,25360,354,25006,0,40,3130,0,22,861,805,56,20953
0500000US28059,28,059,Jackson County,142014,8917,133097,460,3359,30025,66,291,2568,2366,202,96328
0500000US28143,28,143,Tunica County,10170,85,10085,0,121,7984,0,0,23,23,0,1957
0500000US28021,28,021,Claiborne County,9120,13,9107,13,49,7972,0,0,10,10,0,1063
0500000US28075,28,075,Lauderdale County,77323,1755,75568,145,600,33546,0,47,444,430,14,40786
0500000US28127,28,127,Simpson County,27073,93,26980,3,74,9878,0,13,356,343,13,16656
0500000US28007,28,007,Attala County,18581,386,18195,30,33,7910,0,0,232,226,6,9990
0500000US28027,28,027,Coahoma County,23802,56,23746,23,119,18413,0,0,146,146,0,5045
0500000US28147,28,147,Walthall County,14601,89,14512,0,63,6699,0,12,53,53,0,7685
0500000US28115,28,115,Pontotoc County,31315,2055,29260,5,18,4814,0,23,336,307,29,24064
0500000US28003,28,003,Alcorn County,37180,1181,35999,0,98,4332,0,0,746,736,10,30823
0500000US28033,28,033,DeSoto County,176132,8599,167533,276,2156,45944,29,291,3509,3471,38,115328
0500000US29129,29,129,Mercer County,3664,71,3593,0,19,14,4,0,60,60,0,3496
0500000US29047,29,047,Clay County,239164,16014,223150,1017,5043,14075,365,126,7316,7234,82,195208
0500000US29065,29,065,Dent County,15504,258,15246,97,72,89,0,0,329,325,4,14659
0500000US29227,29,227,Worth County,2040,14,2026,1,4,7,0,0,43,43,0,1971
0500000US29510,29,510,St. Louis city,311273,12363,298910,616,10002,145696,154,1366,6459,6251,208,134617
0500000US29023,29,023,Butler County,42733,887,41846,221,254,2437,2,12,971,971,0,37949
0500000US29087,29,087,Holt County,4456,26,4430,37,34,30,1,0,43,43,0,4285
0500000US29139,29,139,Montgomery County,11545,216,11329,12,29,169,10,0,227,227,0,10882
0500000US29207,29,207,Stoddard County,29512,501,29011,3,10,340,0,0,465,465,0,28193
0500000US29221,29,221,Washington County,24931,332,24599,68,22,492,4,0,495,486,9,23518
0500000US29063,29,063,DeKalb County,12564,303,12261,90,26,1228,21,11,328,328,0,10557
0500000US29107,29,107,Lafayette County,32589,897,31692,36,185,634,75,0,745,745,0,30017
0500000US29197,29,197,Schuyler County,4502,28,4474,0,0,23,0,0,78,78,0,4373
0500000US29029,29,029,Camden County,45096,1203,43893,264,145,315,0,11,580,580,0,42578
0500000US29097,29,097,Jasper County,119238,9369,109869,1708,1306,2263,136,80,3734,3589,145,100642
0500000US29119,29,119,McDonald County,22827,2642,20185,635,328,450,417,0,568,557,11,17787
0500000US29167,29,167,Polk County,31549,757,30792,323,39,299,16,0,521,521,0,29594
0500000US29179,29,179,Reynolds County,6315,121,6194,15,9,121,16,0,96,96,0,5937
0500000US29201,29,201,Scott County,38729,878,37851,151,160,4456,0,103,705,675,30,32276
0500000US29011,29,011,Barton County,11850,312,11538,219,0,35,6,2,316,301,15,10960
0500000US29051,29,051,Cole County,76740,2144,74596,216,1055,8916,14,341,1582,1506,76,62472
0500000US29073,29,073,Gasconade County,14746,200,14546,48,55,52,0,23,204,200,4,14164
0500000US29121,29,121,Macon County,15254,210,15044,97,80,271,3,11,264,264,0,14318
0500000US29155,29,155,Pemiscot County,17031,422,16609,14,0,4554,2,0,333,322,11,11706
0500000US29203,29,203,Shannon County,8246,150,8096,38,0,12,0,0,291,291,0,7755
0500000US29067,29,067,Douglas County,13374,203,13171,23,9,14,0,5,31,31,0,13089
0500000US29083,29,083,Henry County,21765,511,21254,114,52,289,0,0,412,390,22,20387
0500000US29109,29,109,Lawrence County,38133,2771,35362,196,82,211,0,28,744,744,0,34101
0500000US30015,30,015,Chouteau County,5789,136,5653,1083,25,3,2,0,93,93,0,4447
0500000US30053,30,053,Lincoln County,19358,575,18783,135,97,12,31,5,529,517,12,17974
0500000US30103,30,103,Treasure County,777,6,771,0,14,0,0,0,11,11,0,746
0500000US30097,30,097,Sweet Grass County,3653,111,3542,40,10,8,0,0,88,88,0,3396
0500000US30079,30,079,Prairie County,1342,18,1324,1,0,0,0,0,0,0,0,1323
0500000US30035,30,035,Glacier County,13699,402,13297,8831,16,38,14,0,162,162,0,4236
0500000US30037,30,037,Golden Valley County,724,59,665,0,0,0,0,0,21,21,0,644
0500000US30095,30,095,Stillwater County,9410,370,9040,97,20,20,0,0,169,169,0,8734
0500000US30039,30,039,Granite County,3269,74,3195,16,2,5,0,0,42,42,0,3130
0500000US30057,30,057,Madison County,8218,412,7806,75,4,2,0,0,171,171,0,7554
0500000US30091,30,091,Sheridan County,3574,95,3479,45,16,0,0,0,160,160,0,3258
0500000US30003,30,003,Big Horn County,13376,837,12539,8661,20,6,3,0,219,219,0,3630
0500000US30049,30,049,Lewis and Clark County,67077,2165,64912,1148,417,175,44,17,1727,1725,2,61384
0500000US30063,30,063,Missoula County,115983,3714,112269,2576,1860,559,111,90,3426,3305,121,103647
0500000US30013,30,013,Cascade County,81746,3569,78177,3629,675,1020,71,20,2871,2787,84,69891
0500000US30033,30,033,Garfield County,1141,2,1139,0,0,0,0,0,0,0,0,1139
0500000US30077,30,077,Powell County,6861,130,6731,280,34,24,0,0,238,238,0,6155
0500000US30031,30,031,Gallatin County,104729,3777,100952,748,1460,351,11,15,2242,2206,36,96125
0500000US30001,30,001,Beaverhead County,9393,421,8972,234,43,6,13,0,134,134,0,8542
0500000US30065,30,065,Musselshell County,4807,128,4679,8,20,0,0,0,30,30,0,4621
0500000US31161,31,161,Sheridan County,5234,261,4973,433,37,40,2,0,191,191,0,4270
0500000US31129,31,129,Nuckolls County,4275,116,4159,3,57,7,0,0,18,18,0,4074
0500000US31063,31,063,Frontier County,2609,27,2582,20,3,2,0,0,41,41,0,2516
0500000US31055,31,055,Douglas County,554992,68770,486222,2028,20092,60722,250,930,14636,14179,457,387564
0500000US31029,31,029,Chase County,3734,369,3365,0,10,2,0,0,18,18,0,3335
0500000US31005,31,005,Arthur County,418,3,415,2,0,0,0,2,14,14,0,397
0500000US31061,31,061,Franklin County,3006,67,2939,0,4,11,4,0,39,39,0,2881
0500000US31095,31,095,Jefferson County,7188,268,6920,32,11,18,0,0,102,102,0,6757
0500000US31115,31,115,Loup County,585,10,575,2,0,0,0,0,0,0,0,573
0500000US31137,31,137,Phelps County,9120,504,8616,19,24,23,0,0,114,114,0,8436
0500000US31157,31,157,Scotts Bluff County,36255,8590,27665,522,236,239,0,24,445,411,34,26199
0500000US31105,31,105,Kimball County,3667,394,3273,1,12,8,0,0,85,85,0,3167
0500000US31121,31,121,Merrick County,7803,332,7471,9,23,67,0,0,133,133,0,7239
0500000US31021,31,021,Burt County,6528,192,6336,98,32,46,0,0,77,77,0,6083
0500000US31039,31,039,Cuming County,8991,891,8100,15,28,7,11,0,90,90,0,7949
0500000US31075,31,075,Grant County,718,12,706,0,0,5,0,0,7,7,0,694
0500000US31085,31,085,Hayes County,943,69,874,0,0,0,0,0,0,0,0,874
0500000US31027,31,027,Cedar County,8523,156,8367,76,3,4,2,0,36,36,0,8246
0500000US31097,31,097,Johnson County,5197,524,4673,43,48,334,0,2,59,59,0,4187
0500000US31071,31,071,Garfield County,1975,39,1936,0,7,4,0,9,8,8,0,1908
0500000US31133,31,133,Pawnee County,2676,48,2628,5,0,0,0,0,69,69,0,2554
0500000US31183,31,183,Wheeler County,822,5,817,0,2,0,0,0,3,3,0,812
0500000US31185,31,185,York County,13799,691,13108,30,56,210,0,37,245,245,0,12530
0500000US31037,31,037,Colfax County,10760,4892,5868,6,64,374,22,0,60,60,0,5342
0500000US31113,31,113,Logan County,886,26,860,2,0,0,0,0,3,0,3,855
0500000US31143,31,143,Polk County,5255,282,4973,15,3,4,0,0,61,61,0,4890
0500000US31017,31,017,Brown County,2988,42,2946,7,10,1,0,0,58,58,0,2870
0500000US32015,32,015,Lander County,5746,1498,4248,238,7,6,50,0,40,40,0,3907
0500000US32011,32,011,Eureka County,1830,120,1710,96,0,1,0,0,0,0,0,1613
0500000US34021,34,021,Mercer County,368762,63371,305391,203,39522,73089,65,682,6075,5795,280,185755
0500000US34035,34,035,Somerset County,330176,47729,282447,344,57035,30340,17,344,5326,4637,689,189041
0500000US34001,34,001,Atlantic County,268539,50129,218410,598,21502,38177,66,357,6043,5495,548,151667
0500000US34023,34,023,Middlesex County,826698,171616,655082,1270,197010,78052,275,2464,13689,10808,2881,362322
0500000US34009,34,009,Cape May County,93705,6988,86717,26,908,4304,7,92,1259,1253,6,80121
0500000US34039,34,039,Union County,553066,171745,381321,279,27631,111523,20,10743,8373,7047,1326,222752
0500000US34019,34,019,Hunterdon County,125051,7942,117109,63,4902,3138,41,48,1335,1200,135,107582
0500000US35028,35,028,Los Alamos County,18356,3236,15120,173,996,36,0,9,665,642,23,13241
0500000US35061,35,061,Valencia County,75956,45843,30113,2833,372,704,0,66,1072,894,178,25066
0500000US35001,35,001,Bernalillo County,677692,337627,340065,27949,16782,16622,379,1900,12075,11363,712,264358
0500000US35011,35,011,De Baca County,2060,949,1111,0,0,33,0,0,6,6,0,1072
0500000US35023,35,023,Hidalgo County,4371,2535,1836,23,0,27,0,0,4,4,0,1782
0500000US35043,35,043,Sandoval County,140769,54038,86731,16879,1732,2894,161,296,2849,2751,98,61920
0500000US35009,35,009,Curry County,50199,20872,29327,458,780,2650,80,174,1001,896,105,24184
0500000US35021,35,021,Harding County,459,171,288,0,0,0,2,1,2,2,0,283
0500000US35045,35,045,San Juan County,127455,25619,101836,48592,841,712,75,164,2118,2063,55,49334
0500000US35005,35,005,Chaves County,65459,36797,28662,570,405,1005,23,163,643,643,0,25853
0500000US35059,35,059,Union County,4175,1746,2429,72,2,82,0,20,110,57,53,2143
0500000US35041,35,041,Roosevelt County,19117,7941,11176,65,79,447,0,21,527,527,0,10037
0500000US36005,36,005,Bronx County,1437872,803636,634236,3476,50906,421275,493,8803,15409,12813,2596,133874
0500000US36035,36,035,Fulton County,53743,1581,52162,132,382,1058,15,0,602,598,4,49973
0500000US36083,36,083,Rensselaer County,159431,7650,151781,81,4113,9399,0,281,4675,4608,67,133232
0500000US36043,36,043,Herkimer County,62505,1309,61196,150,322,714,15,85,763,709,54,59147
0500000US36089,36,089,St. Lawrence County,109558,2532,107026,828,1125,2429,68,154,1652,1612,40,100770
0500000US36113,36,113,Warren County,64480,1589,62891,166,671,816,32,24,559,559,0,60623
0500000US36027,36,027,Dutchess County,293894,34970,258924,410,10600,28478,79,1112,6935,6630,305,211310
0500000US36055,36,055,Monroe County,744248,63631,680617,1246,26259,107709,113,1272,16891,16123,768,527127
0500000US36111,36,111,Ulster County,179303,17976,161327,130,3389,9614,131,490,5058,5002,56,142515
0500000US36051,36,051,Livingston County,63907,2223,61684,115,833,1696,22,68,838,816,22,58112
0500000US36039,36,039,Greene County,47617,2753,44864,233,516,2763,5,166,556,556,0,40625
0500000US36003,36,003,Allegany County,47025,744,46281,133,523,639,12,66,517,517,0,44391
0500000US36009,36,009,Cattaraugus County,77686,1605,76081,2289,648,1224,0,61,1434,1342,92,70425
0500000US36093,36,093,Schenectady County,154883,10707,144176,319,6967,14824,66,3064,5287,4400,887,113649
0500000US36123,36,123,Yates County,25009,549,24460,16,189,207,7,55,300,279,21,23686
0500000US37087,37,087,Haywood County,60433,2307,58126,278,311,617,0,50,737,737,0,56133
0500000US37005,37,005,Alleghany County,10973,1054,9919,37,26,255,1,0,52,52,0,9548
0500000US37045,37,045,Cleveland County,97159,3317,93842,289,988,20205,0,226,1167,1148,19,70967
0500000US37077,37,077,Granville County,58874,4563,54311,285,266,17718,0,111,1677,1620,57,34254
0500000US37093,37,093,Hoke County,53239,6950,46289,4274,754,17412,69,226,2089,2048,41,21465
0500000US37097,37,097,Iredell County,172525,12869,159656,288,4026,20869,32,218,2679,2625,54,131544
0500000US37147,37,147,Pitt County,177372,10903,166469,460,3054,61235,45,744,3932,3878,54,96999
0500000US37039,37,039,Cherokee County,27668,846,26822,390,193,364,0,39,585,585,0,25251
0500000US37193,37,193,Wilkes County,68460,4316,64144,192,419,2750,139,11,693,669,24,59940
0500000US37003,37,003,Alexander County,37119,1723,35396,150,402,2105,31,0,463,457,6,32245
0500000US37031,37,031,Carteret County,68920,2930,65990,177,781,3859,40,54,1555,1542,13,59524
0500000US37139,37,139,Pasquotank County,39479,2031,37448,35,646,14362,58,10,689,679,10,21648
0500000US37173,37,173,Swain County,14254,731,13523,3962,47,60,0,0,586,586,0,8868
0500000US37007,37,007,Anson County,25306,999,24307,86,335,12333,9,7,249,249,0,11288
0500000US37069,37,069,Franklin County,64902,5276,59626,293,360,16296,1,286,1146,999,147,41244
0500000US37113,37,113,Macon County,34410,2367,32043,193,267,464,0,82,311,294,17,30726
0500000US37175,37,175,Transylvania County,33513,1090,32423,103,111,1500,15,0,430,391,39,30264
0500000US37047,37,047,Columbus County,56293,2941,53352,1874,245,17134,9,163,530,505,25,33397
0500000US37123,37,123,Montgomery County,27338,4176,23162,113,407,4914,5,30,397,397,0,17296
0500000US37153,37,153,Richmond County,45189,2870,42319,1049,419,14303,0,0,647,646,1,25901
0500000US37171,37,171,Surry County,72099,7450,64649,258,402,2659,104,35,473,473,0,60718
0500000US37021,37,021,Buncombe County,254474,16529,237945,962,3085,15745,341,195,4844,4680,164,212773
0500000US37025,37,025,Cabarrus County,201448,20560,180888,644,6837,34633,101,424,3620,3309,311,134629
0500000US37057,37,057,Davidson County,164664,11516,153148,482,2462,14843,18,155,2640,2618,22,132548
0500000US37091,37,091,Hertford County,24153,897,23256,255,178,14154,47,15,529,527,2,8078
0500000US37141,37,141,Pender County,59020,4069,54951,128,294,8783,39,101,1468,1468,0,44138
0500000US37189,37,189,Watauga County,54117,1882,52235,329,500,886,78,53,664,548,116,49725
0500000US37177,37,177,Tyrrell County,4119,263,3856,35,0,1540,0,5,79,79,0,2197
0500000US38097,38,097,Traill County,8019,287,7732,115,12,88,17,0,103,93,10,7397
0500000US38021,38,021,Dickey County,4970,170,4800,68,22,57,0,0,12,8,4,4641
0500000US38101,38,101,Ward County,69034,4082,64952,1455,1131,2657,80,46,1921,1914,7,57662
0500000US38049,38,049,McHenry County,5927,135,5792,62,19,25,0,0,48,48,0,5638
0500000US38005,38,005,Benson County,6886,63,6823,3833,8,2,0,6,157,157,0,2817
0500000US38075,38,075,Renville County,2495,158,2337,13,20,5,0,0,28,26,2,2271
0500000US38015,38,015,Burleigh County,93737,2195,91542,3472,613,1950,49,32,1623,1605,18,83803
0500000US38065,38,065,Oliver County,1837,32,1805,28,5,18,0,3,83,83,0,1668
0500000US38071,38,071,Ramsey County,11557,303,11254,1136,47,13,0,0,344,343,1,9714
0500000US38039,38,039,Griggs County,2266,6,2260,34,0,31,0,0,35,25,10,2160
0500000US38083,38,083,Sheridan County,1405,0,1405,11,0,0,0,0,15,15,0,1379
0500000US38103,38,103,Wells County,4055,52,4003,6,7,0,0,1,23,23,0,3966
0500000US39099,39,099,Mahoning County,231064,13489,217575,527,1938,33736,6,105,5277,5258,19,175986
0500000US39145,39,145,Scioto County,76377,1030,75347,321,330,2029,0,157,1210,1200,10,71300
0500000US39105,39,105,Meigs County,23160,119,23041,41,18,308,0,8,267,267,0,22399
0500000US39131,39,131,Pike County,28214,302,27912,109,31,311,0,12,568,568,0,26881
0500000US39061,39,061,Hamilton County,812037,25836,786201,711,21001,207494,501,2065,22471,22023,448,531958
0500000US39087,39,087,Lawrence County,60622,576,60046,13,296,1265,0,26,952,952,0,57494
0500000US39157,39,157,Tuscarawas County,92526,2443,90083,245,354,576,0,0,1263,1263,0,87645
0500000US39015,39,015,Brown County,43679,420,43259,39,129,338,0,9,584,576,8,42160
0500000US39043,39,043,Erie County,75136,3246,71890,205,443,6459,6,110,2082,1992,90,62585
0500000US39089,39,089,Licking County,172293,3154,169139,178,1981,6360,11,391,4155,3880,275,156063
0500000US39019,39,019,Carroll County,27578,358,27220,9,128,187,0,0,347,347,0,26549
0500000US39025,39,025,Clermont County,203216,3822,199394,300,2472,2844,87,344,3021,2962,59,190326
0500000US39071,39,071,Highland County,43007,446,42561,62,174,678,0,27,633,614,19,40987
0500000US39133,39,133,Portage County,162644,2904,159740,357,3078,6609,6,67,3674,3657,17,145949
0500000US39013,39,013,Belmont County,68472,639,67833,135,301,2766,0,51,1004,996,8,63576
0500000US39127,39,127,Perry County,35985,305,35680,93,65,142,8,9,559,528,31,34804
0500000US48395,48,395,Robertson County,16890,3481,13409,35,49,3276,22,11,288,280,8,9728
0500000US48441,48,441,Taylor County,136348,32869,103479,722,2909,10287,75,289,2072,2027,45,87125
0500000US48455,48,455,Trinity County,14569,1420,13149,48,147,1318,0,0,185,185,0,11451
0500000US48019,48,019,Bandera County,21763,4010,17753,88,59,172,0,17,385,376,9,17032
0500000US48079,48,079,Cochran County,2904,1684,1220,0,0,96,0,0,56,56,0,1068
0500000US48091,48,091,Comal County,135097,36612,98485,97,1403,2544,45,140,2287,2273,14,91969
0500000US48225,48,225,Houston County,22955,2511,20444,49,72,5676,0,9,453,453,0,14185
0500000US48375,48,375,Potter County,120899,45905,74994,392,6494,11591,96,88,2578,2457,121,53755
0500000US48415,48,415,Scurry County,17239,6917,10322,13,49,837,0,35,230,215,15,9158
0500000US48433,48,433,Stonewall County,1385,256,1129,0,0,48,0,0,6,6,0,1075
0500000US48049,48,049,Brown County,37834,8299,29535,140,281,1340,0,0,521,521,0,27253
0500000US48025,48,025,Bee County,32691,19152,13539,186,141,2535,4,13,268,255,13,10392
0500000US48103,48,103,Crane County,4839,3080,1759,3,19,189,0,0,0,0,0,1548
0500000US48307,48,307,McCulloch County,8098,2587,5511,2,16,148,0,251,149,149,0,4945
0500000US48287,48,287,Lee County,16952,3970,12982,0,165,1889,0,26,129,79,50,10773
0500000US48139,48,139,Ellis County,168838,43737,125101,336,1104,15820,46,159,3495,3447,48,104141
0500000US48265,48,265,Kerr County,51365,13702,37663,117,473,759,32,114,684,678,6,35484
0500000US48145,48,145,Falls County,17299,3987,13312,57,73,4153,7,0,144,144,0,8878
0500000US19137,19,137,Montgomery County,10155,384,9771,23,0,0,0,0,215,215,0,9533
0500000US19123,19,123,Mahaska County,22208,475,21733,58,308,339,15,7,249,249,0,20757
0500000US19019,19,019,Buchanan County,21125,321,20804,66,123,22,0,2,257,240,17,20334
0500000US19053,19,053,Decatur County,8044,227,7817,30,54,127,14,0,116,116,0,7476
0500000US20085,20,085,Jackson County,13318,600,12718,845,79,86,18,0,492,491,1,11198
0500000US20109,20,109,Logan County,2810,163,2647,21,0,1,0,4,84,79,5,2537
0500000US20209,20,209,Wyandotte County,164345,46738,117607,471,7131,36256,368,294,5418,5264,154,67669
0500000US20027,20,027,Clay County,8142,201,7941,54,54,45,0,0,114,114,0,7674
0500000US20169,20,169,Saline County,54977,6078,48899,260,1243,1507,0,46,1674,1674,0,44169
0500000US20197,20,197,Wabaunsee County,6888,247,6641,37,51,32,0,12,135,135,0,6374
0500000US20123,20,123,Mitchell County,6222,147,6075,11,14,48,0,0,83,83,0,5919
0500000US20005,20,005,Atchison County,16363,487,15876,53,71,373,10,5,908,892,16,14456
0500000US20055,20,055,Finney County,36957,18286,18671,125,1477,904,0,0,689,689,0,15476
0500000US20103,20,103,Leavenworth County,80042,5498,74544,340,1106,6482,40,6,3273,3258,15,63297
0500000US20187,20,187,Stanton County,2063,744,1319,6,0,1,0,0,59,59,0,1253
0500000US20119,20,119,Meade County,4261,785,3476,0,50,21,0,2,78,78,0,3325
0500000US20151,20,151,Pratt County,9582,688,8894,10,11,225,0,8,171,171,0,8469
0500000US20003,20,003,Anderson County,7852,142,7710,166,1,45,0,0,36,36,0,7462
0500000US20061,20,061,Geary County,34895,5571,29324,375,1085,5914,318,60,1728,1725,3,19844
0500000US20057,20,057,Ford County,34484,18809,15675,101,514,668,18,20,498,498,0,13856
0500000US20117,20,117,Marshall County,9798,239,9559,24,52,50,23,0,123,120,3,9287
0500000US20023,20,023,Cheyenne County,2677,174,2503,0,1,0,0,24,7,7,0,2471
0500000US20035,20,035,Cowley County,35591,3836,31755,578,570,963,7,12,1241,1241,0,28384
0500000US20059,20,059,Franklin County,25563,1062,24501,111,73,271,0,67,716,714,2,23263
0500000US20089,20,089,Jewell County,2916,68,2848,15,0,18,4,0,28,28,0,2783
0500000US20159,20,159,Rice County,9762,1101,8661,72,83,164,30,0,131,129,2,8181
0500000US20017,20,017,Chase County,2645,122,2523,13,0,46,0,0,48,48,0,2416
0500000US20203,20,203,Wichita County,2143,625,1518,3,19,19,0,0,27,27,0,1450
0500000US20137,20,137,Norton County,5486,282,5204,25,32,148,0,4,100,100,0,4895
0500000US20009,20,009,Barton County,26791,3935,22856,170,27,326,54,12,372,371,1,21895
0500000US20047,20,047,Edwards County,2925,595,2330,0,11,17,0,0,55,55,0,2247
0500000US20165,20,165,Rush County,3102,83,3019,9,19,5,0,3,80,80,0,2903
0500000US20115,20,115,Marion County,12032,430,11602,11,28,59,0,0,332,328,4,11172
0500000US20143,20,143,Ottawa County,5902,163,5739,34,26,53,0,0,71,71,0,5555
0500000US20007,20,007,Barber County,4733,191,4542,48,31,28,0,1,102,102,0,4332
0500000US20041,20,041,Dickinson County,19004,876,18128,162,85,254,0,0,330,320,10,17297
0500000US21223,21,223,Trimble County,8637,256,8381,26,6,0,45,14,150,143,7,8140
0500000US21105,21,105,Hickman County,4568,53,4515,12,26,431,0,0,80,80,0,3966
0500000US21179,21,179,Nelson County,45388,953,44435,51,275,2239,0,37,784,773,11,41049
0500000US21081,21,081,Grant County,24915,673,24242,28,39,190,0,212,427,416,11,23346
0500000US21141,21,141,Logan County,26849,753,26096,20,68,1668,2,0,544,522,22,23794
0500000US21191,21,191,Pendleton County,14520,189,14331,8,81,116,0,0,139,139,0,13987
0500000US21215,21,215,Spencer County,18246,375,17871,39,135,220,0,0,249,249,0,17228
0500000US21011,21,011,Bath County,12268,195,12073,14,61,141,0,0,179,179,0,11678
0500000US21021,21,021,Boyle County,29913,987,28926,85,262,2095,0,46,822,813,9,25616
0500000US21095,21,095,Harlan County,27134,247,26887,16,110,683,0,22,254,248,6,25802
0500000US21137,21,137,Lincoln County,24458,389,24069,4,4,500,8,21,481,476,5,23051
0500000US21171,21,171,Monroe County,10634,331,10303,11,0,293,7,0,61,61,0,9931
0500000US21225,21,225,Union County,14802,284,14518,5,82,1899,0,3,321,321,0,12208
0500000US21035,21,035,Calloway County,38776,1036,37740,101,582,1314,50,0,905,905,0,34788
0500000US21059,21,059,Daviess County,99937,3009,96928,158,1448,4233,17,141,2623,2620,3,88308
0500000US21101,21,101,Henderson County,46137,1152,44985,40,191,3345,5,294,1228,1217,11,39882
0500000US21119,21,119,Knott County,15513,152,15361,5,8,95,13,3,175,160,15,15062
0500000US21177,21,177,Muhlenberg County,31081,465,30616,68,173,1443,14,14,272,272,0,28632
0500000US21199,21,199,Pulaski County,64145,1592,62553,205,497,624,0,102,756,729,27,60369
0500000US21001,21,001,Adair County,19241,363,18878,44,45,623,0,16,185,185,0,17965
0500000US21057,21,057,Cumberland County,6713,59,6654,0,24,262,0,105,55,55,0,6208
0500000US21129,21,129,Lee County,6751,40,6711,20,29,57,0,0,100,100,0,6505
0500000US21135,21,135,Lewis County,13490,0,13490,146,14,62,0,0,72,72,0,13196
0500000US21239,21,239,Woodford County,26097,1753,24344,0,86,1166,0,21,563,563,0,22508
0500000US21113,21,113,Jessamine County,52422,1759,50663,146,751,2121,0,40,857,837,20,46748
0500000US21133,21,133,Letcher County,22676,175,22501,47,57,88,0,0,193,171,22,22116
0500000US21145,21,145,McCracken County,65284,1594,63690,166,482,7148,55,35,1353,1349,4,54451
0500000US21235,21,235,Whitley County,36089,442,35647,65,110,360,20,0,447,416,31,34645
0500000US21071,21,071,Floyd County,36926,295,36631,4,116,385,0,0,265,265,0,35861
0500000US21147,21,147,McCreary County,17635,438,17197,66,125,997,11,25,186,153,33,15787
0500000US21169,21,169,Metcalfe County,10004,130,9874,4,32,110,0,0,222,222,0,9506
0500000US21205,21,205,Rowan County,24499,406,24093,45,175,432,0,0,277,270,7,23164
0500000US21049,21,049,Clark County,35872,1029,34843,30,200,1634,0,54,570,561,9,32355
0500000US21041,21,041,Carroll County,10711,733,9978,19,45,279,0,0,132,126,6,9503
0500000US21065,21,065,Estill County,14313,47,14266,54,12,24,7,0,235,227,8,13934
0500000US21089,21,089,Greenup County,35765,379,35386,27,159,298,0,4,474,470,4,34424
0500000US21043,21,043,Carter County,27290,251,27039,110,17,267,3,17,229,229,0,26396
0500000US22057,22,057,Lafourche Parish,98214,4291,93923,2254,732,13040,15,134,2295,2295,0,75453
0500000US22053,22,053,Jefferson Davis Parish,31467,741,30726,192,142,5199,0,0,547,547,0,24646
0500000US22125,22,125,West Feliciana Parish,15377,238,15139,23,103,6807,0,8,159,159,0,8039
0500000US22011,22,011,Beauregard Parish,36769,1363,35406,265,113,4575,4,17,997,991,6,29435
0500000US22039,22,039,Evangeline Parish,33636,1183,32453,54,147,9124,0,130,576,565,11,22422
0500000US22061,22,061,Lincoln Parish,47356,1437,45919,152,779,19191,0,14,540,540,0,25243
0500000US22119,22,119,Webster Parish,39631,739,38892,124,133,13522,42,22,459,459,0,24590
0500000US22047,22,047,Iberville Parish,32956,838,32118,71,21,15852,0,0,470,470,0,15704
0500000US22067,22,067,Morehouse Parish,25992,102,25890,11,131,12784,0,33,102,102,0,12829
0500000US22109,22,109,Terrebonne Parish,112587,5765,106822,6285,1049,21513,72,49,2584,2528,56,75270
0500000US22027,22,027,Claiborne Parish,16153,236,15917,36,22,8377,0,0,168,168,0,7314
0500000US22009,22,009,Avoyelles Parish,40882,762,40120,356,220,11713,69,22,1088,1088,0,26652
0500000US22077,22,077,Pointe Coupee Parish,22158,577,21581,65,57,7874,0,68,183,183,0,13334
0500000US22115,22,115,Vernon Parish,51007,4790,46217,595,978,7236,223,52,1434,1381,53,35699
0500000US22085,22,085,Sabine Parish,24088,933,23155,1641,96,3926,7,4,1137,1120,17,16344
0500000US22059,22,059,LaSalle Parish,14949,422,14527,149,10,1818,12,0,157,157,0,12381
0500000US23015,23,015,Lincoln County,34067,400,33667,138,322,160,0,8,328,322,6,32711
0500000US23021,23,021,Piscataquis County,16887,242,16645,92,115,74,0,22,260,250,10,16082
0500000US23029,23,029,Washington County,31694,705,30989,1587,139,141,4,34,674,674,0,28410
0500000US23023,23,023,Sagadahoc County,35277,577,34700,53,228,265,0,47,718,692,26,33389
0500000US23011,23,011,Kennebec County,121545,1828,119717,627,1153,955,45,45,1740,1713,27,115152
0500000US23009,23,009,Hancock County,54541,759,53782,223,569,465,58,32,667,647,20,51768
0500000US24039,24,039,Somerset County,25737,899,24838,75,265,10793,5,4,443,443,0,13253
0500000US24001,24,001,Allegany County,71977,1261,70716,82,629,5924,13,70,1304,1273,31,62694
0500000US24033,24,033,Prince George's County,906202,162372,743830,1816,37513,562046,298,3677,20979,20159,820,117501
0500000US24021,24,021,Frederick County,248472,22855,225617,494,10865,22685,187,411,6430,6276,154,184545
0500000US24029,24,029,Kent County,19593,848,18745,25,248,2804,0,40,380,375,5,15248
0500000US25027,25,027,Worcester County,822280,91732,730548,1218,39501,36777,185,3485,15460,14337,1123,633922
0500000US26033,26,033,Chippewa County,37834,702,37132,5336,361,2453,60,15,2489,2435,54,26418
0500000US26125,26,125,Oakland County,1250843,50057,1200786,2616,89956,170007,259,1983,31248,29968,1280,904717
0500000US26121,26,121,Muskegon County,173043,9655,163388,1155,958,23531,4,59,5447,5422,25,132234
0500000US26087,26,087,Lapeer County,88202,4092,84110,300,480,1090,24,82,1107,1066,41,81027
0500000US26151,26,151,Sanilac County,41376,1519,39857,126,134,218,0,8,444,439,5,38927
0500000US26131,26,131,Ontonagon County,5968,87,5881,47,15,33,8,4,104,104,0,5670
0500000US26001,26,001,Alcona County,10364,149,10215,57,29,40,8,14,143,126,17,9924
0500000US26079,26,079,Kalkaska County,17463,337,17126,133,106,135,0,0,284,284,0,16468
0500000US26129,26,129,Ogemaw County,20928,443,20485,214,131,77,0,0,233,207,26,19830
0500000US26165,26,165,Wexford County,33111,631,32480,145,194,207,8,2,589,585,4,31335
0500000US26043,26,043,Dickinson County,25570,381,25189,306,157,157,0,21,199,165,34,24349
0500000US26065,26,065,Ingham County,289564,22286,267278,754,18686,31619,66,478,13188,12709,479,202487
0500000US26109,26,109,Menominee County,23234,404,22830,514,93,65,0,2,519,517,2,21637
0500000US26113,26,113,Missaukee County,15006,426,14580,87,24,62,0,2,290,290,0,14115
0500000US26159,26,159,Van Buren County,75272,8586,66686,302,495,2371,28,66,2212,2192,20,61212
0500000US26015,26,015,Barry County,60057,1714,58343,163,333,226,3,94,879,853,26,56645
0500000US26019,26,019,Benzie County,17552,435,17117,263,78,67,0,0,243,239,4,16466
0500000US26153,26,153,Schoolcraft County,8069,81,7988,557,31,41,0,0,434,434,0,6925
0500000US26055,26,055,Grand Traverse County,91746,2584,89162,939,530,960,37,107,1660,1628,32,84929
0500000US26049,26,049,Genesee County,409361,13797,395564,1456,4226,80370,41,459,12245,12078,167,296767
0500000US26093,26,093,Livingston County,188482,4468,184014,451,1707,1093,124,129,2520,2487,33,177990
0500000US26101,26,101,Manistee County,24444,738,23706,369,95,655,14,2,770,765,5,21801
0500000US26051,26,051,Gladwin County,25289,397,24892,145,125,85,0,15,247,247,0,24275
0500000US05075,05,075,Lawrence County,16669,240,16429,47,16,173,1,0,278,278,0,15914
0500000US05029,05,029,Conway County,20906,812,20094,64,10,2255,0,3,693,690,3,17069
0500000US05001,05,001,Arkansas County,18124,554,17570,18,0,4677,0,0,180,174,6,12695
0500000US05085,05,085,Lonoke County,72206,3196,69010,396,476,4372,85,52,1437,1408,29,62192
0500000US06047,06,047,Merced County,269075,158494,110581,840,19487,8038,556,501,5151,4987,164,76008
0500000US06049,06,049,Modoc County,8938,1292,7646,291,130,149,6,4,104,96,8,6962
0500000US06027,06,027,Inyo County,18085,3927,14158,1944,289,160,35,28,313,312,1,11389
0500000US06099,06,099,Stanislaus County,539301,245973,293328,2600,28599,14338,3711,908,13376,12769,607,229796
0500000US06103,06,103,Tehama County,63373,15623,47750,1013,964,420,17,24,1773,1734,39,43539
0500000US06069,06,069,San Benito County,59416,35248,24168,193,1705,434,79,84,893,840,53,20780
0500000US06017,06,017,El Dorado County,186661,23631,163030,939,8237,1432,396,184,5852,5721,131,145990
0500000US06075,06,075,San Francisco County,870044,132651,737393,1363,294846,43619,2694,4163,37038,35528,1510,353670
0500000US06107,06,107,Tulare County,460477,295149,165328,2769,14800,5870,584,877,6811,6549,262,133617
0500000US06057,06,057,Nevada County,99092,9281,89811,570,989,601,154,130,2897,2812,85,84470
0500000US06039,06,039,Madera County,155013,88806,66207,1504,3047,4835,136,443,2711,2500,211,53531
0500000US06105,06,105,Trinity County,12862,930,11932,574,179,87,158,27,300,299,1,10607
0500000US06071,06,071,San Bernardino County,2135413,1127813,1007600,7409,145652,168864,6037,4085,52291,49414,2877,623262
0500000US06061,06,061,Placer County,380077,52498,327579,1244,27196,5868,576,403,13912,13528,384,278380
0500000US06095,06,095,Solano County,438530,114406,324124,1258,65994,59500,3928,1288,23286,22630,656,168870
0500000US06011,06,011,Colusa County,21464,12655,8809,159,324,277,53,30,294,294,0,7672
0500000US06031,06,031,Kings County,150075,81154,68921,1227,5737,8784,285,204,3626,3449,177,49058
0500000US06019,06,019,Fresno County,978130,515907,462223,4458,97991,44474,1104,1864,20877,19919,958,291455
0500000US06111,06,111,Ventura County,848112,360017,488095,2299,60242,13677,1406,1016,21154,20614,540,388301
0500000US08123,08,123,Weld County,295123,86322,208801,1017,4181,3259,258,326,4947,4780,167,194813
0500000US08027,08,027,Custer County,4640,444,4196,44,0,119,0,0,87,87,0,3946
0500000US08035,08,035,Douglas County,328614,27998,300616,625,14527,4116,241,898,8260,7829,431,271949
0500000US08067,08,067,La Plata County,55101,7028,48073,2856,329,238,13,27,1228,1183,45,43382
0500000US08105,08,105,Rio Grande County,11351,5046,6305,220,24,45,5,24,67,67,0,5920
0500000US08011,08,011,Bent County,5809,1858,3951,18,34,202,0,0,15,15,0,3682
0500000US08111,08,111,San Juan County,544,48,496,7,0,0,0,0,0,0,0,489
0500000US08075,08,075,Logan County,21689,3443,18246,95,164,198,0,10,909,909,0,16870
0500000US08119,08,119,Teller County,24113,1532,22581,110,244,191,8,7,526,526,0,21495
0500000US08039,08,039,Elbert County,25162,1693,23469,134,196,115,0,14,636,626,10,22374
0500000US08073,08,073,Lincoln County,5548,1203,4345,53,37,524,25,2,36,36,0,3668
0500000US08003,08,003,Alamosa County,16444,7542,8902,319,145,134,57,58,249,198,51,7940
0500000US08043,08,043,Fremont County,47002,6186,40816,550,320,1888,2,21,811,771,40,37224
0500000US08085,08,085,Montrose County,41268,8476,32792,317,323,146,79,57,476,460,16,31394
0500000US08109,08,109,Saguache County,6468,2366,4102,157,0,0,0,0,160,160,0,3785
0500000US08053,08,053,Hinsdale County,878,51,827,19,3,0,0,0,13,13,0,792
0500000US08049,08,049,Grand County,15066,1273,13793,7,167,122,84,78,137,137,0,13198
0500000US08089,08,089,Otero County,18325,7637,10688,121,179,248,16,116,144,144,0,9864
0500000US09005,09,005,Litchfield County,183031,10941,172090,305,3361,2863,6,179,2478,2287,191,162898
0500000US09011,09,011,New London County,268881,27762,241119,1294,10972,14219,74,380,9995,9691,304,204185
0500000US09001,09,001,Fairfield County,944348,182653,761695,1257,49375,99412,309,5416,16952,15286,1666,588974
0500000US10001,10,001,Kent County,174822,12180,162642,982,3470,42782,46,465,6210,6179,31,108687
0500000US12057,12,057,Hillsborough County,1378883,386478,992405,2483,54617,213409,723,5332,32906,30480,2426,682935
0500000US12129,12,129,Wakulla County,31877,1165,30712,38,199,4703,0,3,419,419,0,25350
0500000US12045,12,045,Gulf County,16055,760,15295,59,86,2850,27,20,252,252,0,12001
0500000US12097,12,097,Osceola County,338619,179388,159231,722,8720,31734,331,1614,4860,4493,367,111250
0500000US12131,12,131,Walton County,65858,4029,61829,301,632,3085,92,47,2112,2112,0,55560
0500000US12065,12,065,Jefferson County,14105,565,13540,77,30,4847,0,0,203,203,0,8383
0500000US12049,12,049,Hardee County,27228,11834,15394,45,212,2082,21,5,164,164,0,12865
0500000US12093,12,093,Okeechobee County,40572,10217,30355,229,380,3337,63,9,532,532,0,25805
0500000US12041,12,041,Gilchrist County,17615,998,16617,4,38,1079,0,0,264,264,0,15232
0500000US12001,12,001,Alachua County,263148,25229,237919,870,15703,51979,127,620,6663,6586,77,161957
0500000US12015,12,015,Charlotte County,176954,12443,164511,382,2209,9374,115,409,3123,2945,178,148899
0500000US12085,12,085,Martin County,157581,21094,136487,308,2067,8564,92,291,1313,1220,93,123852
0500000US12115,12,115,Sarasota County,412144,36988,375156,585,6741,18214,96,475,5472,5391,81,343573
0500000US12017,12,017,Citrus County,143087,7873,135214,440,2415,3894,5,118,1975,1962,13,126367
0500000US12113,12,113,Santa Rosa County,170442,9199,161243,733,3189,10062,259,274,5880,5829,51,140846
0500000US12011,12,011,Broward County,1909151,554609,1354542,3188,67313,524739,946,10121,37797,33522,4275,710438
0500000US12087,12,087,Monroe County,76325,18206,58119,98,970,5024,107,93,803,747,56,51024
0500000US13313,13,313,Whitfield County,103849,35864,67985,174,1486,4054,4,74,841,803,38,61352
0500000US13285,13,285,Troup County,69774,2563,67211,59,1384,24770,0,150,1293,1272,21,39555
0500000US13145,13,145,Harris County,33590,1155,32435,41,398,5404,4,2,711,711,0,25875
0500000US13321,13,321,Worth County,20656,431,20225,77,70,5833,5,85,255,244,11,13900
0500000US13109,13,109,Evans County,10727,1256,9471,1,91,3256,0,12,67,67,0,6044
0500000US13307,13,307,Webster County,2613,250,2363,5,0,1045,0,0,19,19,0,1294
0500000US13125,13,125,Glascock County,3009,49,2960,15,0,275,2,0,40,40,0,2628
0500000US13051,13,051,Chatham County,287049,18007,269042,522,7330,112859,334,610,7144,6634,510,140243
0500000US13173,13,173,Lanier County,10366,574,9792,28,32,2507,0,22,84,84,0,7119
0500000US13195,13,195,Madison County,28900,1495,27405,73,347,2534,0,93,544,534,10,23814
0500000US13147,13,147,Hart County,25631,952,24679,10,248,4723,7,0,491,432,59,19200
0500000US13191,13,191,McIntosh County,14120,139,13981,16,235,4822,20,0,151,141,10,8737
0500000US13237,13,237,Putnam County,21503,1381,20122,2,139,5626,0,0,271,271,0,14084
0500000US13301,13,301,Warren County,5346,23,5323,0,45,3267,0,6,9,9,0,1996
0500000US13029,13,029,Bryan County,35885,2454,33431,162,520,5080,0,95,1107,1107,0,26467
0500000US13039,13,039,Camden County,52714,3466,49248,270,963,9816,64,103,1174,1153,21,36858
0500000US13099,13,099,Early County,10348,229,10119,9,57,5266,0,3,64,64,0,4720
0500000US13069,13,069,Coffee County,42961,4926,38035,44,327,12028,0,200,383,376,7,25053
0500000US13123,13,123,Gilmer County,29922,3429,26493,65,142,90,3,0,440,420,20,25753
0500000US13317,13,317,Wilkes County,9884,475,9409,0,85,4198,0,16,73,73,0,5037
0500000US13129,13,129,Gordon County,56790,8864,47926,7,595,2219,14,35,889,858,31,44167
0500000US13057,13,057,Cherokee County,241910,24977,216933,165,4527,15268,62,353,4448,4274,174,192110
0500000US13177,13,177,Lee County,29348,839,28509,21,758,5921,38,57,536,520,16,21178
0500000US13133,13,133,Greene County,16976,1018,15958,0,171,6001,3,0,107,90,17,9676
0500000US13075,13,075,Cook County,17184,988,16196,45,109,4711,0,0,183,183,0,11148
0500000US13121,13,121,Fulton County,1021902,74328,947574,1612,69987,445992,206,4238,18784,17832,952,406755
0500000US13187,13,187,Lumpkin County,31951,1530,30421,186,96,584,35,29,528,520,8,28963
0500000US13201,13,201,Miller County,5836,34,5802,45,0,1769,0,0,7,7,0,3981
0500000US13219,13,219,Oconee County,37017,1804,35213,15,1517,2005,2,66,301,266,35,31307
0500000US13151,13,151,Henry County,221307,14739,206568,128,7337,92650,0,480,6169,5906,263,99804
0500000US13183,13,183,Long County,18156,2043,16113,50,180,4259,95,0,933,933,0,10596
0500000US13257,13,257,Stephens County,25676,843,24833,40,84,2876,2,0,621,596,25,21210
0500000US13293,13,293,Upson County,26216,600,25616,88,105,7284,186,0,291,211,80,17662
0500000US13225,13,225,Peach County,26966,2018,24948,32,271,12015,31,9,203,203,0,12387
0500000US13229,13,229,Pierce County,19164,966,18198,59,0,1832,0,0,194,194,0,16113
0500000US13251,13,251,Screven County,13990,276,13714,31,100,5868,0,24,67,67,0,7624
0500000US13011,13,011,Banks County,18510,1236,17274,67,230,500,0,20,168,168,0,16289
0500000US13061,13,061,Clay County,3001,0,3001,0,41,2036,0,16,6,6,0,902
0500000US13089,13,089,DeKalb County,743187,63736,679451,1361,45140,396854,260,2663,16952,16211,741,216221
0500000US13157,13,157,Jackson County,65755,4850,60905,81,1048,4274,5,145,1439,1346,93,53913
0500000US13181,13,181,Lincoln County,7799,129,7670,4,15,2462,2,0,53,53,0,5134
0500000US13235,13,235,Pulaski County,11295,463,10832,17,10,3908,0,4,172,157,15,6721
0500000US13281,13,281,Towns County,11417,140,11277,64,77,135,0,0,196,187,9,10805
0500000US13287,13,287,Turner County,7962,131,7831,17,66,3401,0,22,13,13,0,4312
0500000US13001,13,001,Appling County,18454,1803,16651,68,139,3363,0,0,265,265,0,12816
0500000US16077,16,077,Power County,7713,2618,5095,316,0,4,2,0,24,24,0,4749
0500000US16071,16,071,Oneida County,4326,192,4134,9,0,4,0,0,79,79,0,4042
0500000US16063,16,063,Lincoln County,5321,1607,3714,26,9,0,0,0,127,127,0,3552
0500000US16041,16,041,Franklin County,13279,891,12388,83,8,32,10,5,139,139,0,12111
0500000US16053,16,053,Jerome County,23431,8299,15132,57,100,24,83,3,299,299,0,14566
0500000US16067,16,067,Minidoka County,20615,7226,13389,169,82,27,0,0,286,254,32,12825
0500000US16013,16,013,Blaine County,21994,4798,17196,4,204,81,20,0,284,284,0,16603
0500000US16021,16,021,Boundary County,11549,567,10982,119,90,33,26,0,259,259,0,10455
0500000US16047,16,047,Gooding County,15169,4413,10756,90,54,15,43,5,254,254,0,10295
0500000US16007,16,007,Bear Lake County,5962,249,5713,16,74,21,0,0,25,25,0,5577
0500000US16019,16,019,Bonneville County,112397,14482,97915,439,961,574,159,51,2186,2124,62,93545
0500000US16035,16,035,Clearwater County,8640,356,8284,186,27,33,21,0,192,192,0,7825
0500000US16059,16,059,Lemhi County,7798,261,7537,7,0,3,7,13,242,242,0,7265
0500000US16017,16,017,Bonner County,42711,1282,41429,426,284,88,54,12,699,699,0,39866
0500000US16037,16,037,Custer County,4141,184,3957,38,0,4,0,0,166,166,0,3749
0500000US16065,16,065,Madison County,38705,2902,35803,44,447,106,28,86,838,822,16,34254
0500000US16081,16,081,Teton County,11080,1895,9185,41,10,17,0,0,145,145,0,8972
0500000US15003,15,003,Honolulu County,987638,96562,891076,1018,409718,21921,87614,860,186808,185485,1323,183137
0500000US17183,17,183,Vermilion County,78407,3877,74530,211,743,10885,12,17,1113,1045,68,61549
0500000US17023,17,023,Clark County,15836,247,15589,11,76,46,0,0,162,162,0,15294
0500000US17049,17,049,Effingham County,34174,684,33490,24,210,155,15,10,296,296,0,32780
0500000US17065,17,065,Hamilton County,8221,198,8023,23,49,31,0,0,0,0,0,7920
0500000US17087,17,087,Johnson County,12602,403,12199,9,40,1462,0,9,32,32,0,10647
0500000US17105,17,105,Livingston County,36324,1627,34697,0,278,1420,0,2,579,579,0,32418
0500000US17179,17,179,Tazewell County,133852,3019,130833,207,1330,1747,18,95,1486,1465,21,125950
0500000US17187,17,187,Warren County,17338,1631,15707,40,448,449,0,76,239,239,0,14455
0500000US17119,17,119,Madison County,265670,8485,257185,482,2592,22318,57,120,5104,5024,80,226512
0500000US17131,17,131,Mercer County,15693,364,15329,16,54,92,0,0,174,173,1,14993
0500000US17003,17,003,Alexander County,6532,73,6459,48,6,2169,0,0,173,142,31,4063
0500000US17157,17,157,Randolph County,32546,996,31550,47,128,3305,0,17,387,378,9,27666
0500000US17115,17,115,Macon County,106512,2366,104146,273,1154,15185,7,164,5904,5871,33,81459
0500000US17191,17,191,Wayne County,16487,81,16406,33,43,290,0,0,168,165,3,15872
0500000US17055,17,055,Franklin County,39127,657,38470,79,185,280,25,17,357,357,0,37527
0500000US17109,17,109,McDonough County,30875,835,30040,55,689,1431,0,0,652,634,18,27213
0500000US17139,17,139,Moultrie County,14703,197,14506,40,32,78,0,4,109,109,0,14243
0500000US17151,17,151,Pope County,4249,79,4170,10,27,223,0,0,45,45,0,3865
0500000US17173,17,173,Shelby County,21832,226,21606,19,25,202,0,0,111,111,0,21249
0500000US17019,17,019,Champaign County,209448,12239,197209,268,22278,27617,121,351,4817,4775,42,141757
0500000US17053,17,053,Ford County,13398,427,12971,59,64,147,5,19,104,89,15,12573
0500000US17093,17,093,Kendall County,124626,22616,102010,108,4132,8184,0,15,1948,1682,266,87623
0500000US17121,17,121,Marion County,38084,748,37336,86,264,1328,0,73,813,810,3,34772
0500000US17125,17,125,Mason County,13778,147,13631,14,27,130,0,1,151,151,0,13308
0500000US18149,18,149,Starke County,22941,835,22106,33,160,84,0,0,174,174,0,21655
0500000US18055,18,055,Greene County,32295,446,31849,10,112,111,20,0,361,361,0,31235
0500000US18177,18,177,Wayne County,66613,1949,64664,109,682,3300,0,27,1687,1687,0,58859
0500000US18037,18,037,Dubois County,42418,3115,39303,12,295,181,0,0,298,298,0,38517
0500000US18059,18,059,Hancock County,73830,1674,72156,66,601,1549,18,75,1354,1238,116,68493
0500000US18115,18,115,Ohio County,5887,64,5823,5,24,68,0,0,33,33,0,5693
0500000US18121,18,121,Parke County,16996,262,16734,33,0,67,142,8,399,399,0,16085
0500000US18007,18,007,Benton County,8667,445,8222,1,15,49,7,0,118,116,2,8032
0500000US18133,18,133,Putnam County,37559,716,36843,56,706,1001,9,5,572,544,28,34494
0500000US18175,18,175,Washington County,27827,369,27458,77,86,24,0,19,314,314,0,26938
0500000US18065,18,065,Henry County,48483,843,47640,106,236,1184,21,74,614,576,38,45405
0500000US18095,18,095,Madison County,129505,5074,124431,230,758,9989,12,90,3117,3039,78,110235
0500000US18125,18,125,Pike County,12411,101,12310,0,91,125,0,0,117,111,6,11977
0500000US18151,18,151,Steuben County,34474,1206,33268,35,140,93,14,7,590,590,0,32389
0500000US18179,18,179,Wells County,27947,812,27135,37,131,202,0,0,315,311,4,26450
0500000US18035,18,035,Delaware County,115616,2751,112865,88,1728,8254,82,144,2035,1991,44,100534
0500000US18077,18,077,Jefferson County,32237,876,31361,88,247,704,0,54,342,342,0,29926
0500000US18103,18,103,Miami County,35901,1109,34792,267,180,1841,29,12,504,504,0,31959
0500000US18111,18,111,Newton County,14018,868,13150,14,0,37,0,0,30,30,0,13069
0500000US18141,18,141,St. Joseph County,269240,22901,246339,766,6037,34488,227,421,7668,7568,100,196732
0500000US18155,18,155,Switzerland County,10628,208,10420,0,56,99,0,0,108,108,0,10157
0500000US18015,18,015,Carroll County,19994,787,19207,56,32,88,3,36,181,178,3,18811
0500000US18069,18,069,Huntington County,36378,847,35531,148,273,333,17,0,209,209,0,34551
0500000US18181,18,181,White County,24217,1973,22244,68,61,97,0,0,335,313,22,21683
0500000US18075,18,075,Jay County,20993,640,20353,13,45,90,1,0,260,260,0,19944
0500000US18019,18,019,Clark County,115702,6147,109555,88,915,7941,27,186,3765,3744,21,96633
0500000US19101,19,101,Jefferson County,18077,529,17548,2,1107,310,0,236,1302,1302,0,14591
0500000US19005,19,005,Allamakee County,13880,884,12996,22,65,174,10,0,123,123,0,12602
0500000US19049,19,049,Dallas County,84002,5120,78882,88,3597,1361,67,95,1634,1634,0,72040
0500000US19023,19,023,Butler County,14735,194,14541,28,83,81,9,0,97,97,0,14243
0500000US19071,19,071,Fremont County,6968,184,6784,48,0,32,0,0,85,78,7,6619
0500000US19173,19,173,Taylor County,6201,492,5709,2,44,15,0,0,52,52,0,5596
0500000US19195,19,195,Worth County,7489,218,7271,0,25,92,2,0,82,82,0,7070
0500000US19003,19,003,Adams County,3726,47,3679,3,10,16,0,0,7,7,0,3643
0500000US19037,19,037,Chickasaw County,12099,295,11804,34,52,51,0,0,58,58,0,11609
0500000US19059,19,059,Dickinson County,17056,333,16723,43,140,111,0,0,75,70,5,16354
0500000US19103,19,103,Johnson County,147001,8184,138817,269,9240,9822,98,503,3043,2982,61,115842
0500000US19171,19,171,Tama County,17136,1581,15555,1212,58,143,3,8,171,171,0,13960
0500000US19069,19,069,Franklin County,10245,1271,8974,0,0,142,0,0,85,85,0,8747
0500000US19027,19,027,Carroll County,20344,147,20197,3,22,35,0,0,94,94,0,20043
0500000US19067,19,067,Floyd County,15858,467,15391,90,224,274,27,0,183,183,0,14593
0500000US19115,19,115,Louisa County,11223,1768,9455,55,419,125,0,9,76,76,0,8771
0500000US19119,19,119,Lyon County,11769,304,11465,31,27,7,33,0,90,90,0,11277
0500000US19165,19,165,Shelby County,11694,332,11362,9,37,96,0,0,131,131,0,11089
0500000US19087,19,087,Henry County,19926,948,18978,51,522,449,9,15,347,347,0,17585
0500000US19145,19,145,Page County,15363,512,14851,101,147,260,0,0,323,323,0,14020
0500000US19155,19,155,Pottawattamie County,93503,7122,86381,257,619,1335,11,7,1901,1901,0,82251
0500000US19043,19,043,Clayton County,17672,339,17333,36,79,181,0,0,72,72,0,16965
0500000US19021,19,021,Buena Vista County,20260,5107,15153,3,2125,551,97,11,140,140,0,12226
0500000US19077,19,077,Guthrie County,10674,286,10388,36,27,3,0,0,160,160,0,10162
0500000US19091,19,091,Humboldt County,9566,407,9159,41,40,25,0,0,92,92,0,8961
0500000US19183,19,183,Washington County,22143,1336,20807,55,104,191,0,0,259,257,2,20198
